"code_7","dist_name","dsd_name","gnd_name","gnd_number","total","male","female"
"2103005","Kandy","Thumpane","Meegahahena South","380",677,320,357
"2103010","Kandy","Thumpane","Meegahahena","379",485,238,247
"2103015","Kandy","Thumpane","Galabawa","378",604,287,317
"2103020","Kandy","Thumpane","Kobbegala","370",389,206,183
"2103025","Kandy","Thumpane","Ambagahahena","371",522,305,217
"2103030","Kandy","Thumpane","Rokhill","302",581,317,264
"2103035","Kandy","Thumpane","Akkarawatta","303",327,176,151
"2103040","Kandy","Thumpane","Bonakot","304",496,231,265
"2103045","Kandy","Thumpane","Haddapitiya","305",766,349,417
"2103050","Kandy","Thumpane","Delgasyaya","307",342,173,169
"2103055","Kandy","Thumpane","Gallenawatta","364",422,194,228
"2103060","Kandy","Thumpane","Kandanhena East","400",617,313,304
"2103065","Kandy","Thumpane","Namaltenna","401",831,382,449
"2103070","Kandy","Thumpane","Alawattegama","399",368,172,196
"2103075","Kandy","Thumpane","Kumburegama","398",756,358,398
"2103080","Kandy","Thumpane","Ban Anga","363",455,242,213
"2103085","Kandy","Thumpane","Ethamulla","362",729,360,369
"2103090","Kandy","Thumpane","Palukopi Watta","308",777,370,407
"2103095","Kandy","Thumpane","Damunugasthenna","306",649,311,338
"2103100","Kandy","Thumpane","Galagedara West","301",1043,507,536
"2103105","Kandy","Thumpane","Udapitiya","311",334,161,173
"2103110","Kandy","Thumpane","Galagedara Madige South","369",1162,522,640
"2103115","Kandy","Thumpane","Galagedara","300",745,380,365
"2103120","Kandy","Thumpane","Galagedara Madige","368",597,278,319
"2103125","Kandy","Thumpane","Pethigewela","310",448,244,204
"2103130","Kandy","Thumpane","Udalagama","309",607,279,328
"2103135","Kandy","Thumpane","Gunadaha","372",896,409,487
"2103140","Kandy","Thumpane","Medagoda Pahala","406",556,252,304
"2103145","Kandy","Thumpane","Opalla","373",318,155,163
"2103150","Kandy","Thumpane","Gangodapitiya","320",467,233,234
"2103155","Kandy","Thumpane","Pubbiliya","321",351,162,189
"2103160","Kandy","Thumpane","Kannadeniya","319",513,239,274
"2103165","Kandy","Thumpane","Barandara","322",652,303,349
"2103170","Kandy","Thumpane","Kaluwana","318",623,296,327
"2103175","Kandy","Thumpane","Kinigama West","317",526,254,272
"2103180","Kandy","Thumpane","Kinigama East","316",540,255,285
"2103185","Kandy","Thumpane","Ponnila","313",442,210,232
"2103190","Kandy","Thumpane","Uduwa","312",685,333,352
"2103195","Kandy","Thumpane","Medagoda Ihala","407",479,237,242
"2103200","Kandy","Thumpane","Naranwala","299",766,352,414
"2103205","Kandy","Thumpane","Hikgodawalpola","298",627,301,326
"2103210","Kandy","Thumpane","Paranagama","367",713,336,377
"2103215","Kandy","Thumpane","Wettewa","296",392,190,202
"2103220","Kandy","Thumpane","Pavulpawa","297",487,265,222
"2103225","Kandy","Thumpane","Kirindiwelpola","285",389,211,178
"2103230","Kandy","Thumpane","Kuragama North","366",453,263,190
"2103235","Kandy","Thumpane","Nikathenna","289",441,234,207
"2103240","Kandy","Thumpane","Etambegoda","290",330,155,175
"2103245","Kandy","Thumpane","Thahalpitiya","286",352,154,198
"2103250","Kandy","Thumpane","Dehideniya","284",619,290,329
"2103255","Kandy","Thumpane","Kandekumbura","361",654,293,361
"2103260","Kandy","Thumpane","Diyapalagoda","359",421,237,184
"2103265","Kandy","Thumpane","Niyangoda","358",893,456,437
"2103270","Kandy","Thumpane","Niyambepola","403",661,287,374
"2103275","Kandy","Thumpane","Henegama Palkumbura","405",740,343,397
"2103280","Kandy","Thumpane","Idamegama","404",798,367,431
"2103285","Kandy","Thumpane","Marawanagoda","402",829,402,427
"2103290","Kandy","Thumpane","Adungama Palkumbura","360",699,331,368
"2103295","Kandy","Thumpane","Kuragama","365",800,388,412
"2103300","Kandy","Thumpane","Udahenepola","287",287,140,147
"2103305","Kandy","Thumpane","Poholiyadda","288",534,279,255
"2103310","Kandy","Thumpane","Hiyadala","295",147,68,79
"2103315","Kandy","Thumpane","Pallekotuwa","392",411,193,218
"2103320","Kandy","Thumpane","Hiyadala Walpola","294",676,317,359
"2103325","Kandy","Thumpane","Minigamuwa","291",393,178,215
"2103330","Kandy","Thumpane","Minigamuwa Ihala","293",155,76,79
"2103335","Kandy","Thumpane","Thennewela","292",198,96,102
"2106005","Kandy","Poojapitiya","Egodamulla North","531",926,459,467
"2106010","Kandy","Poojapitiya","Ihalamulla","528",589,266,323
"2106015","Kandy","Poojapitiya","Dehiwatta","529",887,413,474
"2106020","Kandy","Poojapitiya","Egodamulla South","530",1215,572,643
"2106025","Kandy","Poojapitiya","Pahala Kithulgolla","540",1102,527,575
"2106030","Kandy","Poojapitiya","Alawatta","538",685,332,353
"2106035","Kandy","Poojapitiya","Uda Kithulgolla","539",747,362,385
"2106040","Kandy","Poojapitiya","Ankumbura South","532",1043,534,509
"2106045","Kandy","Poojapitiya","Ankumbura North","533",1085,518,567
"2106050","Kandy","Poojapitiya","Uggala Janapadaya","535",691,333,358
"2106055","Kandy","Poojapitiya","Pallegama Pahala","534",627,311,316
"2106060","Kandy","Poojapitiya","Welgala","537",598,316,282
"2106065","Kandy","Poojapitiya","Ankumbura Udagama","536",686,315,371
"2106070","Kandy","Poojapitiya","Kovilamuduna","525",825,363,462
"2106075","Kandy","Poojapitiya","Galhinna","524",1960,887,1073
"2106080","Kandy","Poojapitiya","Galkanda","523",456,209,247
"2106085","Kandy","Poojapitiya","Palliya Kotuwa","526",1792,849,943
"2106090","Kandy","Poojapitiya","Batagolladeniya","527",1688,728,960
"2106095","Kandy","Poojapitiya","Watagalathenna","522",832,394,438
"2106100","Kandy","Poojapitiya","Morankanda","505",493,226,267
"2106105","Kandy","Poojapitiya","Wewala North","506",645,289,356
"2106110","Kandy","Poojapitiya","Udahena","500",385,184,201
"2106115","Kandy","Poojapitiya","Siyapathgama","501",873,419,454
"2106120","Kandy","Poojapitiya","Pathirada","497",447,204,243
"2106125","Kandy","Poojapitiya","Udahingulwala","499",976,461,515
"2106130","Kandy","Poojapitiya","Pahala Hingulwala","507",832,392,440
"2106135","Kandy","Poojapitiya","Rambukewela","517",1273,592,681
"2106140","Kandy","Poojapitiya","Godahena","521",1031,480,551
"2106145","Kandy","Poojapitiya","Kahatagasthenna","520",655,295,360
"2106150","Kandy","Poojapitiya","Watagoda","541",916,444,472
"2106155","Kandy","Poojapitiya","Dolapihilla North","518",853,422,431
"2106160","Kandy","Poojapitiya","Dolapihilla South","519",1036,475,561
"2106165","Kandy","Poojapitiya","Weligalla","516",1059,485,574
"2106170","Kandy","Poojapitiya","Wewala","503",999,476,523
"2106175","Kandy","Poojapitiya","Bokkawala","502",944,471,473
"2106180","Kandy","Poojapitiya","Harankahawa","494",584,267,317
"2106185","Kandy","Poojapitiya","Henegama","495",550,261,289
"2106190","Kandy","Poojapitiya","Molagoda","498",601,290,311
"2106195","Kandy","Poojapitiya","Waldeniya","504",837,408,429
"2106200","Kandy","Poojapitiya","Medagoda","513",454,214,240
"2106205","Kandy","Poojapitiya","Diddeniya","547",846,386,460
"2106210","Kandy","Poojapitiya","Ovissa North","542",748,364,384
"2106215","Kandy","Poojapitiya","Ovissa South","543",936,419,517
"2106220","Kandy","Poojapitiya","Kiralagama","545",665,304,361
"2106225","Kandy","Poojapitiya","Paleepana","546",978,455,523
"2106230","Kandy","Poojapitiya","Dombagammana","515",1026,487,539
"2106235","Kandy","Poojapitiya","Uggahakumbura","514",510,229,281
"2106240","Kandy","Poojapitiya","Marathugoda North","508",920,428,492
"2106245","Kandy","Poojapitiya","Marathugoda South","509",761,358,403
"2106250","Kandy","Poojapitiya","Ambaruppa","496",598,271,327
"2106255","Kandy","Poojapitiya","Gallella","492",616,299,317
"2106260","Kandy","Poojapitiya","Maruddana","493",719,322,397
"2106265","Kandy","Poojapitiya","Alagoda","510",746,345,401
"2106270","Kandy","Poojapitiya","Madadeniya","511",978,475,503
"2106275","Kandy","Poojapitiya","Warakadeniya","512",431,202,229
"2106280","Kandy","Poojapitiya","Batagalla North","548",979,488,491
"2106285","Kandy","Poojapitiya","Bamunupola","544",686,332,354
"2106290","Kandy","Poojapitiya","Batugoda North","550",632,310,322
"2106295","Kandy","Poojapitiya","Batagalla South","549",510,242,268
"2106300","Kandy","Poojapitiya","Batugoda South","551",675,321,354
"2106305","Kandy","Poojapitiya","Diwanawatta","552",1134,552,582
"2106310","Kandy","Poojapitiya","Mullegama North","554",1028,482,546
"2106315","Kandy","Poojapitiya","Kahawatta North","557",1218,562,656
"2106320","Kandy","Poojapitiya","Kahawatta South","558",1284,627,657
"2106325","Kandy","Poojapitiya","Mullegama South","553",1980,938,1042
"2106330","Kandy","Poojapitiya","Kaluwana South","555",873,414,459
"2106335","Kandy","Poojapitiya","Kaluwana North","556",560,272,288
"2109005","Kandy","Akurana","Rambuke Ela","590",1694,797,897
"2109010","Kandy","Akurana","Vilana Udagama","589",1566,763,803
"2109015","Kandy","Akurana","Vilana Pallegama","591",1703,836,867
"2109020","Kandy","Akurana","Walahena","587",1150,580,570
"2109025","Kandy","Akurana","Alawathugoda","583",3835,1828,2007
"2109030","Kandy","Akurana","Balakaduwa","585",1007,493,514
"2109035","Kandy","Akurana","Mawathupola","580",2087,931,1156
"2109040","Kandy","Akurana","Arambepola","584",1301,611,690
"2109045","Kandy","Akurana","Delgasgoda","588",1658,785,873
"2109050","Kandy","Akurana","Dippitiya","586",1309,635,674
"2109055","Kandy","Akurana","Malwanahinna","569",2015,944,1071
"2109060","Kandy","Akurana","Konakalagala","581",1260,610,650
"2109065","Kandy","Akurana","Malgamandeniya","574",1146,533,613
"2109070","Kandy","Akurana","Rathukoho","575",1320,601,719
"2109075","Kandy","Akurana","Marahela","582",1053,497,556
"2109080","Kandy","Akurana","Hureegolla","571",2169,987,1182
"2109085","Kandy","Akurana","Neerella","567",2107,950,1157
"2109090","Kandy","Akurana","Melchena","568",1218,551,667
"2109095","Kandy","Akurana","Bulugohothenna","559",2162,988,1174
"2109100","Kandy","Akurana","Kasawatta","560",2342,1109,1233
"2109105","Kandy","Akurana","Udaweliketiya","561",3189,1461,1728
"2109110","Kandy","Akurana","Palleweliketiya","562",1845,808,1037
"2109115","Kandy","Akurana","Dodangolla","563",3106,1401,1705
"2109120","Kandy","Akurana","Akurana","564",2548,1140,1408
"2109125","Kandy","Akurana","Delgasthenna","572",1756,803,953
"2109130","Kandy","Akurana","Kurugoda","570",2013,974,1039
"2109135","Kandy","Akurana","Deegala","576",736,354,382
"2109140","Kandy","Akurana","Pangollamada","573",795,326,469
"2109145","Kandy","Akurana","Dunuvila North","578",1717,838,879
"2109150","Kandy","Akurana","Dunuvila South","579",1192,563,629
"2109155","Kandy","Akurana","Palle Deegala","577",832,380,452
"2109160","Kandy","Akurana","Thelambugahawatta","565",3448,1905,1543
"2109165","Kandy","Akurana","Waragashinna","566",2228,1139,1089
"2109170","Kandy","Akurana","Kurudugahaela","592",1889,876,1013
"2109175","Kandy","Akurana","Uggala","593",2001,943,1058
"2112005","Kandy","Pathadumbara","Yatawara","620",1377,627,750
"2112010","Kandy","Pathadumbara","Yatawara Kandagama","621",1289,634,655
"2112015","Kandy","Pathadumbara","Ihala Yatawara","622",2301,1090,1211
"2112020","Kandy","Pathadumbara","Udurawana","598",1031,488,543
"2112025","Kandy","Pathadumbara","Doragamuwa","600",2115,1000,1115
"2112030","Kandy","Pathadumbara","Bogahakumbura","626",1256,579,677
"2112035","Kandy","Pathadumbara","Deegahawathura","623",1146,559,587
"2112040","Kandy","Pathadumbara","Mahakumbura","624",965,442,523
"2112045","Kandy","Pathadumbara","Mandandawela","632",1063,523,540
"2112050","Kandy","Pathadumbara","Paranagama","627",764,375,389
"2112055","Kandy","Pathadumbara","Aluthgama","625",1167,557,610
"2112060","Kandy","Pathadumbara","Walpaladeniya","602",1352,600,752
"2112065","Kandy","Pathadumbara","Puwakgahadeniya","599",871,412,459
"2112070","Kandy","Pathadumbara","Wattegama","594",2540,1218,1322
"2112075","Kandy","Pathadumbara","Wattegama North","595",3135,1454,1681
"2112080","Kandy","Pathadumbara","Gunembill","596",818,412,406
"2112085","Kandy","Pathadumbara","Eriyagasthenna","597",1416,699,717
"2112090","Kandy","Pathadumbara","Pitiyegedara","642",1129,542,587
"2112095","Kandy","Pathadumbara","Yatirawana","641",2201,1060,1141
"2112100","Kandy","Pathadumbara","Meegammana","601",2015,953,1062
"2112105","Kandy","Pathadumbara","Meegammana West","603",1306,602,704
"2112110","Kandy","Pathadumbara","Galadeniya","612",2958,1453,1505
"2112115","Kandy","Pathadumbara","Udathalavinna","615",2481,1163,1318
"2112120","Kandy","Pathadumbara","Pallethalavinna Ihala","614",1167,520,647
"2112125","Kandy","Pathadumbara","Moonamale","628",857,402,455
"2112130","Kandy","Pathadumbara","Kendaliyadda","630",1321,632,689
"2112135","Kandy","Pathadumbara","Girakaduwa","631",1179,565,614
"2112140","Kandy","Pathadumbara","Ambathenna","629",1707,835,872
"2112145","Kandy","Pathadumbara","Molagodayawatta","619",1605,790,815
"2112150","Kandy","Pathadumbara","Megodagama","618",860,416,444
"2112155","Kandy","Pathadumbara","Egodagama","616",1482,719,763
"2112160","Kandy","Pathadumbara","Millanga","617",1151,527,624
"2112165","Kandy","Pathadumbara","Pallethalavinna","613",1843,826,1017
"2112170","Kandy","Pathadumbara","Udathalavinna Madige","611",3627,1730,1897
"2112175","Kandy","Pathadumbara","Meegamawatta","604",2739,1306,1433
"2112180","Kandy","Pathadumbara","Madawala Madige","637",4594,2106,2488
"2112185","Kandy","Pathadumbara","Madawala","640",2199,1071,1128
"2112190","Kandy","Pathadumbara","Walala","643",822,360,462
"2112195","Kandy","Pathadumbara","Ketakahala","644",1068,514,554
"2112200","Kandy","Pathadumbara","Thalkotuwa","645",1343,635,708
"2112205","Kandy","Pathadumbara","Napana","633",1295,588,707
"2112210","Kandy","Pathadumbara","Leemagahadeniya","636",1863,908,955
"2112215","Kandy","Pathadumbara","Pihilladeniya","639",2022,923,1099
"2112220","Kandy","Pathadumbara","Gunnepana Madige","638",2570,1251,1319
"2112225","Kandy","Pathadumbara","Polgolla","609",2054,965,1089
"2112230","Kandy","Pathadumbara","Balanagala","610",1545,727,818
"2112235","Kandy","Pathadumbara","Nawayalathenna","608",2363,1054,1309
"2112240","Kandy","Pathadumbara","Kahalla","605",2470,1176,1294
"2112245","Kandy","Pathadumbara","Kalugalawatta","606",2190,1039,1151
"2112250","Kandy","Pathadumbara","Galewatta","607",1883,873,1010
"2112255","Kandy","Pathadumbara","Abasingama","635",1175,525,650
"2112260","Kandy","Pathadumbara","Hamindagoda","634",1035,495,540
"2115005","Kandy","Panvila","Kelebokka","735",4071,1830,2241
"2115010","Kandy","Panvila","Watakele","734",813,380,433
"2115015","Kandy","Panvila","Mahapathana","733",2314,1031,1283
"2115020","Kandy","Panvila","Kosgama","739",2497,1209,1288
"2115025","Kandy","Panvila","Thawalanthenna","737",2754,1246,1508
"2115030","Kandy","Panvila","Gomaraya","738",1061,468,593
"2115035","Kandy","Panvila","Beddegama","736",866,394,472
"2115040","Kandy","Panvila","Arattana","730",1539,714,825
"2115045","Kandy","Panvila","Madulkele","731",2835,1347,1488
"2115050","Kandy","Panvila","Hathale","732",1636,789,847
"2115055","Kandy","Panvila","Angammana","728",1536,730,806
"2115060","Kandy","Panvila","Udugoda","726",1176,586,590
"2115065","Kandy","Panvila","Pitawala","727",785,383,402
"2115070","Kandy","Panvila","Panvila","729",2411,1106,1305
"2118005","Kandy","Udadumbara","Meemure","893",282,148,134
"2118010","Kandy","Udadumbara","Kumbukgolla","895",248,126,122
"2118015","Kandy","Udadumbara","Kaikawala","894",116,80,36
"2118020","Kandy","Udadumbara","Pusseela","897",272,136,136
"2118025","Kandy","Udadumbara","Karambaketiya","896",76,40,36
"2118035","Kandy","Udadumbara","Moonamalpelessa","880",321,153,168
"2118040","Kandy","Udadumbara","Kalugala","885",268,127,141
"2118045","Kandy","Udadumbara","Udailuka","887",351,175,176
"2118050","Kandy","Udadumbara","Padupola","874",187,89,98
"2118055","Kandy","Udadumbara","Udakumbura","873",226,112,114
"2118060","Kandy","Udadumbara","Kalugaloya","886",362,168,194
"2118065","Kandy","Udadumbara","Dumbaragama","881",762,362,400
"2118070","Kandy","Udadumbara","Pallewela","878",479,236,243
"2118075","Kandy","Udadumbara","Udawela","888",430,213,217
"2118080","Kandy","Udadumbara","Kandegama","889",249,127,122
"2118085","Kandy","Udadumbara","Wadawalakanda","890",273,132,141
"2118090","Kandy","Udadumbara","Kobonilla","891",356,167,189
"2118095","Kandy","Udadumbara","Pallekanda","892",213,120,93
"2118100","Kandy","Udadumbara","Hanwella","882",230,114,116
"2118105","Kandy","Udadumbara","Andideniya","884",440,220,220
"2118110","Kandy","Udadumbara","Dambagahapitiya","883",295,132,163
"2118115","Kandy","Udadumbara","Poppitiya","871",237,113,124
"2118120","Kandy","Udadumbara","Oyathenna","872",461,224,237
"2118125","Kandy","Udadumbara","Thalagune","875",326,143,183
"2118130","Kandy","Udadumbara","Gedaramada","876",199,101,98
"2118135","Kandy","Udadumbara","Kirigankumbura","877",588,278,310
"2118140","Kandy","Udadumbara","Udadumbara","847",538,279,259
"2118145","Kandy","Udadumbara","Nawanagala","848",390,191,199
"2118150","Kandy","Udadumbara","Hunnasgiriya","843",1199,649,550
"2118155","Kandy","Udadumbara","Kiripattiya","851",467,222,245
"2118160","Kandy","Udadumbara","Halyala","845",336,162,174
"2118165","Kandy","Udadumbara","Mendiriya","846",284,136,148
"2118170","Kandy","Udadumbara","Gangoda","855",419,215,204
"2118175","Kandy","Udadumbara","Udapitawala","866",636,301,335
"2118180","Kandy","Udadumbara","Mahawala","870",324,152,172
"2118185","Kandy","Udadumbara","Pitawala Udagammedda","868",256,124,132
"2118190","Kandy","Udadumbara","Godakumbura","854",222,107,115
"2118195","Kandy","Udadumbara","Mediwaka","852",484,227,257
"2118200","Kandy","Udadumbara","Karandagolla","853",164,86,78
"2118205","Kandy","Udadumbara","Rambukwella East","850",280,148,132
"2118210","Kandy","Udadumbara","Rambukwella West","849",212,99,113
"2118215","Kandy","Udadumbara","Denapitiya","844",371,174,197
"2118220","Kandy","Udadumbara","Nugethenna East","842",293,141,152
"2118225","Kandy","Udadumbara","Nugethenna West","841",545,261,284
"2118230","Kandy","Udadumbara","Kevulgama","840",246,118,128
"2118235","Kandy","Udadumbara","Ganegala","839",260,123,137
"2118240","Kandy","Udadumbara","Minuwangamuwa","856",464,229,235
"2118245","Kandy","Udadumbara","Kalalgamuwa","857",438,211,227
"2118250","Kandy","Udadumbara","Pitawala","867",195,99,96
"2118255","Kandy","Udadumbara","Dewahandiya East","863",224,113,111
"2118260","Kandy","Udadumbara","Hapukanda East","865",274,141,133
"2118265","Kandy","Udadumbara","Hapukanda West","864",271,136,135
"2118270","Kandy","Udadumbara","Madugalla Udagammedda","858",422,199,223
"2118275","Kandy","Udadumbara","Madugalla North","859",335,158,177
"2118280","Kandy","Udadumbara","Madugalla South","860",414,203,211
"2118285","Kandy","Udadumbara","Pamunethenna","835",152,83,69
"2118290","Kandy","Udadumbara","Devinnegama","838",649,292,357
"2118295","Kandy","Udadumbara","Bambarabedda East","836",806,389,417
"2118300","Kandy","Udadumbara","Bambarabedda West","837",460,214,246
"2118305","Kandy","Udadumbara","Pitigoda","834",145,75,70
"2118310","Kandy","Udadumbara","Kalawala","861",320,178,142
"2118315","Kandy","Udadumbara","Dewahandiya West","862",378,181,197
"2121005","Kandy","Minipe","Galamuduna","898",108,56,52
"2121010","Kandy","Minipe","Dungolla","900",198,95,103
"2121015","Kandy","Minipe","Thotillagas Ella","904",1704,813,891
"2121020","Kandy","Minipe","Palugolla","906",1360,672,688
"2121025","Kandy","Minipe","Wewere","907",2174,1060,1114
"2121030","Kandy","Minipe","Dehemigama","905",1589,790,799
"2121035","Kandy","Minipe","Himbutuwa","903",1138,580,558
"2121040","Kandy","Minipe","Udattawa North","911",790,389,401
"2121045","Kandy","Minipe","Pallegaladebokka","901",324,162,162
"2121050","Kandy","Minipe","Udagaladebokka","899",107,57,50
"2121055","Kandy","Minipe","Udattawa","912",999,476,523
"2121060","Kandy","Minipe","Dambagahawela","902",1185,569,616
"2121065","Kandy","Minipe","Kindigoda North","908",1248,616,632
"2121070","Kandy","Minipe","Udawela","910",1580,737,843
"2121075","Kandy","Minipe","Kindigoda South","909",1423,724,699
"2121080","Kandy","Minipe","Ulpathagama","914",923,464,459
"2121085","Kandy","Minipe","Ambagolla","913",740,355,385
"2121090","Kandy","Minipe","Dambepitiya","915",1356,694,662
"2121095","Kandy","Minipe","Welgahawadiya","918",356,170,186
"2121100","Kandy","Minipe","Mahayaya North","916",1102,511,591
"2121105","Kandy","Minipe","08 Ela","921",671,327,344
"2121110","Kandy","Minipe","Welgala","923",839,400,439
"2121115","Kandy","Minipe","Mahayaya South","917",1188,583,605
"2121120","Kandy","Minipe","Thorapitiya","919",804,395,409
"2121125","Kandy","Minipe","Keenapelessa","920",1408,707,701
"2121130","Kandy","Minipe","Mahagalaheenna","922",817,384,433
"2121135","Kandy","Minipe","Hasalaka","924",1443,764,679
"2121140","Kandy","Minipe","Pallewatta","930",1910,959,951
"2121145","Kandy","Minipe","Hasalaka Nagaraya","928",1416,703,713
"2121150","Kandy","Minipe","Maha Eswedduma","925",1206,572,634
"2121155","Kandy","Minipe","Rathnella","926",1278,606,672
"2121160","Kandy","Minipe","Gurulupotha","927",804,408,396
"2121165","Kandy","Minipe","Waragolla","929",1038,500,538
"2121170","Kandy","Minipe","Weragama","931",1661,817,844
"2121175","Kandy","Minipe","Bulathwelkandura","932",1698,841,857
"2121180","Kandy","Minipe","Weraganthota","933",828,406,422
"2121185","Kandy","Minipe","Morayaya","934",1149,548,601
"2121190","Kandy","Minipe","Lunumadalaketiya","935",1188,569,619
"2121195","Kandy","Minipe","Diyabubula","936",1134,585,549
"2121200","Kandy","Minipe","Handaganawa","937",1691,784,907
"2121205","Kandy","Minipe","Batumulla","938",1407,709,698
"2121210","Kandy","Minipe","Udayagala","939",688,325,363
"2121215","Kandy","Minipe","Asamodagamyaya","940",688,331,357
"2121220","Kandy","Minipe","Ambagahapelessa","941",898,440,458
"2121225","Kandy","Minipe","Muttettuthenna","942",1129,569,560
"2121230","Kandy","Minipe","Minipe","943",1285,635,650
"2121235","Kandy","Minipe","Kolonyaya","944",620,309,311
"2121240","Kandy","Minipe","Bembiya","945",593,302,291
"2124005","Kandy","Medadumbara","Elliyadda","745",253,117,136
"2124010","Kandy","Medadumbara","Thunisgala","742",800,385,415
"2124015","Kandy","Medadumbara","Gonawala","740",398,189,209
"2124020","Kandy","Medadumbara","Thangappuwa","793",269,121,148
"2124025","Kandy","Medadumbara","Kotaganga","741",698,331,367
"2124030","Kandy","Medadumbara","Bulathwatta","749",504,231,273
"2124035","Kandy","Medadumbara","Galabadawatta","743",357,161,196
"2124040","Kandy","Medadumbara","Nagolla","744",319,162,157
"2124045","Kandy","Medadumbara","Galkotuwa","746",294,159,135
"2124050","Kandy","Medadumbara","Werapitiya","747",489,246,243
"2124055","Kandy","Medadumbara","Werathenna","748",282,135,147
"2124060","Kandy","Medadumbara","Randiwela","753",1089,481,608
"2124065","Kandy","Medadumbara","Bobebila","781",773,344,429
"2124070","Kandy","Medadumbara","Duckwariya","792",782,356,426
"2124075","Kandy","Medadumbara","Rangala Aluthwatta","790",437,213,224
"2124080","Kandy","Medadumbara","Ferndail","794",332,151,181
"2124085","Kandy","Medadumbara","Hakmana","800",529,255,274
"2124090","Kandy","Medadumbara","Burnside","795",174,71,103
"2124095","Kandy","Medadumbara","Rangala","791",596,247,349
"2124100","Kandy","Medadumbara","Weladaramba","788",455,210,245
"2124105","Kandy","Medadumbara","Makuldeniya","782",944,440,504
"2124110","Kandy","Medadumbara","Waradiwela","780",336,140,196
"2124115","Kandy","Medadumbara","Giddawa-Waradiwela","752",443,203,240
"2124120","Kandy","Medadumbara","Dunhinna","750",1012,509,503
"2124125","Kandy","Medadumbara","Maneluwa","751",486,242,244
"2124130","Kandy","Medadumbara","Giddawa","756",613,307,306
"2124135","Kandy","Medadumbara","Weliketiya","754",286,136,150
"2124140","Kandy","Medadumbara","Putuhapuwa","755",647,294,353
"2124145","Kandy","Medadumbara","Udabage","779",501,241,260
"2124150","Kandy","Medadumbara","Amupitiya","778",797,392,405
"2124155","Kandy","Medadumbara","Godamunna","783",578,270,308
"2124160","Kandy","Medadumbara","Katugoda","789",436,213,223
"2124165","Kandy","Medadumbara","Heeloya","796",768,356,412
"2124170","Kandy","Medadumbara","Kandekumbura","802",374,189,185
"2124175","Kandy","Medadumbara","Retiyagama","801",400,189,211
"2124180","Kandy","Medadumbara","Poddalgoda","787",493,240,253
"2124185","Kandy","Medadumbara","Nilgala","786",586,287,299
"2124190","Kandy","Medadumbara","Madeniyawaka","784",395,188,207
"2124195","Kandy","Medadumbara","Embalagama","777",493,216,277
"2124200","Kandy","Medadumbara","Siridigana","774",356,156,200
"2124205","Kandy","Medadumbara","Nugepathana","759",623,305,318
"2124210","Kandy","Medadumbara","Watapana","758",651,321,330
"2124215","Kandy","Medadumbara","Ambalagala","757",452,240,212
"2124220","Kandy","Medadumbara","Gangasirigama","760",956,482,474
"2124225","Kandy","Medadumbara","Madapola","761",955,447,508
"2124230","Kandy","Medadumbara","Kandegama","763",740,353,387
"2124235","Kandy","Medadumbara","Randeniya","765",867,396,471
"2124240","Kandy","Medadumbara","Pallebage","775",760,376,384
"2124245","Kandy","Medadumbara","Gabbela","776",788,351,437
"2124250","Kandy","Medadumbara","Udispattuwa","773",1417,664,753
"2124255","Kandy","Medadumbara","Ranmulla","772",926,462,464
"2124260","Kandy","Medadumbara","Maharawela","785",776,377,399
"2124265","Kandy","Medadumbara","Kurukohogama","797",493,235,258
"2124270","Kandy","Medadumbara","Kiribattalawa","798",381,175,206
"2124275","Kandy","Medadumbara","Hathiyalwela","804",859,398,461
"2124280","Kandy","Medadumbara","Mangoda","806",852,387,465
"2124285","Kandy","Medadumbara","Rambukpotha","807",683,327,356
"2124290","Kandy","Medadumbara","Namandagala","805",742,348,394
"2124295","Kandy","Medadumbara","Metideniya","803",500,222,278
"2124300","Kandy","Medadumbara","Doraliyadda South","799",621,316,305
"2124305","Kandy","Medadumbara","Wegala","771",676,328,348
"2124310","Kandy","Medadumbara","Meegahamaditta","770",737,368,369
"2124315","Kandy","Medadumbara","Rambukwella - East","769",772,339,433
"2124320","Kandy","Medadumbara","Rambukwella","768",511,241,270
"2124325","Kandy","Medadumbara","Udawela","766",579,264,315
"2124330","Kandy","Medadumbara","Wellethota","767",645,312,333
"2124335","Kandy","Medadumbara","Vilamuna","764",1069,528,541
"2124340","Kandy","Medadumbara","Karalliyadda","762",1828,841,987
"2124345","Kandy","Medadumbara","Ambagahalanda","833",1419,662,757
"2124350","Kandy","Medadumbara","Hijrapura","832",1621,748,873
"2124355","Kandy","Medadumbara","Galambalama","831",818,396,422
"2124360","Kandy","Medadumbara","Maberiyathenna","827",773,370,403
"2124365","Kandy","Medadumbara","Ellepola","830",757,359,398
"2124370","Kandy","Medadumbara","Wewegama","829",473,225,248
"2124375","Kandy","Medadumbara","Senarathwela","828",715,304,411
"2124380","Kandy","Medadumbara","Nithulemada","826",1935,910,1025
"2124385","Kandy","Medadumbara","Udathenna","811",937,439,498
"2124390","Kandy","Medadumbara","Medamahanuwara","810",874,443,431
"2124395","Kandy","Medadumbara","Bomure","809",391,180,211
"2124400","Kandy","Medadumbara","Rajagala","808",711,343,368
"2124405","Kandy","Medadumbara","Wathuliyadda","813",561,282,279
"2124410","Kandy","Medadumbara","Moragahamula","812",604,295,309
"2124415","Kandy","Medadumbara","Mahadoraliyadda","814",658,300,358
"2124420","Kandy","Medadumbara","Victoria","825",0,0,0
"2124425","Kandy","Medadumbara","Puwakgahadiwela","817",844,402,442
"2124430","Kandy","Medadumbara","Ambale","815",634,315,319
"2124435","Kandy","Medadumbara","Meeriyagolla","816",450,187,263
"2124440","Kandy","Medadumbara","Bambaragahadeniya","818",744,333,411
"2124445","Kandy","Medadumbara","Meegahalanda","821",634,297,337
"2124450","Kandy","Medadumbara","Sandasiri Dunuvila","819",442,200,242
"2124455","Kandy","Medadumbara","Thennalanda","820",522,247,275
"2124460","Kandy","Medadumbara","Udagammedda","824",348,172,176
"2124465","Kandy","Medadumbara","Welapahala","822",261,124,137
"2124470","Kandy","Medadumbara","Meda Gammedda","823",275,143,132
"2127005","Kandy","Kundasale","Dunuhappawa","647",1312,627,685
"2127010","Kandy","Kundasale","Naranpanawa West","725",883,421,462
"2127015","Kandy","Kundasale","Kandekumbura","724",785,379,406
"2127020","Kandy","Kundasale","Alawathugirigama","649",1320,618,702
"2127025","Kandy","Kundasale","Galpihilla","646",962,450,512
"2127030","Kandy","Kundasale","Makkanigama","648",864,388,476
"2127035","Kandy","Kundasale","Wavinna","671",1122,548,574
"2127040","Kandy","Kundasale","Pallegama","670",1013,490,523
"2127045","Kandy","Kundasale","Maharathenna West","675",736,353,383
"2127050","Kandy","Kundasale","Udagama North","672",922,442,480
"2127055","Kandy","Kundasale","Ihala Gonagama","676",824,400,424
"2127060","Kandy","Kundasale","Delgaslanda","708",961,461,500
"2127065","Kandy","Kundasale","Lunuketiyamaditta","709",1073,502,571
"2127070","Kandy","Kundasale","Naranpanawa East","723",711,313,398
"2127075","Kandy","Kundasale","Kuruambemuduna","722",605,293,312
"2127080","Kandy","Kundasale","Maluwegama","720",1371,641,730
"2127085","Kandy","Kundasale","Wepathana","721",910,436,474
"2127090","Kandy","Kundasale","Gonawala North","718",2011,968,1043
"2127095","Kandy","Kundasale","Deliwalathenna","710",828,397,431
"2127100","Kandy","Kundasale","Heepitiya","711",1496,704,792
"2127105","Kandy","Kundasale","Udagama South","673",1015,479,536
"2127110","Kandy","Kundasale","Maharathenna East","674",968,467,501
"2127115","Kandy","Kundasale","Menikhinna","705",2696,1298,1398
"2127120","Kandy","Kundasale","Hurikaduwa North","678",1837,934,903
"2127125","Kandy","Kundasale","Hurikaduwa West","677",1529,713,816
"2127130","Kandy","Kundasale","Bogaskumbura","661",1269,623,646
"2127135","Kandy","Kundasale","Pilawala North","660",1301,610,691
"2127140","Kandy","Kundasale","Amunugama North","656",1136,528,608
"2127145","Kandy","Kundasale","Amunugama South","657",983,493,490
"2127150","Kandy","Kundasale","Udagunnepana South","667",954,416,538
"2127155","Kandy","Kundasale","Udagunnepana North","666",1441,596,845
"2127160","Kandy","Kundasale","Gabadagama South","668",962,476,486
"2127165","Kandy","Kundasale","Gabadagama North","669",1368,670,698
"2127170","Kandy","Kundasale","Pallegunnepana South","665",2623,1099,1524
"2127175","Kandy","Kundasale","Pallegunnepana North","664",1692,816,876
"2127180","Kandy","Kundasale","Sirimalwatta West","651",1320,649,671
"2127185","Kandy","Kundasale","Sirimalwatta East","650",893,425,468
"2127190","Kandy","Kundasale","Sirimalwatta Pallegama","653",1234,569,665
"2127195","Kandy","Kundasale","Lewellagama","655",1620,781,839
"2127200","Kandy","Kundasale","Degaldoruwa","652",1031,472,559
"2127205","Kandy","Kundasale","Deekirimadawala","659",1324,584,740
"2127210","Kandy","Kundasale","Hapuwala","658",1087,535,552
"2127215","Kandy","Kundasale","Galapitaambe","663",1213,572,641
"2127220","Kandy","Kundasale","Hathamuna","707",1415,686,729
"2127225","Kandy","Kundasale","Dodamgolla","682",1544,741,803
"2127230","Kandy","Kundasale","Hurikaduwa South","679",1077,519,558
"2127235","Kandy","Kundasale","Hurikaduwa East","680",1653,808,845
"2127240","Kandy","Kundasale","Hurikaduwa Madige","704",990,512,478
"2127245","Kandy","Kundasale","Galamuna","713",1248,551,697
"2127250","Kandy","Kundasale","Malpana","712",1468,688,780
"2127255","Kandy","Kundasale","Ahaspokuna North","714",1684,835,849
"2127260","Kandy","Kundasale","Gonawala South","719",1483,696,787
"2127265","Kandy","Kundasale","Kumbukkandura South","717",1096,493,603
"2127270","Kandy","Kundasale","Kumbukkandura North","716",1663,1046,617
"2127275","Kandy","Kundasale","Rajawella North","696",3111,1502,1609
"2127280","Kandy","Kundasale","Ahaspokuna South","715",2216,1076,1140
"2127285","Kandy","Kundasale","Ihalawela","701",2316,1058,1258
"2127290","Kandy","Kundasale","Kengalla","700",3450,1379,2071
"2127295","Kandy","Kundasale","Nithulethenna","681",1330,606,724
"2127300","Kandy","Kundasale","Dambarawa","706",1575,761,814
"2127305","Kandy","Kundasale","Pilawala South","662",1073,506,567
"2127310","Kandy","Kundasale","Mahawatta East","690",659,310,349
"2127315","Kandy","Kundasale","Mahawatta North","689",1752,829,923
"2127320","Kandy","Kundasale","Mahawatta West","688",874,398,476
"2127325","Kandy","Kundasale","Mahawatta South","687",1321,628,693
"2127330","Kandy","Kundasale","Arangala North","685",944,443,501
"2127335","Kandy","Kundasale","Karattamada","654",650,311,339
"2127340","Kandy","Kundasale","Arangala South","686",1075,502,573
"2127345","Kandy","Kundasale","Galmaduwa","683",2401,1141,1260
"2127350","Kandy","Kundasale","Nattarampotha","684",2241,1086,1155
"2127355","Kandy","Kundasale","Kundasale North","691",4633,2326,2307
"2127360","Kandy","Kundasale","Kundasale South","692",7040,3763,3277
"2127365","Kandy","Kundasale","Balagolla West","699",1929,853,1076
"2127370","Kandy","Kundasale","Balagolla East","698",4164,1711,2453
"2127375","Kandy","Kundasale","Aswalapitiya","702",1157,549,608
"2127380","Kandy","Kundasale","Diyabubula","703",2589,1215,1374
"2127385","Kandy","Kundasale","Rajawella South","697",1286,626,660
"2127390","Kandy","Kundasale","Aluth Pallekele","694",3185,1543,1642
"2127395","Kandy","Kundasale","Wijaya Sri Gama","693",2343,1092,1251
"2127400","Kandy","Kundasale","Ambakotayawatta","695",4230,2164,2066
"2130005","Kandy","Kandy Four Gravets & Gangawata Korale","Mavilmada","227",2514,1156,1358
"2130010","Kandy","Kandy Four Gravets & Gangawata Korale","Siyambalagasthenna","226",1724,803,921
"2130015","Kandy","Kandy Four Gravets & Gangawata Korale","Pitakanda Gama","250",1842,998,844
"2130020","Kandy","Kandy Four Gravets & Gangawata Korale","Senkadagala","251",2065,1036,1029
"2130025","Kandy","Kandy Four Gravets & Gangawata Korale","Wattaranthenna","238",2270,1087,1183
"2130030","Kandy","Kandy Four Gravets & Gangawata Korale","Nittawela","225",3138,1497,1641
"2130035","Kandy","Kandy Four Gravets & Gangawata Korale","Watapuluwa","228",1987,978,1009
"2130040","Kandy","Kandy Four Gravets & Gangawata Korale","Mahaweli Uyana","231",1191,512,679
"2130045","Kandy","Kandy Four Gravets & Gangawata Korale","Watapuluwa South","230",1617,776,841
"2130050","Kandy","Kandy Four Gravets & Gangawata Korale","Aruppala East","224",1599,749,850
"2130055","Kandy","Kandy Four Gravets & Gangawata Korale","Aruppala West","223",2742,1316,1426
"2130060","Kandy","Kandy Four Gravets & Gangawata Korale","Watapuluwa West","229",2149,1022,1127
"2130065","Kandy","Kandy Four Gravets & Gangawata Korale","Mahaiyawa","239",2111,1020,1091
"2130070","Kandy","Kandy Four Gravets & Gangawata Korale","Mapanawathura","237",2877,1355,1522
"2130075","Kandy","Kandy Four Gravets & Gangawata Korale","Poorna Watta East","241",1602,765,837
"2130080","Kandy","Kandy Four Gravets & Gangawata Korale","Poorna Watta West","240",5238,2533,2705
"2130085","Kandy","Kandy Four Gravets & Gangawata Korale","Asgiriya","235",2244,1214,1030
"2130090","Kandy","Kandy Four Gravets & Gangawata Korale","Bahirawa Kanda","236",2744,1290,1454
"2130095","Kandy","Kandy Four Gravets & Gangawata Korale","Nuwara Dodamwala","232",1734,854,880
"2130100","Kandy","Kandy Four Gravets & Gangawata Korale","Aniwatta East","234",2012,922,1090
"2130105","Kandy","Kandy Four Gravets & Gangawata Korale","Katukele West","256",1673,877,796
"2130110","Kandy","Kandy Four Gravets & Gangawata Korale","Katukele","255",2315,941,1374
"2130115","Kandy","Kandy Four Gravets & Gangawata Korale","Ihala Katukele","258",2219,1022,1197
"2130120","Kandy","Kandy Four Gravets & Gangawata Korale","Mahanuwara","257",2012,1337,675
"2130125","Kandy","Kandy Four Gravets & Gangawata Korale","Lewella","222",1778,863,915
"2130130","Kandy","Kandy Four Gravets & Gangawata Korale","Thalwatta","221",3220,1531,1689
"2130135","Kandy","Kandy Four Gravets & Gangawata Korale","Boowelikada","220",1372,690,682
"2130140","Kandy","Kandy Four Gravets & Gangawata Korale","Malwatta","254",2001,924,1077
"2130145","Kandy","Kandy Four Gravets & Gangawata Korale","Bogambara","264",3195,2391,804
"2130150","Kandy","Kandy Four Gravets & Gangawata Korale","Deiyannewela","261",2412,1096,1316
"2130155","Kandy","Kandy Four Gravets & Gangawata Korale","Nagasthenna","262",3526,1585,1941
"2130160","Kandy","Kandy Four Gravets & Gangawata Korale","Suduhumpala East","265",2553,1242,1311
"2130165","Kandy","Kandy Four Gravets & Gangawata Korale","Suduhumpala West","266",2392,1097,1295
"2130170","Kandy","Kandy Four Gravets & Gangawata Korale","Welata","260",2416,1060,1356
"2130175","Kandy","Kandy Four Gravets & Gangawata Korale","Aniwatta West","233",1698,783,915
"2130180","Kandy","Kandy Four Gravets & Gangawata Korale","Getambe","259",2867,1315,1552
"2130185","Kandy","Kandy Four Gravets & Gangawata Korale","Pahala Eriyagama","282",2503,1195,1308
"2130190","Kandy","Kandy Four Gravets & Gangawata Korale","Godagandeniya","283",1578,849,729
"2130195","Kandy","Kandy Four Gravets & Gangawata Korale","Palle Peradeniya","248",4942,1914,3028
"2130200","Kandy","Kandy Four Gravets & Gangawata Korale","Uda Bowala","244",4127,1945,2182
"2130205","Kandy","Kandy Four Gravets & Gangawata Korale","Bowala","245",4499,2104,2395
"2130210","Kandy","Kandy Four Gravets & Gangawata Korale","Mulgampala","243",2719,1273,1446
"2130215","Kandy","Kandy Four Gravets & Gangawata Korale","Heeressagala","242",3726,1824,1902
"2130220","Kandy","Kandy Four Gravets & Gangawata Korale","Hanthana Pedesa","263",1766,890,876
"2130225","Kandy","Kandy Four Gravets & Gangawata Korale","Ampitiya South","253",1705,776,929
"2130230","Kandy","Kandy Four Gravets & Gangawata Korale","Ampitiya North","252",2675,1283,1392
"2130235","Kandy","Kandy Four Gravets & Gangawata Korale","Ampitiya Udagama North","269",2080,1030,1050
"2130240","Kandy","Kandy Four Gravets & Gangawata Korale","Thennakumbura","275",6195,2937,3258
"2130245","Kandy","Kandy Four Gravets & Gangawata Korale","Ampitiya Pallegama","271",2620,1196,1424
"2130250","Kandy","Kandy Four Gravets & Gangawata Korale","Meddegama","272",1700,809,891
"2130255","Kandy","Kandy Four Gravets & Gangawata Korale","Ampitiya Udagama South","270",1715,803,912
"2130260","Kandy","Kandy Four Gravets & Gangawata Korale","Wewathenna","274",2869,1356,1513
"2130265","Kandy","Kandy Four Gravets & Gangawata Korale","Ulpathakumbura","273",2314,1085,1229
"2130270","Kandy","Kandy Four Gravets & Gangawata Korale","Gurudeniya West","278",1435,664,771
"2130275","Kandy","Kandy Four Gravets & Gangawata Korale","Gurudeniya East","276",3057,1508,1549
"2130280","Kandy","Kandy Four Gravets & Gangawata Korale","Maligathenna","279",2565,1190,1375
"2130285","Kandy","Kandy Four Gravets & Gangawata Korale","Gurudeniya Dambawela","277",1570,755,815
"2130290","Kandy","Kandy Four Gravets & Gangawata Korale","Lewla","280",1127,512,615
"2130295","Kandy","Kandy Four Gravets & Gangawata Korale","Ketawala","281",1351,656,695
"2130300","Kandy","Kandy Four Gravets & Gangawata Korale","Bowalawatta","247",2535,1249,1286
"2130305","Kandy","Kandy Four Gravets & Gangawata Korale","Ogastawatta","246",3803,1955,1848
"2130310","Kandy","Kandy Four Gravets & Gangawata Korale","Uda Peradeniya","249",2515,1201,1314
"2130315","Kandy","Kandy Four Gravets & Gangawata Korale","Hindagala","267",2596,1184,1412
"2130320","Kandy","Kandy Four Gravets & Gangawata Korale","Mahakanda","268",3225,1504,1721
"2133005","Kandy","Harispattuwa","Amuwathdeniya","488",627,272,355
"2133010","Kandy","Harispattuwa","Doranegama","487",528,244,284
"2133015","Kandy","Harispattuwa","Ihagama","489",890,415,475
"2133020","Kandy","Harispattuwa","Medawala","484",1500,687,813
"2133025","Kandy","Harispattuwa","Angoda","485",467,212,255
"2133030","Kandy","Harispattuwa","Dembaralawa","486",1116,525,591
"2133035","Kandy","Harispattuwa","Bothota","483",1083,495,588
"2133040","Kandy","Harispattuwa","Attaragama East","481",919,413,506
"2133045","Kandy","Harispattuwa","Attaragama","480",975,467,508
"2133050","Kandy","Harispattuwa","Gonigoda-Palkumbura","468",835,386,449
"2133055","Kandy","Harispattuwa","Gonigoda","467",676,315,361
"2133060","Kandy","Harispattuwa","Attaragama South","482",994,472,522
"2133065","Kandy","Harispattuwa","Hapugoda","408",1066,501,565
"2133070","Kandy","Harispattuwa","Udabokalawela","411",1099,523,576
"2133075","Kandy","Harispattuwa","Rajapihilla","463",1479,707,772
"2133080","Kandy","Harispattuwa","Ulladupitiya East","465",649,289,360
"2133085","Kandy","Harispattuwa","Ulladupitiya West","466",799,380,419
"2133090","Kandy","Harispattuwa","Arambegama","470",1194,567,627
"2133095","Kandy","Harispattuwa","Aladeniya","471",1001,494,507
"2133100","Kandy","Harispattuwa","Hedeniya","472",1016,507,509
"2133105","Kandy","Harispattuwa","Rajasinghagama","476",905,426,479
"2133110","Kandy","Harispattuwa","Palkumbura","475",863,414,449
"2133115","Kandy","Harispattuwa","Narangoda","473",647,326,321
"2133120","Kandy","Harispattuwa","Kurundugolla","474",1303,609,694
"2133125","Kandy","Harispattuwa","Viguhumpola","469",1622,737,885
"2133130","Kandy","Harispattuwa","Hiriyalagammana","455",1272,612,660
"2133135","Kandy","Harispattuwa","Thittapajjala","461",1205,589,616
"2133140","Kandy","Harispattuwa","Thittapajjala North","462",870,398,472
"2133145","Kandy","Harispattuwa","Nugawela","452",2232,1096,1136
"2133150","Kandy","Harispattuwa","Batuambe","454",896,430,466
"2133155","Kandy","Harispattuwa","Endaruthenna","464",553,248,305
"2133160","Kandy","Harispattuwa","Embulpuraya","453",808,391,417
"2133165","Kandy","Harispattuwa","Uduwawala West","417",1030,494,536
"2133170","Kandy","Harispattuwa","Uduwawala North","418",944,453,491
"2133175","Kandy","Harispattuwa","Pallebokalawela","412",909,449,460
"2133180","Kandy","Harispattuwa","Ranawana West","409",1448,681,767
"2133185","Kandy","Harispattuwa","Ranawana East","410",1605,751,854
"2133190","Kandy","Harispattuwa","Uduwawala East","419",1371,676,695
"2133195","Kandy","Harispattuwa","Senarathgama North","425",1133,525,608
"2133200","Kandy","Harispattuwa","Wathuwala","490",1002,486,516
"2133205","Kandy","Harispattuwa","Uyanwatta","491",924,435,489
"2133210","Kandy","Harispattuwa","Dadahogama","449",909,423,486
"2133215","Kandy","Harispattuwa","Mapamadulla","450",890,432,458
"2133220","Kandy","Harispattuwa","Malagammana","451",357,177,180
"2133225","Kandy","Harispattuwa","Ruwanpuraya","460",876,427,449
"2133230","Kandy","Harispattuwa","Kurunduwatta","456",719,348,371
"2133235","Kandy","Harispattuwa","Karanduwawala Ihala","477",684,307,377
"2133240","Kandy","Harispattuwa","Karanduwawala Pahala","478",457,214,243
"2133245","Kandy","Harispattuwa","Owathenna","479",696,351,345
"2133250","Kandy","Harispattuwa","Yahalathenna West","459",563,225,338
"2133255","Kandy","Harispattuwa","Yahalathenna Kanda","457",1050,514,536
"2133260","Kandy","Harispattuwa","Kulugammana","447",1585,709,876
"2133265","Kandy","Harispattuwa","Uguressapitiya","426",1609,753,856
"2133270","Kandy","Harispattuwa","Senarathgama South","424",1730,811,919
"2133275","Kandy","Harispattuwa","Kondadeniya","423",1400,695,705
"2133280","Kandy","Harispattuwa","Etamurungagoda","414",1202,557,645
"2133285","Kandy","Harispattuwa","Yatiwawala","415",1736,818,918
"2133290","Kandy","Harispattuwa","Katugasthota","413",1304,671,633
"2133295","Kandy","Harispattuwa","Inigala","416",2016,923,1093
"2133300","Kandy","Harispattuwa","Rathmale","422",2156,1038,1118
"2133305","Kandy","Harispattuwa","Hamangoda North","436",2001,959,1042
"2133310","Kandy","Harispattuwa","Hamangoda South","437",965,417,548
"2133315","Kandy","Harispattuwa","Uggalla","427",825,401,424
"2133320","Kandy","Harispattuwa","Udadoolwala","442",700,331,369
"2133325","Kandy","Harispattuwa","Kurundugahamada","448",406,198,208
"2133330","Kandy","Harispattuwa","Seewaleekanda","446",551,261,290
"2133335","Kandy","Harispattuwa","Mahathenna","458",904,426,478
"2133340","Kandy","Harispattuwa","Bulathgolla","444",747,327,420
"2133345","Kandy","Harispattuwa","Yatihalagala Udagama","445",737,358,379
"2133350","Kandy","Harispattuwa","Pahala Doolwala","443",598,274,324
"2133355","Kandy","Harispattuwa","Udamulla","433",1068,495,573
"2133360","Kandy","Harispattuwa","Gohagoda","429",1793,860,933
"2133365","Kandy","Harispattuwa","Wegiriya","421",1185,578,607
"2133370","Kandy","Harispattuwa","Polwatta","420",2363,1150,1213
"2133375","Kandy","Harispattuwa","Madapathagama","428",746,368,378
"2133380","Kandy","Harispattuwa","Banwelgolla","431",837,406,431
"2133385","Kandy","Harispattuwa","Narangaskumbura","430",542,252,290
"2133390","Kandy","Harispattuwa","Pallemulla","432",1020,468,552
"2133395","Kandy","Harispattuwa","Haloluwa Pallegama","434",747,337,410
"2133400","Kandy","Harispattuwa","Bogahakanda","438",598,289,309
"2133405","Kandy","Harispattuwa","Yatihalagala Pallegama","440",840,371,469
"2133410","Kandy","Harispattuwa","Haloluwa","435",1757,874,883
"2133415","Kandy","Harispattuwa","Kumburegedara","441",726,341,385
"2133420","Kandy","Harispattuwa","Warathenna","439",1127,536,591
"2134005","Kandy","Hatharaliyadda","Paragoda","375",354,152,202
"2134010","Kandy","Hatharaliyadda","Aludeniya North","374",501,244,257
"2134015","Kandy","Hatharaliyadda","Aludeniya South","376",719,331,388
"2134020","Kandy","Hatharaliyadda","Alakolamaditta","377",493,252,241
"2134025","Kandy","Hatharaliyadda","Amboruwa","315",680,319,361
"2134030","Kandy","Hatharaliyadda","Galdola","314",383,179,204
"2134035","Kandy","Hatharaliyadda","Polwatta Ihalagama","347",841,403,438
"2134040","Kandy","Hatharaliyadda","Ilpemada","346",914,444,470
"2134045","Kandy","Hatharaliyadda","Polwatta","323",554,268,286
"2134050","Kandy","Hatharaliyadda","Dunkumbura","324",451,204,247
"2134055","Kandy","Hatharaliyadda","Nikathenna","330",415,165,250
"2134060","Kandy","Hatharaliyadda","Narangaspitiya","336",335,163,172
"2134065","Kandy","Hatharaliyadda","Godathale","333",542,263,279
"2134070","Kandy","Hatharaliyadda","Kalotuwawa","334",710,337,373
"2134075","Kandy","Hatharaliyadda","Dedunupitiya Pahalagama","332",327,148,179
"2134080","Kandy","Hatharaliyadda","Damunupola","337",643,298,345
"2134085","Kandy","Hatharaliyadda","Pallepola","329",331,155,176
"2134090","Kandy","Hatharaliyadda","Welagama","335",448,220,228
"2134095","Kandy","Hatharaliyadda","Weligodapola","328",1146,539,607
"2134100","Kandy","Hatharaliyadda","Hatharaliyadda","350",690,383,307
"2134105","Kandy","Hatharaliyadda","Kanakkarapola North","348",494,225,269
"2134110","Kandy","Hatharaliyadda","Mawathagama","326",336,158,178
"2134115","Kandy","Hatharaliyadda","Imbulethenna","325",288,137,151
"2134120","Kandy","Hatharaliyadda","Welivita Ihala North","340",548,270,278
"2134125","Kandy","Hatharaliyadda","Welivita Ihalagama","338",523,243,280
"2134130","Kandy","Hatharaliyadda","Sivurupitiya","339",352,162,190
"2134135","Kandy","Hatharaliyadda","Eramuduliyadda","351",515,229,286
"2134140","Kandy","Hatharaliyadda","Muruddeniya","391",466,215,251
"2134145","Kandy","Hatharaliyadda","Walpalagolla North","395",341,159,182
"2134150","Kandy","Hatharaliyadda","Walpalagolla East","397",451,215,236
"2134155","Kandy","Hatharaliyadda","Walpalagolla South","396",501,250,251
"2134160","Kandy","Hatharaliyadda","Welivita Pahalagama","352",464,223,241
"2134165","Kandy","Hatharaliyadda","Handabowa","341",524,232,292
"2134170","Kandy","Hatharaliyadda","Meegasthenna","345",566,273,293
"2134175","Kandy","Hatharaliyadda","Kanakkarapola South","349",425,186,239
"2134180","Kandy","Hatharaliyadda","Avulbodale","327",242,126,116
"2134185","Kandy","Hatharaliyadda","Lechchimimenila","387",719,341,378
"2134190","Kandy","Hatharaliyadda","Yaggala","390",356,164,192
"2134195","Kandy","Hatharaliyadda","Rangamuwa","388",406,182,224
"2134200","Kandy","Hatharaliyadda","Dedunupitiya Ihalagama","331",417,195,222
"2134205","Kandy","Hatharaliyadda","Ambawa","389",429,208,221
"2134210","Kandy","Hatharaliyadda","Dehideniya Madige","386",920,487,433
"2134215","Kandy","Hatharaliyadda","Pelena Pahalagama","383",527,242,285
"2134220","Kandy","Hatharaliyadda","Pelena","384",554,267,287
"2134225","Kandy","Hatharaliyadda","Kandemeeya","385",560,254,306
"2134230","Kandy","Hatharaliyadda","Alagalla Pahalagama","381",789,352,437
"2134235","Kandy","Hatharaliyadda","Alagalla Ihala","382",791,400,391
"2134240","Kandy","Hatharaliyadda","Mudagammana","344",395,195,200
"2134245","Kandy","Hatharaliyadda","Pattapola Ihala","342",547,260,287
"2134250","Kandy","Hatharaliyadda","Pattapola Pahalagama","343",591,270,321
"2134255","Kandy","Hatharaliyadda","Welivita Pahalagama South","353",427,197,230
"2134260","Kandy","Hatharaliyadda","Andiyathenna","357",389,195,194
"2134265","Kandy","Hatharaliyadda","Kolugala","354",612,296,316
"2134270","Kandy","Hatharaliyadda","Kolugala Pahalagama","355",604,281,323
"2134275","Kandy","Hatharaliyadda","Kithuldora","356",510,245,265
"2134280","Kandy","Hatharaliyadda","Aluthgama Pahala","393",478,230,248
"2134285","Kandy","Hatharaliyadda","Aluthgama Ihala","394",452,211,241
"2136005","Kandy","Yatinuwara","Alagalla Watta","190",799,376,423
"2136010","Kandy","Yatinuwara","Kirimetiya Watta","186",941,472,469
"2136015","Kandy","Yatinuwara","Pahala Yatigammana","184",575,272,303
"2136020","Kandy","Yatinuwara","Yatigammana","183",540,266,274
"2136025","Kandy","Yatinuwara","Thismada","219",563,268,295
"2136030","Kandy","Yatinuwara","Kotaligoda North","215",1114,563,551
"2136035","Kandy","Yatinuwara","Udawela Nadithalawa","177",626,320,306
"2136040","Kandy","Yatinuwara","Udawela Pallemaditta","178",840,401,439
"2136045","Kandy","Yatinuwara","Wathurakumbura","157",1326,646,680
"2136050","Kandy","Yatinuwara","Gurugama","158",1525,695,830
"2136055","Kandy","Yatinuwara","Dehianga North","159",1268,581,687
"2136060","Kandy","Yatinuwara","Kobbekaduwa","141",1216,574,642
"2136065","Kandy","Yatinuwara","Ihala Kobbekaduwa","142",923,418,505
"2136070","Kandy","Yatinuwara","Pelawa Ihalagama","138",715,323,392
"2136075","Kandy","Yatinuwara","Yahalathenna","140",1365,620,745
"2136080","Kandy","Yatinuwara","Pelawa Ihala Meda","139",1315,625,690
"2136085","Kandy","Yatinuwara","Pelawa Pahalagama","137",1072,462,610
"2136090","Kandy","Yatinuwara","Gannoruwa West","135",1228,572,656
"2136095","Kandy","Yatinuwara","Dehigama East","143",1329,626,703
"2136100","Kandy","Yatinuwara","Dehigama South","145",817,374,443
"2136105","Kandy","Yatinuwara","Dehigama North","144",861,405,456
"2136110","Kandy","Yatinuwara","Dehianga South","160",1497,701,796
"2136115","Kandy","Yatinuwara","Pahala Dodamwala","156",1092,493,599
"2136120","Kandy","Yatinuwara","Ihala Dodamwala","155",696,355,341
"2136125","Kandy","Yatinuwara","Udawela Pahalagama","179",1177,556,621
"2136130","Kandy","Yatinuwara","Munwathugoda","162",880,407,473
"2136135","Kandy","Yatinuwara","Walgampaya","211",1784,836,948
"2136140","Kandy","Yatinuwara","Bathgoda","212",882,427,455
"2136145","Kandy","Yatinuwara","Doluwa East","213",651,303,348
"2136150","Kandy","Yatinuwara","Doluwa West","214",723,341,382
"2136155","Kandy","Yatinuwara","Kotaligoda South","216",768,350,418
"2136160","Kandy","Yatinuwara","Menikdiwela","217",1100,516,584
"2136165","Kandy","Yatinuwara","Pottepitiya","185",535,246,289
"2136170","Kandy","Yatinuwara","Ihala Alagalla","189",1508,718,790
"2136175","Kandy","Yatinuwara","Godigamuwa","187",643,326,317
"2136180","Kandy","Yatinuwara","Motana Dekinda","199",463,195,268
"2136185","Kandy","Yatinuwara","Gondeniya","188",629,294,335
"2136190","Kandy","Yatinuwara","Madiligama","195",482,233,249
"2136195","Kandy","Yatinuwara","Udarathmeewala","196",676,332,344
"2136200","Kandy","Yatinuwara","Pahala Rathmeewala","197",993,475,518
"2136205","Kandy","Yatinuwara","Deldeniya","218",902,389,513
"2136210","Kandy","Yatinuwara","Walgowwagoda","206",889,403,486
"2136215","Kandy","Yatinuwara","Kavudupana","207",786,389,397
"2136220","Kandy","Yatinuwara","Haliyadda","174",1207,552,655
"2136225","Kandy","Yatinuwara","Danthure","161",1746,843,903
"2136230","Kandy","Yatinuwara","Siyambalagoda","163",1431,711,720
"2136235","Kandy","Yatinuwara","Parakatawella","181",1248,605,643
"2136240","Kandy","Yatinuwara","Imbulmalgama","182",551,256,295
"2136245","Kandy","Yatinuwara","Diyapalagoda","147",1077,508,569
"2136250","Kandy","Yatinuwara","Mangalagama","146",1047,513,534
"2136255","Kandy","Yatinuwara","Karuwalawatta","128",1071,517,554
"2136260","Kandy","Yatinuwara","Gannoruwa Central","136",1504,688,816
"2136265","Kandy","Yatinuwara","Dehideniya West","154",990,464,526
"2136270","Kandy","Yatinuwara","Sooriyagoda","127",1784,861,923
"2136275","Kandy","Yatinuwara","Malgammana","149",764,349,415
"2136280","Kandy","Yatinuwara","Moladanda","148",1189,548,641
"2136285","Kandy","Yatinuwara","Giragama","180",934,423,511
"2136290","Kandy","Yatinuwara","Arambegama East","164",1358,649,709
"2136295","Kandy","Yatinuwara","Kudaoya","170",949,468,481
"2136300","Kandy","Yatinuwara","Kurunduwatta","169",783,394,389
"2136305","Kandy","Yatinuwara","Kandangama North","208",1897,878,1019
"2136310","Kandy","Yatinuwara","Mamudawala","201",604,290,314
"2136315","Kandy","Yatinuwara","Maligathenna","203",492,235,257
"2136320","Kandy","Yatinuwara","Ketakumbura","202",742,329,413
"2136325","Kandy","Yatinuwara","Amunupura","191",880,401,479
"2136330","Kandy","Yatinuwara","Moragolla Mahakanda","200",391,193,198
"2136335","Kandy","Yatinuwara","Balana","198",718,336,382
"2136340","Kandy","Yatinuwara","Weralugolla","192",829,406,423
"2136345","Kandy","Yatinuwara","Pahala Mudaliwatta","194",808,370,438
"2136350","Kandy","Yatinuwara","Mudaliwatta","193",765,362,403
"2136355","Kandy","Yatinuwara","Panabokka","210",1038,494,544
"2136360","Kandy","Yatinuwara","Kandangama South","209",709,337,372
"2136365","Kandy","Yatinuwara","Kotabogoda","175",1199,579,620
"2136370","Kandy","Yatinuwara","Urapola","168",1098,507,591
"2136375","Kandy","Yatinuwara","Arambegama West","165",1032,493,539
"2136380","Kandy","Yatinuwara","Embilmeegama North","166",1051,517,534
"2136385","Kandy","Yatinuwara","Ranawana","150",969,462,507
"2136390","Kandy","Yatinuwara","Bulumulla","125",1288,616,672
"2136395","Kandy","Yatinuwara","Pilapitiya","126",3208,1507,1701
"2136400","Kandy","Yatinuwara","Kiribathkumbura East","129",1567,755,812
"2136405","Kandy","Yatinuwara","Dehideniya East","153",1430,689,741
"2136410","Kandy","Yatinuwara","Kendakaduwa","134",1894,921,973
"2136415","Kandy","Yatinuwara","Gannoruwa East","133",2210,1287,923
"2136420","Kandy","Yatinuwara","Uda Eriyagama East","151",1268,597,671
"2136425","Kandy","Yatinuwara","Uda Eriyagama West","152",1146,509,637
"2136430","Kandy","Yatinuwara","Edanduwawa East","131",1583,858,725
"2136435","Kandy","Yatinuwara","Edanduwawa West","132",1657,799,858
"2136440","Kandy","Yatinuwara","Kiribathkumbura West","130",2193,1059,1134
"2136445","Kandy","Yatinuwara","Embilmeegama South","167",1568,754,814
"2136450","Kandy","Yatinuwara","Govindala","171",1403,691,712
"2136455","Kandy","Yatinuwara","Pilimathalawa","172",1629,839,790
"2136460","Kandy","Yatinuwara","Ilukwatta","173",2179,1146,1033
"2136465","Kandy","Yatinuwara","Madarangoda","176",1089,565,524
"2136470","Kandy","Yatinuwara","Kadawathgama","204",2172,1169,1003
"2136475","Kandy","Yatinuwara","Kadugannawa Town","205",974,478,496
"2139005","Kandy","Udunuwara","Gangoda","1",634,303,331
"2139010","Kandy","Udunuwara","Gangoda North","3",888,415,473
"2139015","Kandy","Udunuwara","Werellamana","5",692,347,345
"2139020","Kandy","Udunuwara","Thalawatta","4",650,313,337
"2139025","Kandy","Udunuwara","Boyagama","6",909,437,472
"2139030","Kandy","Udunuwara","Gangoda South","2",837,381,456
"2139035","Kandy","Udunuwara","Gadaladeniya North","81",1086,546,540
"2139040","Kandy","Udunuwara","Kiriwavula East","89",976,463,513
"2139045","Kandy","Udunuwara","Kiriwavula West","90",849,400,449
"2139050","Kandy","Udunuwara","Alanduwaka","122",1347,627,720
"2139055","Kandy","Udunuwara","Pahala Koorukuttala","118",1301,682,619
"2139060","Kandy","Udunuwara","Ihala Koorukuttala","117",1927,898,1029
"2139065","Kandy","Udunuwara","Belungala","115",981,453,528
"2139070","Kandy","Udunuwara","Lagamuwa","114",835,390,445
"2139075","Kandy","Udunuwara","Mathgamuwa","119",772,365,407
"2139080","Kandy","Udunuwara","Urulewatta","121",796,373,423
"2139085","Kandy","Udunuwara","Warakagoda","86",566,287,279
"2139090","Kandy","Udunuwara","Hepana","87",601,283,318
"2139095","Kandy","Udunuwara","Gadaladeniya South","82",620,292,328
"2139100","Kandy","Udunuwara","Deliwala","85",796,379,417
"2139105","Kandy","Udunuwara","Pamunuwa West","84",807,395,412
"2139110","Kandy","Udunuwara","Pamunuwa East","83",671,320,351
"2139115","Kandy","Udunuwara","Mampitiya","7",1142,551,591
"2139120","Kandy","Udunuwara","Rajagiriya","8",801,407,394
"2139125","Kandy","Udunuwara","Hendeniya West","9",1003,487,516
"2139130","Kandy","Udunuwara","Hendeniya East","10",1108,532,576
"2139135","Kandy","Udunuwara","Penideniya","21",689,319,370
"2139140","Kandy","Udunuwara","Sangabogama","13",993,477,516
"2139145","Kandy","Udunuwara","Meewathura","20",1725,1219,506
"2139150","Kandy","Udunuwara","Angunawala East","18",1189,557,632
"2139155","Kandy","Udunuwara","Angunawala West","19",1112,541,571
"2139160","Kandy","Udunuwara","Yalegoda East","11",897,432,465
"2139165","Kandy","Udunuwara","Yalegoda West","12",805,391,414
"2139170","Kandy","Udunuwara","Alapalawala East","16",746,366,380
"2139175","Kandy","Udunuwara","Alapalawala West","17",872,433,439
"2139180","Kandy","Udunuwara","Walgama","78",620,309,311
"2139185","Kandy","Udunuwara","Rabbegamuwa North","79",788,382,406
"2139190","Kandy","Udunuwara","Rabbegamuwa South","80",597,285,312
"2139195","Kandy","Udunuwara","Hiddavulla East","91",734,335,399
"2139200","Kandy","Udunuwara","Ganguldeniya","88",544,251,293
"2139205","Kandy","Udunuwara","Wattappola","123",606,282,324
"2139210","Kandy","Udunuwara","Walagedara North","110",560,336,224
"2139215","Kandy","Udunuwara","Udagama","120",679,343,336
"2139220","Kandy","Udunuwara","Aluthkanda","116",983,478,505
"2139225","Kandy","Udunuwara","Sadikkawatta","112",532,257,275
"2139230","Kandy","Udunuwara","Kovilakanda","113",930,428,502
"2139235","Kandy","Udunuwara","Walagedara South","111",674,302,372
"2139240","Kandy","Udunuwara","Nikahetiya","109",632,299,333
"2139245","Kandy","Udunuwara","Panabokka","124",583,294,289
"2139250","Kandy","Udunuwara","Hiddavulla West","92",850,400,450
"2139255","Kandy","Udunuwara","Hiyarapitiya","74",861,390,471
"2139260","Kandy","Udunuwara","Heeyawala","77",724,343,381
"2139265","Kandy","Udunuwara","Imbuldeniya","76",702,324,378
"2139270","Kandy","Udunuwara","Naranwala","15",658,336,322
"2139275","Kandy","Udunuwara","Handessa","14",738,345,393
"2139280","Kandy","Udunuwara","Piligalla West","23",707,340,367
"2139285","Kandy","Udunuwara","Piligalla East","22",721,336,385
"2139290","Kandy","Udunuwara","Godapola West","28",693,313,380
"2139295","Kandy","Udunuwara","Godapola East","27",856,409,447
"2139300","Kandy","Udunuwara","Kamburadeniya","29",863,414,449
"2139305","Kandy","Udunuwara","Meewaladeniya","33",844,410,434
"2139310","Kandy","Udunuwara","Arattana","54",901,433,468
"2139315","Kandy","Udunuwara","Davulagala","55",2028,991,1037
"2139320","Kandy","Udunuwara","Aravuwawala","75",1190,577,613
"2139325","Kandy","Udunuwara","Rangama","73",590,275,315
"2139330","Kandy","Udunuwara","Wathupola","65",439,221,218
"2139335","Kandy","Udunuwara","Manikkawa","108",805,377,428
"2139340","Kandy","Udunuwara","Elpitikanda","107",1065,506,559
"2139345","Kandy","Udunuwara","Kooradeniya","106",1263,619,644
"2139350","Kandy","Udunuwara","Ambanwala","105",649,315,334
"2139355","Kandy","Udunuwara","Werawala East","69",545,253,292
"2139360","Kandy","Udunuwara","Werawala West","67",444,213,231
"2139365","Kandy","Udunuwara","Siyambalagoda","72",737,370,367
"2139370","Kandy","Udunuwara","Meddegoda","71",242,105,137
"2139375","Kandy","Udunuwara","Embekka","70",832,405,427
"2139380","Kandy","Udunuwara","Ambarapola","59",972,472,500
"2139385","Kandy","Udunuwara","Eladetta West","53",1122,522,600
"2139390","Kandy","Udunuwara","Ihala Pethiyagoda","34",809,394,415
"2139395","Kandy","Udunuwara","Pethiyagoda West","32",902,425,477
"2139400","Kandy","Udunuwara","Pethiyagoda East","31",1454,687,767
"2139405","Kandy","Udunuwara","Palle Aludeniya","30",882,418,464
"2139410","Kandy","Udunuwara","Karamada North","24",773,356,417
"2139415","Kandy","Udunuwara","Nawa Peradeniya","26",1467,676,791
"2139420","Kandy","Udunuwara","Karamada South","25",1117,542,575
"2139425","Kandy","Udunuwara","Nawa Elpitiya North","39",873,410,463
"2139430","Kandy","Udunuwara","Gelioya","38",974,439,535
"2139435","Kandy","Udunuwara","Dehipagoda West","36",1013,473,540
"2139440","Kandy","Udunuwara","Dehipagoda East","37",1202,578,624
"2139445","Kandy","Udunuwara","Eladetta East","52",1561,736,825
"2139450","Kandy","Udunuwara","Hathnagoda","62",1032,469,563
"2139455","Kandy","Udunuwara","Ketakumbura","56",1565,996,569
"2139460","Kandy","Udunuwara","Boowelikada","58",844,396,448
"2139465","Kandy","Udunuwara","Dodamdeniya","60",554,274,280
"2139470","Kandy","Udunuwara","Batupitiya","57",1297,636,661
"2139475","Kandy","Udunuwara","Bambaradeniya","63",467,216,251
"2139480","Kandy","Udunuwara","Pilapitiya","64",612,294,318
"2139485","Kandy","Udunuwara","Rangoda","66",805,394,411
"2139490","Kandy","Udunuwara","Ambagasthenna","68",970,459,511
"2139495","Kandy","Udunuwara","Welamboda","100",2058,1027,1031
"2139500","Kandy","Udunuwara","Liyangaha Watta","101",1069,514,555
"2139505","Kandy","Udunuwara","Maveekumbura North","103",1821,885,936
"2139510","Kandy","Udunuwara","Maveekumbura South","104",686,325,361
"2139515","Kandy","Udunuwara","Watadeniya","102",1646,688,958
"2139520","Kandy","Udunuwara","Viharagama","99",706,329,377
"2139525","Kandy","Udunuwara","Ganhatha","93",722,364,358
"2139530","Kandy","Udunuwara","Daskara","61",675,331,344
"2139535","Kandy","Udunuwara","Wegiriya East","48",855,434,421
"2139540","Kandy","Udunuwara","Thalawathura","49",870,409,461
"2139545","Kandy","Udunuwara","Muruthagahamula","35",895,433,462
"2139550","Kandy","Udunuwara","Pitawalawatta","43",1065,502,563
"2139555","Kandy","Udunuwara","Nawa Elpitiya South","40",648,311,337
"2139560","Kandy","Udunuwara","Polgahaanga","44",961,439,522
"2139565","Kandy","Udunuwara","Delgahapitiya","45",1183,562,621
"2139570","Kandy","Udunuwara","Weligalla","41",918,417,501
"2139575","Kandy","Udunuwara","Uda Aludeniya","42",1524,742,782
"2139580","Kandy","Udunuwara","Palkumbura","46",723,339,384
"2139585","Kandy","Udunuwara","Lunugama","50",614,270,344
"2139590","Kandy","Udunuwara","Hondiyadeniya","51",988,463,525
"2139595","Kandy","Udunuwara","Wegiriya West","47",885,412,473
"2139600","Kandy","Udunuwara","Kotagaloluwa","97",576,274,302
"2139605","Kandy","Udunuwara","Deldeniya","98",353,162,191
"2139610","Kandy","Udunuwara","Dihitideniya","94",395,184,211
"2139615","Kandy","Udunuwara","Appallagoda East","95",1061,481,580
"2139620","Kandy","Udunuwara","Appallagoda West","96",709,333,376
"2142005","Kandy","Doluwa","Galoya","1162",2127,1009,1118
"2142010","Kandy","Doluwa","Haloya","1160",1360,670,690
"2142015","Kandy","Doluwa","Wariyagala","1161",1629,762,867
"2142020","Kandy","Doluwa","Megoda Kalugamuwa","1157",1334,777,557
"2142025","Kandy","Doluwa","Ganegoda","1158",1598,764,834
"2142030","Kandy","Doluwa","Godawela","1156",1242,614,628
"2142035","Kandy","Doluwa","Nawa Gurukele","1139",1113,529,584
"2142040","Kandy","Doluwa","Nillamba","1137",2267,1059,1208
"2142045","Kandy","Doluwa","Nawa Nillamba","1136",1614,744,870
"2142050","Kandy","Doluwa","Palledelthota","1135",2712,1226,1486
"2142055","Kandy","Doluwa","Gurukele","1138",1336,615,721
"2142060","Kandy","Doluwa","Legumdeniya","1146",1453,742,711
"2142065","Kandy","Doluwa","Orayanwatta","1154",1322,638,684
"2142070","Kandy","Doluwa","Doluwa","1155",953,464,489
"2142075","Kandy","Doluwa","Inguruwatta","1153",1665,838,827
"2142080","Kandy","Doluwa","Naranvita","1149",1147,537,610
"2142085","Kandy","Doluwa","Atuwewatta","1151",2203,1029,1174
"2142090","Kandy","Doluwa","Gampolawatta","1150",2278,1195,1083
"2142095","Kandy","Doluwa","Wewathenna","1152",886,412,474
"2142100","Kandy","Doluwa","Thundeniya","1143",1052,498,554
"2142105","Kandy","Doluwa","Kahawatta","1144",1221,551,670
"2142110","Kandy","Doluwa","Gothatuwela","1145",1389,793,596
"2142115","Kandy","Doluwa","Millagahamula","1173",1516,816,700
"2142120","Kandy","Doluwa","Pabadeniya","1148",772,491,281
"2142125","Kandy","Doluwa","Panvilathenna","1147",1062,522,540
"2142130","Kandy","Doluwa","Masgolla","1141",1691,805,886
"2142135","Kandy","Doluwa","Thumpelawaka","1140",801,372,429
"2142140","Kandy","Doluwa","Mulgama","1132",801,375,426
"2142145","Kandy","Doluwa","Ududeniya","1134",878,429,449
"2142150","Kandy","Doluwa","Hunugala","1142",1407,709,698
"2142155","Kandy","Doluwa","Rajathalawa","1182",996,539,457
"2142160","Kandy","Doluwa","Pupuressa","1181",4769,2276,2493
"2142165","Kandy","Doluwa","Pitawala","1133",1248,607,641
"2145005","Kandy","Pathahewaheta","Uduwelawatta Colony","954",1497,718,779
"2145010","Kandy","Pathahewaheta","Galthenna","955",764,390,374
"2145015","Kandy","Pathahewaheta","Wathuliyedda","953",1305,640,665
"2145020","Kandy","Pathahewaheta","Monarangala","952",1653,794,859
"2145025","Kandy","Pathahewaheta","Nehiniwela","962",615,276,339
"2145030","Kandy","Pathahewaheta","Godompitiya","963",622,283,339
"2145035","Kandy","Pathahewaheta","Hippola","958",714,350,364
"2145040","Kandy","Pathahewaheta","Kossinna","956",944,451,493
"2145045","Kandy","Pathahewaheta","Thalathuoya West","960",657,334,323
"2145050","Kandy","Pathahewaheta","Pussathenna","957",822,392,430
"2145055","Kandy","Pathahewaheta","Pinnagolla","986",778,381,397
"2145060","Kandy","Pathahewaheta","Singharagama","988",565,282,283
"2145065","Kandy","Pathahewaheta","Haragama","1001",1530,745,785
"2145070","Kandy","Pathahewaheta","Kapuliyadda East","992",466,236,230
"2145075","Kandy","Pathahewaheta","Kapuliyadda West","991",510,257,253
"2145080","Kandy","Pathahewaheta","Doolmure","987",600,287,313
"2145085","Kandy","Pathahewaheta","Bootawatta North","984",1216,587,629
"2145090","Kandy","Pathahewaheta","Thalathuoya East","961",661,312,349
"2145095","Kandy","Pathahewaheta","Ankelipitiya","971",886,424,462
"2145100","Kandy","Pathahewaheta","Batagalla","959",567,263,304
"2145105","Kandy","Pathahewaheta","Ethulgama East","968",602,278,324
"2145110","Kandy","Pathahewaheta","Ethulgama North","967",751,360,391
"2145115","Kandy","Pathahewaheta","Uduwela Pallegama East","949",579,286,293
"2145120","Kandy","Pathahewaheta","Uduwela Pallegama West","950",597,293,304
"2145125","Kandy","Pathahewaheta","Uduwela Pallegama South","948",687,326,361
"2145130","Kandy","Pathahewaheta","Uduwela Udagama West","947",1784,854,930
"2145135","Kandy","Pathahewaheta","Uduwela Udagama East","946",1163,551,612
"2145140","Kandy","Pathahewaheta","Ratemulla","951",1872,951,921
"2145145","Kandy","Pathahewaheta","Pooliyadda","964",403,185,218
"2145150","Kandy","Pathahewaheta","Ethulgama West","966",811,399,412
"2145155","Kandy","Pathahewaheta","Ethulgama South","965",792,374,418
"2145160","Kandy","Pathahewaheta","Haputhale Egodagama","972",1067,526,541
"2145165","Kandy","Pathahewaheta","Haputhale Udagama","969",913,435,478
"2145170","Kandy","Pathahewaheta","Moragolla","973",1253,627,626
"2145175","Kandy","Pathahewaheta","Haputhale Pallegama","970",838,389,449
"2145180","Kandy","Pathahewaheta","Nugaliyadda Ihala","983",627,320,307
"2145185","Kandy","Pathahewaheta","Nugaliyadda Pahala","982",432,207,225
"2145190","Kandy","Pathahewaheta","Bootawatta South","985",613,303,310
"2145195","Kandy","Pathahewaheta","Godamunna West","990",645,326,319
"2145200","Kandy","Pathahewaheta","Narangasthenna","993",594,290,304
"2145205","Kandy","Pathahewaheta","Godalawela","994",494,228,266
"2145210","Kandy","Pathahewaheta","Bolepa","999",769,367,402
"2145215","Kandy","Pathahewaheta","Pathamailapitiya South","1006",1233,593,640
"2145220","Kandy","Pathahewaheta","Pathamailapitiya North","1005",1386,688,698
"2145225","Kandy","Pathahewaheta","Udamailapitiya North","1002",978,440,538
"2145230","Kandy","Pathahewaheta","Damunugolla","1008",495,237,258
"2145235","Kandy","Pathahewaheta","Marassana","1007",786,383,403
"2145240","Kandy","Pathahewaheta","Madadeniya","1000",600,272,328
"2145245","Kandy","Pathahewaheta","Welegama","995",474,218,256
"2145250","Kandy","Pathahewaheta","Godamunna East","989",619,284,335
"2145255","Kandy","Pathahewaheta","Letiyagolla","975",677,325,352
"2145260","Kandy","Pathahewaheta","Sriyagama","974",949,463,486
"2145265","Kandy","Pathahewaheta","Medagama Udagama","996",733,342,391
"2145270","Kandy","Pathahewaheta","Medagama Pallegama","997",753,355,398
"2145275","Kandy","Pathahewaheta","Kandewela","1013",534,263,271
"2145280","Kandy","Pathahewaheta","Elikewela","1010",448,194,254
"2145285","Kandy","Pathahewaheta","Meeruppa","1009",1047,485,562
"2145290","Kandy","Pathahewaheta","Kethigannawela","1004",496,232,264
"2145295","Kandy","Pathahewaheta","Udamailapitiya South","1003",1217,606,611
"2145300","Kandy","Pathahewaheta","Galagoda","1011",973,452,521
"2145305","Kandy","Pathahewaheta","Hewavissa East","1016",593,278,315
"2145310","Kandy","Pathahewaheta","Hewavissa West","1017",589,274,315
"2145315","Kandy","Pathahewaheta","Bawlana","1014",718,319,399
"2145320","Kandy","Pathahewaheta","Oluwawatta","1015",553,275,278
"2145325","Kandy","Pathahewaheta","Kiriwanagoda","1012",506,233,273
"2145330","Kandy","Pathahewaheta","Ududeniya Madige","1022",1016,489,527
"2145335","Kandy","Pathahewaheta","Unuvinna East","1024",809,406,403
"2145340","Kandy","Pathahewaheta","Unuvinna West","1025",642,318,324
"2145345","Kandy","Pathahewaheta","Ududeniya","1023",472,237,235
"2145350","Kandy","Pathahewaheta","Bopitiya","1018",568,264,304
"2145355","Kandy","Pathahewaheta","Pothgoda","1019",422,205,217
"2145360","Kandy","Pathahewaheta","Kahambiliyawa","1021",620,317,303
"2145365","Kandy","Pathahewaheta","Neelawala","1020",624,306,318
"2148005","Kandy","Delthota","Perawatta West","981",1946,945,1001
"2148010","Kandy","Delthota","Perawatta East","980",983,444,539
"2148015","Kandy","Delthota","Palugama","977",1208,561,647
"2148020","Kandy","Delthota","Udadelthota","976",3521,1627,1894
"2148025","Kandy","Delthota","Galaha","978",1882,866,1016
"2148030","Kandy","Delthota","Suduwella","979",2527,1209,1318
"2148035","Kandy","Delthota","Greatweliya","1043",1145,525,620
"2148040","Kandy","Delthota","Bawlanawatta Janapadaya","998",567,281,286
"2148045","Kandy","Delthota","Maussawa","1035",895,450,445
"2148050","Kandy","Delthota","Wanahapuwa","1036",663,310,353
"2148055","Kandy","Delthota","Bopitiya Nagaraya","1038",859,427,432
"2148060","Kandy","Delthota","Medakekila","1037",697,307,390
"2148065","Kandy","Delthota","Karagaskada South","1042",1319,570,749
"2148070","Kandy","Delthota","Karagaskada North","1041",1368,636,732
"2148075","Kandy","Delthota","Gonangoda","1040",2207,1049,1158
"2148080","Kandy","Delthota","Kandegama","1046",218,113,105
"2148085","Kandy","Delthota","Wetakepotha","1034",781,371,410
"2148090","Kandy","Delthota","Pattiyagama Pallegama","1033",1076,461,615
"2148095","Kandy","Delthota","Kiriwanaketiya","1027",625,280,345
"2148100","Kandy","Delthota","Kolambissa West","1030",443,214,229
"2148105","Kandy","Delthota","Murapola West","1032",491,230,261
"2148110","Kandy","Delthota","Murapola East","1031",596,270,326
"2148115","Kandy","Delthota","Kolambissa East","1029",410,190,220
"2148120","Kandy","Delthota","Nawaneliya","1026",581,253,328
"2148125","Kandy","Delthota","Kotagepitiya","1028",416,210,206
"2148130","Kandy","Delthota","Wadiyagoda","1047",300,144,156
"2148135","Kandy","Delthota","Pattiyagama Udagama","1039",513,238,275
"2148140","Kandy","Delthota","Pattiyagama Gabadagama North","1045",1121,515,606
"2148145","Kandy","Delthota","Pattiyagama Gabadagama South","1044",987,483,504
"2151005","Kandy","Udapalatha","Egoda Kalugamuwa","1159",4031,1871,2160
"2151010","Kandy","Udapalatha","Udovita","1125",1879,873,1006
"2151015","Kandy","Udapalatha","Kirinda","1123",2029,920,1109
"2151020","Kandy","Udapalatha","Galgediyawa","1124",1036,483,553
"2151025","Kandy","Udapalatha","Ranawala","1130",846,410,436
"2151030","Kandy","Udapalatha","Bowala","1131",850,412,438
"2151035","Kandy","Udapalatha","Rathmalkaduwa","1126",1167,541,626
"2151040","Kandy","Udapalatha","Hapugaspitiya","1128",1300,609,691
"2151045","Kandy","Udapalatha","Unambuwa","1121",1202,561,641
"2151050","Kandy","Udapalatha","Ilangawatta","1120",1849,921,928
"2151055","Kandy","Udapalatha","Kahatapitiya","1119",1200,584,616
"2151060","Kandy","Udapalatha","Bothalapitiya","1109",3156,1472,1684
"2151065","Kandy","Udapalatha","Gampola East","1108",2758,1289,1469
"2151070","Kandy","Udapalatha","Mount Temple","1122",2091,964,1127
"2151075","Kandy","Udapalatha","Keerapane","1129",1783,836,947
"2151080","Kandy","Udapalatha","Sinhapitiya North","1127",1123,536,587
"2151085","Kandy","Udapalatha","Sinhapitiya South","1118",1155,500,655
"2151090","Kandy","Udapalatha","Gampola West","1111",2210,978,1232
"2151095","Kandy","Udapalatha","Polkumbura","1112",1894,895,999
"2151100","Kandy","Udapalatha","Illawathura","1110",2705,1197,1508
"2151105","Kandy","Udapalatha","Angammana East","1163",1828,885,943
"2151110","Kandy","Udapalatha","Angammana West","1164",1619,775,844
"2151115","Kandy","Udapalatha","Aregoda","1113",2410,1066,1344
"2151120","Kandy","Udapalatha","Kurukude","1114",781,363,418
"2151125","Kandy","Udapalatha","Kudamake","1115",1894,871,1023
"2151130","Kandy","Udapalatha","Godagama","1117",1629,783,846
"2151135","Kandy","Udapalatha","Jayamalapura","1116",1524,717,807
"2151140","Kandy","Udapalatha","Amunupuraya","1165",1547,707,840
"2151145","Kandy","Udapalatha","Wattehena","1170",1453,683,770
"2151150","Kandy","Udapalatha","Millagaspitiya","1172",1001,456,545
"2151155","Kandy","Udapalatha","Udagama","1171",1315,607,708
"2151160","Kandy","Udapalatha","Hunukotugama","1175",882,409,473
"2151165","Kandy","Udapalatha","Dunukeulla","1183",1946,903,1043
"2151170","Kandy","Udapalatha","Wanahapuwa","1184",657,324,333
"2151175","Kandy","Udapalatha","Ihalagama","1174",1541,717,824
"2151180","Kandy","Udapalatha","Paradeka","1178",2502,1160,1342
"2151185","Kandy","Udapalatha","Amuhena","1169",1241,561,680
"2151190","Kandy","Udapalatha","Delpitiya","1166",3231,1480,1751
"2151195","Kandy","Udapalatha","Nawadevita","1167",2254,1086,1168
"2151200","Kandy","Udapalatha","Galatha","1185",2484,1146,1338
"2151205","Kandy","Udapalatha","Pallegama","1168",1811,885,926
"2151210","Kandy","Udapalatha","Pussellawa","1176",5878,2729,3149
"2151215","Kandy","Udapalatha","Wahugapitiya","1177",1683,750,933
"2151220","Kandy","Udapalatha","Pussellawagama","1179",866,402,464
"2151225","Kandy","Udapalatha","Doragala","1180",4687,2198,2489
"2151230","Kandy","Udapalatha","Kekulanda","1186",2268,1133,1135
"2151235","Kandy","Udapalatha","Weliganga","1188",1181,519,662
"2151240","Kandy","Udapalatha","Kalugalhinna","1189",906,418,488
"2151245","Kandy","Udapalatha","Mawathura","1187",2433,1131,1302
"2154005","Kandy","Ganga Ihala Korale","Kohowala","1060",1153,562,591
"2154010","Kandy","Ganga Ihala Korale","Polmalagama","1062",849,425,424
"2154015","Kandy","Ganga Ihala Korale","Galpaya","1066",2366,1135,1231
"2154020","Kandy","Ganga Ihala Korale","Herakola","1067",2644,1279,1365
"2154025","Kandy","Ganga Ihala Korale","Wallahagoda","1068",2629,1320,1309
"2154030","Kandy","Ganga Ihala Korale","Maligapurana","1078",1972,948,1024
"2154035","Kandy","Ganga Ihala Korale","Gampolawela","1077",2419,1131,1288
"2154040","Kandy","Ganga Ihala Korale","Ethgala North","1073",971,472,499
"2154045","Kandy","Ganga Ihala Korale","Thembiligala","1070",1837,873,964
"2154050","Kandy","Ganga Ihala Korale","Pellapitiya North","1065",1941,919,1022
"2154055","Kandy","Ganga Ihala Korale","Malwattagama","1063",2320,1086,1234
"2154060","Kandy","Ganga Ihala Korale","Giraulla","1061",1292,601,691
"2154065","Kandy","Ganga Ihala Korale","Karagala","1059",1104,551,553
"2154070","Kandy","Ganga Ihala Korale","Wetakedeniya","1058",1824,865,959
"2154075","Kandy","Ganga Ihala Korale","Uduwella","1052",1356,643,713
"2154080","Kandy","Ganga Ihala Korale","Patithalawa","1048",1921,934,987
"2154085","Kandy","Ganga Ihala Korale","Kelly Group","1049",590,299,291
"2154090","Kandy","Ganga Ihala Korale","Alugolla","1051",1582,760,822
"2154095","Kandy","Ganga Ihala Korale","Gemunupura","1057",1171,562,609
"2154100","Kandy","Ganga Ihala Korale","Yatapana","1056",1137,533,604
"2154105","Kandy","Ganga Ihala Korale","Pellapitiya South","1064",1539,706,833
"2154110","Kandy","Ganga Ihala Korale","Ulapane North","1071",2177,1004,1173
"2154115","Kandy","Ganga Ihala Korale","Udagama","1069",2015,958,1057
"2154120","Kandy","Ganga Ihala Korale","Ethgala West","1075",1245,596,649
"2154125","Kandy","Ganga Ihala Korale","Ethgala East","1074",1866,942,924
"2154130","Kandy","Ganga Ihala Korale","Sinhapura","1076",1600,778,822
"2154135","Kandy","Ganga Ihala Korale","Ulapane South","1072",3732,1729,2003
"2154140","Kandy","Ganga Ihala Korale","Pitakanda","1054",2084,984,1100
"2154145","Kandy","Ganga Ihala Korale","Udahenthenna","1055",1807,862,945
"2154150","Kandy","Ganga Ihala Korale","Rakshawa","1053",2380,1183,1197
"2154155","Kandy","Ganga Ihala Korale","Miyanagolla","1050",1731,899,832
"2157005","Kandy","Pasbage Korale","Pallegama","1104",1684,793,891
"2157010","Kandy","Pasbage Korale","Warakawa","1105",2129,968,1161
"2157015","Kandy","Pasbage Korale","Weligodawatta","1102",1824,810,1014
"2157020","Kandy","Pasbage Korale","Dandubediruppa","1103",2531,1125,1406
"2157025","Kandy","Pasbage Korale","Penithuduwa","1106",1369,605,764
"2157030","Kandy","Pasbage Korale","Pahala Rambukpitiya","1090",1273,586,687
"2157035","Kandy","Pasbage Korale","Uda Rambukpitiya","1089",1581,720,861
"2157040","Kandy","Pasbage Korale","Balanthota North","1091",1884,862,1022
"2157045","Kandy","Pasbage Korale","Weligampola","1096",1193,571,622
"2157050","Kandy","Pasbage Korale","Karahandungala","1107",1640,761,879
"2157055","Kandy","Pasbage Korale","Nawalapitiya South","1086",3144,1444,1700
"2157060","Kandy","Pasbage Korale","Nawalapitiya North","1087",2535,1176,1359
"2157065","Kandy","Pasbage Korale","Nawalapitiya West","1088",4186,1940,2246
"2157070","Kandy","Pasbage Korale","Nawalapitiya East","1085",2095,988,1107
"2157075","Kandy","Pasbage Korale","Imbulpitiya","1084",2664,1278,1386
"2157080","Kandy","Pasbage Korale","Greenwood","1082",1654,777,877
"2157085","Kandy","Pasbage Korale","Bawwagama","1083",6312,2897,3415
"2157090","Kandy","Pasbage Korale","Kendopitiya","1097",2372,1060,1312
"2157095","Kandy","Pasbage Korale","Aluthgama","1093",1315,608,707
"2157100","Kandy","Pasbage Korale","Balanthota South","1092",1511,678,833
"2157105","Kandy","Pasbage Korale","Dekinda","1094",1167,541,626
"2157110","Kandy","Pasbage Korale","Mapakanda North","1100",1039,484,555
"2157115","Kandy","Pasbage Korale","Inguruoya North","1099",1091,505,586
"2157120","Kandy","Pasbage Korale","Kadiyanlena","1081",2213,998,1215
"2157125","Kandy","Pasbage Korale","Westhole","1079",2997,1389,1608
"2157130","Kandy","Pasbage Korale","Inguruoya South","1098",667,283,384
"2157135","Kandy","Pasbage Korale","Mapakanda South","1101",1080,479,601
"2157140","Kandy","Pasbage Korale","Wewegama","1095",1915,916,999
"2157145","Kandy","Pasbage Korale","Hydree","1080",2852,1346,1506
"2203005","Matale","Galewela","Wetakoluwewa","E438D",1406,677,729
"2203010","Matale","Galewela","Dewahoowa Colony 2","E437D",1072,524,548
"2203015","Matale","Galewela","Makulugaswewa","E438A",831,401,430
"2203020","Matale","Galewela","Ibbankatuwa","E439B",1045,506,539
"2203025","Matale","Galewela","Thalakiriyagama","E439",1950,938,1012
"2203030","Matale","Galewela","Thennakonpura","E438C",708,365,343
"2203035","Matale","Galewela","Dandubendiruppa","E438",1424,695,729
"2203040","Matale","Galewela","Dewahoowa Colony 1","E437C",2190,1097,1093
"2203045","Matale","Galewela","Bulanawewa","E437A",2575,1226,1349
"2203050","Matale","Galewela","Pahala Diggala","E438B",1397,691,706
"2203055","Matale","Galewela","Meewalapathaha","E433D",1042,524,518
"2203060","Matale","Galewela","Pahala Wewa","E439A",1072,520,552
"2203065","Matale","Galewela","Yatigalpotta","E433A",1293,655,638
"2203070","Matale","Galewela","Kumbukgolla","E437B",1731,853,878
"2203075","Matale","Galewela","Kosgahahinna","E436D",969,458,511
"2203080","Matale","Galewela","Ralalerotawewa","E436C",789,383,406
"2203085","Matale","Galewela","Moragolla","E436A",839,388,451
"2203090","Matale","Galewela","Pibidunugama","E436B",639,329,310
"2203095","Matale","Galewela","Aluthwewa","E436",1488,694,794
"2203100","Matale","Galewela","Bambaragaswewa","E435",822,405,417
"2203105","Matale","Galewela","Beliyakanda","E437",1981,947,1034
"2203110","Matale","Galewela","Silwathgama","E433C",1299,632,667
"2203115","Matale","Galewela","Walaswewa","E433",1679,797,882
"2203120","Matale","Galewela","Galapamula","E432H",967,467,500
"2203125","Matale","Galewela","Damunumulla","E432A",1518,686,832
"2203130","Matale","Galewela","Pattiwela","E432F",1031,496,535
"2203135","Matale","Galewela","Nilagama","E435A",1155,546,609
"2203140","Matale","Galewela","Hombawa","E431A",1407,640,767
"2203145","Matale","Galewela","Palu Hombawa","E432J",611,287,324
"2203150","Matale","Galewela","Dambawatawana","E432G",840,399,441
"2203155","Matale","Galewela","Puwakpitiya","E433B",1272,596,676
"2203160","Matale","Galewela","Weragalawatta","E434A",1188,580,608
"2203165","Matale","Galewela","Nabadagahawatta","E434",1927,926,1001
"2203170","Matale","Galewela","Galewela Town","E432",1177,602,575
"2203175","Matale","Galewela","Pathkolagolla","E432B",1165,544,621
"2203180","Matale","Galewela","Kospotha","E431C",1371,684,687
"2203185","Matale","Galewela","Ranwediyawa","E432I",2099,1007,1092
"2203190","Matale","Galewela","Pahala Bambawa","E432E",1238,598,640
"2203195","Matale","Galewela","Danduyaya","E432C",1227,603,624
"2203200","Matale","Galewela","Dambagolla","E434B",1253,635,618
"2203205","Matale","Galewela","Ihala Bambawa","E432D",903,438,465
"2203210","Matale","Galewela","Siyambalagahawela","E427A",921,463,458
"2203215","Matale","Galewela","Pihilyaya","E427C",588,272,316
"2203220","Matale","Galewela","Medabedda North","E428B",1171,565,606
"2203225","Matale","Galewela","Divulgaskotuwa","E431D",1541,704,837
"2203230","Matale","Galewela","Hathadukkuwa","E431B",999,491,508
"2203235","Matale","Galewela","Beligamuwa","E431",1159,552,607
"2203240","Matale","Galewela","Medabedda South","E428C",876,414,462
"2203245","Matale","Galewela","Wahakotte","E427",696,296,400
"2203250","Matale","Galewela","Galgodayaya","E427D",523,242,281
"2203255","Matale","Galewela","Palapathwala","E427B",1090,523,567
"2203260","Matale","Galewela","Dembawa","E430",761,354,407
"2203265","Matale","Galewela","Elamalpotha","E429",1484,663,821
"2203270","Matale","Galewela","Yatiwehera","E428A",634,304,330
"2203275","Matale","Galewela","Lenawala","E428",922,449,473
"2203280","Matale","Galewela","Hewanwela","E429A",1307,608,699
"2203285","Matale","Galewela","Wegodapola","E430B",830,364,466
"2203290","Matale","Galewela","Kendangamuwa","E430C",981,460,521
"2203295","Matale","Galewela","Madipola","E430A",969,456,513
"2206005","Matale","Dambulla","Siyambala Wewa","E453C",586,283,303
"2206010","Matale","Dambulla","Avudangawa","E453",608,319,289
"2206015","Matale","Dambulla","Gedigaswalana","E454",731,372,359
"2206020","Matale","Dambulla","Pidurangala","E455C",550,268,282
"2206025","Matale","Dambulla","Thalkote","E455A",1150,596,554
"2206030","Matale","Dambulla","Digampathaha","E453A",1250,653,597
"2206035","Matale","Dambulla","Inamaluwa","E451",1568,778,790
"2206040","Matale","Dambulla","Nagalawewa","E453B",906,450,456
"2206045","Matale","Dambulla","Pothana","E452C",766,400,366
"2206050","Matale","Dambulla","Kimbissa","E452A",800,401,399
"2206055","Matale","Dambulla","Egodawewa","E452B",906,460,446
"2206060","Matale","Dambulla","Palutawa","E452",759,390,369
"2206065","Matale","Dambulla","Sigiriya","E455",621,341,280
"2206070","Matale","Dambulla","Mailattawa","E455D",1929,1032,897
"2206075","Matale","Dambulla","Pol Attawa","E455B",655,317,338
"2206080","Matale","Dambulla","Nikawatawana","E447",2522,1280,1242
"2206085","Matale","Dambulla","Kumbukkandanwala","E448",871,436,435
"2206090","Matale","Dambulla","Bellanneoya","E451A",1307,647,660
"2206095","Matale","Dambulla","Rathmalkatuwa","E451C",1166,568,598
"2206100","Matale","Dambulla","Welihena","E450C",1510,735,775
"2206105","Matale","Dambulla","Etawarahena","E451B",1104,520,584
"2206110","Matale","Dambulla","Pallegama","E450",1122,543,579
"2206115","Matale","Dambulla","Bulagala","E450B",1334,615,719
"2206120","Matale","Dambulla","Pelvehera","E450A",2237,1136,1101
"2206125","Matale","Dambulla","Kandalama","E449",2222,1115,1107
"2206130","Matale","Dambulla","Pahala Erevula","E446",1037,615,422
"2206135","Matale","Dambulla","Ihala Ereula","E446C",881,435,446
"2206140","Matale","Dambulla","Welangolla","E446D",896,447,449
"2206145","Matale","Dambulla","Wewala Wewa","E447A",1870,936,934
"2206150","Matale","Dambulla","Yakkuragala North","E446A",1100,520,580
"2206155","Matale","Dambulla","Vilhatha","E446F",569,287,282
"2206160","Matale","Dambulla","Athuparayaya","E445C",1890,939,951
"2206165","Matale","Dambulla","Pahala Wewa","E445D",1245,583,662
"2206170","Matale","Dambulla","Dambulla Town","E445",4864,2621,2243
"2206175","Matale","Dambulla","Dambulugama","E445F",1052,526,526
"2206180","Matale","Dambulla","Haluapullana Wewa","E445E",1502,728,774
"2206185","Matale","Dambulla","Pohoranwewa","E445B",2235,1124,1111
"2206190","Matale","Dambulla","Yapagama","E445G",1724,855,869
"2206195","Matale","Dambulla","Rathmalgaha Ela","E445A",2433,1199,1234
"2206200","Matale","Dambulla","Yakkuragala South","E446E",1088,538,550
"2206205","Matale","Dambulla","Kalundewa Aluthgama","E443A",830,394,436
"2206210","Matale","Dambulla","Angunawel Pelessa","E443B",413,201,212
"2206215","Matale","Dambulla","Kalogaha Ela","E446B",1534,766,768
"2206220","Matale","Dambulla","Thittawelgolla","E444",704,334,370
"2206225","Matale","Dambulla","Moragollewa","E444B",1467,793,674
"2206230","Matale","Dambulla","Kapuwatta","E444A",1127,555,572
"2206235","Matale","Dambulla","Kiralagolla","E440B",928,457,471
"2206240","Matale","Dambulla","Wavulambe","E440C",821,384,437
"2206245","Matale","Dambulla","Embulambe","E440",796,400,396
"2206250","Matale","Dambulla","Puwak Attawala","E441D",828,424,404
"2206255","Matale","Dambulla","Kalundewa Paranagama","E443",714,333,381
"2206260","Matale","Dambulla","Walgamwewa","E442A",1719,841,878
"2206265","Matale","Dambulla","Kiralessa","E441C",559,284,275
"2206270","Matale","Dambulla","Pannampitiya","E441A",1257,619,638
"2206275","Matale","Dambulla","Welamitiyawa","E440D",428,213,215
"2206280","Matale","Dambulla","Etha Bendiwewa","E440A",1573,773,800
"2206285","Matale","Dambulla","Lenadora North","E441",979,512,467
"2206290","Matale","Dambulla","Lenadora South","E441B",1149,552,597
"2206295","Matale","Dambulla","Nayakumbura","E442",914,464,450
"2209005","Matale","Naula","Ussattawa","E413C",225,112,113
"2209010","Matale","Naula","Nikula","E413A",652,323,329
"2209015","Matale","Naula","Serudandapola","E415A",703,353,350
"2209020","Matale","Naula","Haduwa","E412C",509,260,249
"2209025","Matale","Naula","Bambaragahawatta","E404B",333,162,171
"2209030","Matale","Naula","Dambagolla","E404A",279,137,142
"2209035","Matale","Naula","Helambagahawatta","E404",374,182,192
"2209040","Matale","Naula","Pubbiliya","E406A",430,214,216
"2209045","Matale","Naula","Thalagoda","E407A",732,359,373
"2209050","Matale","Naula","Maragamuwa","E406",392,199,193
"2209055","Matale","Naula","Haduwela","E412B",435,216,219
"2209060","Matale","Naula","Dodamattawela","E412G",497,237,260
"2209065","Matale","Naula","Karavilahena","E412",810,389,421
"2209070","Matale","Naula","Bobella","E415E",452,216,236
"2209075","Matale","Naula","Bibila","E413",833,398,435
"2209080","Matale","Naula","Murutholuwa","E414A",517,245,272
"2209085","Matale","Naula","Mailpitiya","E414",899,441,458
"2209090","Matale","Naula","Wewattawa","E414C",305,139,166
"2209095","Matale","Naula","Penalaboda","E413D",814,410,404
"2209100","Matale","Naula","Naula","E413B",2131,1053,1078
"2209105","Matale","Naula","Meegaha Ela","E412F",577,267,310
"2209110","Matale","Naula","Bowathenna Watta","E412D",523,251,272
"2209115","Matale","Naula","Koombiyangahaela","E412A",571,279,292
"2209120","Matale","Naula","Millagahamula Thenna","E409B",526,254,272
"2209125","Matale","Naula","Medapihilla","E407C",463,228,235
"2209130","Matale","Naula","Kadawatha","E407B",555,264,291
"2209135","Matale","Naula","Galporugolla","E401A",333,179,154
"2209140","Matale","Naula","Elagamuwa","E407",547,282,265
"2209145","Matale","Naula","Kongahawela","E409",297,145,152
"2209150","Matale","Naula","Rajawela","E409A",846,414,432
"2209155","Matale","Naula","Gan Imayaya","E412E",543,271,272
"2209160","Matale","Naula","Moragahamada","E383C",447,217,230
"2209165","Matale","Naula","Pilihudugolla Pahalagama","E410B",372,180,192
"2209170","Matale","Naula","Pilihudugolla Ihalagama","E410",950,435,515
"2209175","Matale","Naula","Arangala","E410A",1229,601,628
"2209180","Matale","Naula","Habaragahamada","E410C",868,436,432
"2209185","Matale","Naula","Elhena","E415F",390,188,202
"2209190","Matale","Naula","Diyankaduwa","E414B",255,120,135
"2209195","Matale","Naula","Alugolla","E415C",564,281,283
"2209200","Matale","Naula","Nalanda","E415",807,384,423
"2209205","Matale","Naula","Wambatuyaya","E415H",381,182,199
"2209210","Matale","Naula","Meegolla","E415G",592,267,325
"2209215","Matale","Naula","Ududeniya","E415B",910,424,486
"2209220","Matale","Naula","Hapugasyaya","E415D",899,435,464
"2209225","Matale","Naula","Lihinipitiya","E382A",540,264,276
"2209230","Matale","Naula","Senagama","E383B",800,409,391
"2209235","Matale","Naula","Andawala","E382",896,455,441
"2209240","Matale","Naula","Opalgala","E383",670,312,358
"2209245","Matale","Naula","Ambana","E383A",203,112,91
"2209250","Matale","Naula","Moragolla","E409C",227,112,115
"2209255","Matale","Naula","Galboda","E408",117,65,52
"2209260","Matale","Naula","Kambarawa","E401",664,330,334
"2212005","Matale","Pallepola","Janakagama","E426C",671,287,384
"2212010","Matale","Pallepola","Nilannoruwa Colony","E426D",693,332,361
"2212015","Matale","Pallepola","Aluthgama","E426",1192,577,615
"2212020","Matale","Pallepola","Demada Oya","E417A",920,438,482
"2212025","Matale","Pallepola","Mananwatta","E426B",676,329,347
"2212030","Matale","Pallepola","Nilannoruwa","E426A",808,379,429
"2212035","Matale","Pallepola","Thalakiriyawa","E423B",1062,529,533
"2212040","Matale","Pallepola","Kirioruwa","E418",756,356,400
"2212045","Matale","Pallepola","Kosgolla","E419B",501,235,266
"2212050","Matale","Pallepola","Nagahapola","E419E",607,310,297
"2212055","Matale","Pallepola","Bomeruwa","E423E",463,234,229
"2212060","Matale","Pallepola","Kobbevehera","E423D",584,263,321
"2212065","Matale","Pallepola","Millawana Pahalagama","E423A",772,395,377
"2212070","Matale","Pallepola","Millawana Medagama","E423C",568,255,313
"2212075","Matale","Pallepola","Kandewatta","E419A",498,237,261
"2212080","Matale","Pallepola","Mahayayawatta","E419C",467,221,246
"2212085","Matale","Pallepola","Medalanda","E419D",564,269,295
"2212090","Matale","Pallepola","Walmoruwa","E417",835,399,436
"2212095","Matale","Pallepola","Moragaspitiya","E416B",460,219,241
"2212100","Matale","Pallepola","Akuramboda","E419",719,325,394
"2212105","Matale","Pallepola","Dewarammulla","E422C",465,213,252
"2212110","Matale","Pallepola","Millawana Ihalagama","E423",710,336,374
"2212115","Matale","Pallepola","Ambokka","E422",990,453,537
"2212120","Matale","Pallepola","Maningamuwa West","E422B",642,301,341
"2212125","Matale","Pallepola","Maningamuwa East","E422A",611,294,317
"2212130","Matale","Pallepola","Koswatta","E420",519,238,281
"2212135","Matale","Pallepola","Ekamuthugama","E420D",659,303,356
"2212140","Matale","Pallepola","Ambokudena","E420C",751,347,404
"2212145","Matale","Pallepola","Koholanwala","E416D",1086,505,581
"2212150","Matale","Pallepola","Udurampelessa","E416C",682,325,357
"2212155","Matale","Pallepola","Ehelepola","E416",568,268,300
"2212160","Matale","Pallepola","Pallepola North","E420A",607,310,297
"2212165","Matale","Pallepola","Monaravila","E420B",325,151,174
"2212170","Matale","Pallepola","Galahitiyagama","E422D",501,251,250
"2212175","Matale","Pallepola","Rusigama Ihalagama","E421B",560,274,286
"2212180","Matale","Pallepola","Rusigama Pahalagama","E421F",523,245,278
"2212185","Matale","Pallepola","Pallepola South","E420E",952,437,515
"2212190","Matale","Pallepola","Kinigama","E421D",674,338,336
"2212195","Matale","Pallepola","Paldeniya","E421",742,358,384
"2212200","Matale","Pallepola","Dodamgasyaya","E421E",493,239,254
"2212205","Matale","Pallepola","Ariyagama","E421A",567,273,294
"2212210","Matale","Pallepola","Polwatta","E421G",351,161,190
"2212215","Matale","Pallepola","Thembilideniya North","E421C",583,258,325
"2212220","Matale","Pallepola","Dimbulgamuwa","E416A",1188,555,633
"2215005","Matale","Yatawatta","Udagama West","E332E",712,298,414
"2215010","Matale","Yatawatta","Selagama","E332A",659,328,331
"2215015","Matale","Yatawatta","Selagama East","E332D",651,337,314
"2215020","Matale","Yatawatta","Thembilideniya","E331B",468,224,244
"2215025","Matale","Yatawatta","Mathale North","E331G",1303,646,657
"2215030","Matale","Yatawatta","Kavudupelella","E331A",1176,574,602
"2215035","Matale","Yatawatta","Mahawela","E331",323,146,177
"2215040","Matale","Yatawatta","Mahawela West","E331E",363,187,176
"2215045","Matale","Yatawatta","Delgolla","E331F",519,243,276
"2215050","Matale","Yatawatta","Galagama","E332",728,360,368
"2215055","Matale","Yatawatta","Nagolla","E332C",373,185,188
"2215060","Matale","Yatawatta","Udagama","E332B",249,115,134
"2215065","Matale","Yatawatta","Urulewatta","E334A",377,186,191
"2215070","Matale","Yatawatta","Yatawatta","E334",804,406,398
"2215075","Matale","Yatawatta","Mediyapola","E334C",1078,511,567
"2215080","Matale","Yatawatta","Nikagolla","E333",525,223,302
"2215085","Matale","Yatawatta","Nikagolla North","E333A",684,322,362
"2215090","Matale","Yatawatta","Dikkumbura West","E331J",470,223,247
"2215095","Matale","Yatawatta","Rathalawewa","E331C",809,379,430
"2215100","Matale","Yatawatta","Dikkumbura","E331D",467,223,244
"2215105","Matale","Yatawatta","Wattegedara","E331I",493,252,241
"2215110","Matale","Yatawatta","Galaliyadda","E331H",611,296,315
"2215115","Matale","Yatawatta","Muruthawatta","E331K",594,292,302
"2215120","Matale","Yatawatta","Deevilla North","E337C",1164,573,591
"2215125","Matale","Yatawatta","Deevilla","E337A",485,225,260
"2215130","Matale","Yatawatta","Dangan Place","E337B",1284,607,677
"2215135","Matale","Yatawatta","Alokagama","E337E",485,235,250
"2215140","Matale","Yatawatta","Walpola","E334B",590,285,305
"2215145","Matale","Yatawatta","Maligathenna","E334D",503,223,280
"2215150","Matale","Yatawatta","Aluthwatta","E335C",217,102,115
"2215155","Matale","Yatawatta","Ambanpola","E335",583,279,304
"2215160","Matale","Yatawatta","Lakshahena","E335E",424,204,220
"2215165","Matale","Yatawatta","Deevilla South","E337D",380,178,202
"2215170","Matale","Yatawatta","Gammulla","E337",545,261,284
"2215175","Matale","Yatawatta","Mottuwela","E335B",445,188,257
"2215180","Matale","Yatawatta","Idangama","E335A",659,320,339
"2215185","Matale","Yatawatta","Udasgiriya","E336",341,165,176
"2215190","Matale","Yatawatta","Ethipallawala","E335D",535,252,283
"2215195","Matale","Yatawatta","Aluthgama North","E338A",441,204,237
"2215200","Matale","Yatawatta","Aluthgama","E338",430,193,237
"2215205","Matale","Yatawatta","Pamunuwa","E339",277,135,142
"2215210","Matale","Yatawatta","Walawela","E339B",384,187,197
"2215215","Matale","Yatawatta","Unaweruwa","E339A",576,269,307
"2215220","Matale","Yatawatta","Madadeniya","E336A",507,259,248
"2215225","Matale","Yatawatta","Mathalapitiya","E340A",418,209,209
"2215230","Matale","Yatawatta","Mathalapitiya South","E340D",373,188,185
"2215235","Matale","Yatawatta","Rathninda","E340E",338,161,177
"2215240","Matale","Yatawatta","Asgiri Dorakumbura","E340",226,107,119
"2215245","Matale","Yatawatta","Asgiri Dorakumbura East","E340B",354,165,189
"2215250","Matale","Yatawatta","Polwatta","E340C",326,157,169
"2215255","Matale","Yatawatta","Dullewa","E342",455,232,223
"2215260","Matale","Yatawatta","Dullewa East","E342B",471,232,239
"2215265","Matale","Yatawatta","Thalgahagoda","E342A",343,159,184
"2215270","Matale","Yatawatta","Daluwela","E341B",473,233,240
"2215275","Matale","Yatawatta","Ethipola","E341",393,180,213
"2215280","Matale","Yatawatta","Ethipola West","E341A",381,173,208
"2218005","Matale","Matale","Narangamuwa","E323",774,384,390
"2218010","Matale","Matale","Madawala Ulpatha","E322C",1703,792,911
"2218015","Matale","Matale","Thalagasyaya","E322B",830,417,413
"2218020","Matale","Matale","Madawala","E322",1331,690,641
"2218025","Matale","Matale","Rajjammana","E322A",1367,660,707
"2218030","Matale","Matale","Moragahamada","E324A",420,197,223
"2218035","Matale","Matale","Hathamunagala","E324C",818,413,405
"2218040","Matale","Matale","Ankanda","E324B",749,376,373
"2218045","Matale","Matale","Puwakpitiya","E324",992,487,505
"2218050","Matale","Matale","Walliwela","E330A",1113,512,601
"2218055","Matale","Matale","Galwadukumbura","E330",425,204,221
"2218060","Matale","Matale","Dombawela","E329",968,440,528
"2218065","Matale","Matale","Kawatayamuna","E330B",634,305,329
"2218070","Matale","Matale","Eriyagolla","E325A",565,281,284
"2218075","Matale","Matale","Imbulandanda","E325",797,352,445
"2218080","Matale","Matale","Golahenwatta","E328B",658,313,345
"2218085","Matale","Matale","Parana Dombawela","E329A",1018,470,548
"2218090","Matale","Matale","Ellepola","E328A",488,238,250
"2218095","Matale","Matale","Palapathwala","E328D",1989,959,1030
"2218100","Matale","Matale","Kottagoda","E325B",882,424,458
"2218105","Matale","Matale","Owala Polwatta","E326B",1069,509,560
"2218110","Matale","Matale","Makulgaharuppa","E328E",804,380,424
"2218115","Matale","Matale","Udugama","E328",798,395,403
"2218120","Matale","Matale","Kirigalpotta","E328C",1709,793,916
"2218125","Matale","Matale","Dunkalawatta","E326A",1395,663,732
"2218130","Matale","Matale","Dorakumbura","E326",1672,792,880
"2218135","Matale","Matale","Biridewala","E327A",986,488,498
"2218140","Matale","Matale","Aluvihare","E327",4232,2024,2208
"2218145","Matale","Matale","Dikkiriya","E327B",849,416,433
"2218150","Matale","Matale","Parawatta","E350B",3378,1591,1787
"2218155","Matale","Matale","Kaludewala","E350C",4044,1892,2152
"2218160","Matale","Matale","Mandandawela","E350A",2263,1061,1202
"2218165","Matale","Matale","Bogahakotuwa","E352E",1776,833,943
"2218170","Matale","Matale","Harasgama","E350",880,418,462
"2218175","Matale","Matale","Kandegedara","E351",1104,522,582
"2218180","Matale","Matale","Malwatta","E352D",2386,1175,1211
"2218185","Matale","Matale","Vihara Road","E352G",1918,872,1046
"2218190","Matale","Matale","Muslim Town","E352",4521,2190,2331
"2218195","Matale","Matale","Oya Pahala","E352H",1444,689,755
"2218200","Matale","Matale","Gongawela","E352B",2903,1373,1530
"2218205","Matale","Matale","Sinhala Town","E352A",1359,610,749
"2218210","Matale","Matale","Dodamdeniya","E351A",842,394,448
"2218215","Matale","Matale","Hulangamuwa South","E353",1274,591,683
"2218220","Matale","Matale","Hulangamuwa North","E353B",1608,730,878
"2218225","Matale","Matale","Diyabubula","E352F",1579,786,793
"2218230","Matale","Matale","Maligathenna","E352C",2918,1343,1575
"2218235","Matale","Matale","Nagolla","E353A",1356,625,731
"2218240","Matale","Matale","Pandivita","E349",852,395,457
"2218245","Matale","Matale","Pandivita Welagama","E349A",1016,465,551
"2218250","Matale","Matale","Kotuwegedara North","E348",1035,496,539
"2218255","Matale","Matale","Koombiyangoda","E348A",810,372,438
"2218260","Matale","Matale","Kotuwegedara South","E348B",1563,753,810
"2221005","Matale","Ambanganga Korale","Kumbaloluwa","E381",869,434,435
"2221010","Matale","Ambanganga Korale","Gammaduwa","E381C",1307,565,742
"2221015","Matale","Ambanganga Korale","Kalugalthenna","E381A",560,253,307
"2221020","Matale","Ambanganga Korale","Naguliyadda","E384C",898,419,479
"2221025","Matale","Ambanganga Korale","Kosgolla","E381D",524,228,296
"2221030","Matale","Ambanganga Korale","Imbulgolla","E381B",544,257,287
"2221035","Matale","Ambanganga Korale","Ranmuthugama","E380A",751,367,384
"2221040","Matale","Ambanganga Korale","Raithalawa","E380",277,150,127
"2221045","Matale","Ambanganga Korale","Thibbatukanatha","E380C",599,295,304
"2221050","Matale","Ambanganga Korale","Palle Eswedduma","E384G",490,241,249
"2221055","Matale","Ambanganga Korale","Pallethenna","E384F",843,385,458
"2221060","Matale","Ambanganga Korale","Pussella","E384",1695,814,881
"2221065","Matale","Ambanganga Korale","Sirangahawatta","E384E",1038,469,569
"2221070","Matale","Ambanganga Korale","Kavudagammana","E384D",406,176,230
"2221075","Matale","Ambanganga Korale","Narangolla","E384A",628,308,320
"2221080","Matale","Ambanganga Korale","Hunukete","E384B",1262,598,664
"2221085","Matale","Ambanganga Korale","Metihakka","E379B",1148,523,625
"2221090","Matale","Ambanganga Korale","Aluthwela","E380B",650,301,349
"2221095","Matale","Ambanganga Korale","Cloda","E379A",572,275,297
"2221100","Matale","Ambanganga Korale","Gurubebila","E379",582,266,316
"2224005","Matale","Laggala-Pallegama","Maoya","E402B",332,188,144
"2224010","Matale","Laggala-Pallegama","Kandepitawala","E402G",721,381,340
"2224015","Matale","Laggala-Pallegama","Dewaladeniya","E402H",547,297,250
"2224020","Matale","Laggala-Pallegama","Kaluganga","E402F",673,334,339
"2224025","Matale","Laggala-Pallegama","Akarahediya","E396B",411,219,192
"2224030","Matale","Laggala-Pallegama","Hattota Amuna","E402",458,239,219
"2224035","Matale","Laggala-Pallegama","Dasgiriya","E402A",611,314,297
"2224040","Matale","Laggala-Pallegama","Morathenna","E402E",937,456,481
"2224045","Matale","Laggala-Pallegama","Wellewala","E402D",568,294,274
"2224050","Matale","Laggala-Pallegama","Weliwaranagolla","E402C",380,192,188
"2224055","Matale","Laggala-Pallegama","Leloya","E396",489,244,245
"2224060","Matale","Laggala-Pallegama","Pottatawela","E399",56,26,30
"2224065","Matale","Laggala-Pallegama","Dammanthenna","E399A",80,38,42
"2224070","Matale","Laggala-Pallegama","Gangalapuwakpitiya","E400",346,176,170
"2224075","Matale","Laggala-Pallegama","Divulgas Pathana","E400A",194,102,92
"2224080","Matale","Laggala-Pallegama","Pitawala","E385",213,115,98
"2224085","Matale","Laggala-Pallegama","Kahagala","E388",144,76,68
"2224090","Matale","Laggala-Pallegama","Ilukkumbura","E388A",177,82,95
"2224095","Matale","Laggala-Pallegama","Mahalakotuwa","E387",197,107,90
"2224100","Matale","Laggala-Pallegama","Ganga Henwala","E389A",63,30,33
"2224105","Matale","Laggala-Pallegama","Karadamulla","E397C",502,267,235
"2224110","Matale","Laggala-Pallegama","Gonawala","E397B",202,99,103
"2224115","Matale","Laggala-Pallegama","Laggala Pallegama","E397",439,233,206
"2224120","Matale","Laggala-Pallegama","Miniranketiya","E397D",323,163,160
"2224125","Matale","Laggala-Pallegama","Rawanagama","E397A",208,113,95
"2224130","Matale","Laggala-Pallegama","Galgedawala","E396A",75,42,33
"2224135","Matale","Laggala-Pallegama","Guruwela","E397E",345,179,166
"2224140","Matale","Laggala-Pallegama","Kivulawadiya","E392A",296,140,156
"2224145","Matale","Laggala-Pallegama","Halminiya","E392",410,215,195
"2224150","Matale","Laggala-Pallegama","Imaduwa","E390",171,86,85
"2224155","Matale","Laggala-Pallegama","Rambukoluwa","E389",132,68,64
"2224160","Matale","Laggala-Pallegama","Meda Ela","E387A",140,69,71
"2224165","Matale","Laggala-Pallegama","Rathninda","E386A",169,92,77
"2224170","Matale","Laggala-Pallegama","Etanwala","E386",135,71,64
"2224175","Matale","Laggala-Pallegama","Ranamuregama","E392B",435,212,223
"2224180","Matale","Laggala-Pallegama","Narangamuwa","E391",301,152,149
"2224185","Matale","Laggala-Pallegama","Lakegala","E391A",230,106,124
"2227005","Matale","Wilgamuwa","Kumbukoya","E398I",275,140,135
"2227010","Matale","Wilgamuwa","Thunhiriyawewa","E398C",755,356,399
"2227015","Matale","Wilgamuwa","Palupitiya","E398H",600,301,299
"2227020","Matale","Wilgamuwa","Rattotayaya","E398E",606,317,289
"2227025","Matale","Wilgamuwa","Dunuvilapitiya","E398F",546,278,268
"2227030","Matale","Wilgamuwa","Medakanda","E398A",364,163,201
"2227035","Matale","Wilgamuwa","Aliwanguwa","E398G",781,400,381
"2227040","Matale","Wilgamuwa","Viharagama","E398K",743,362,381
"2227045","Matale","Wilgamuwa","Handungamuwa","E398",686,333,353
"2227050","Matale","Wilgamuwa","Topwalapitiya","E398J",397,199,198
"2227055","Matale","Wilgamuwa","Gemburuoya","E395K",677,342,335
"2227060","Matale","Wilgamuwa","Kumbukandana","E398B",868,447,421
"2227065","Matale","Wilgamuwa","Lediyangala","E395A",945,471,474
"2227070","Matale","Wilgamuwa","Karawgahawewa","E395B",886,418,468
"2227075","Matale","Wilgamuwa","Radunnewewa","E395I",831,409,422
"2227080","Matale","Wilgamuwa","Maraka","E395H",759,386,373
"2227085","Matale","Wilgamuwa","Malgammana","E395J",656,326,330
"2227090","Matale","Wilgamuwa","Bogahawewa","E394",878,456,422
"2227095","Matale","Wilgamuwa","Aliyawala","E395L",266,137,129
"2227100","Matale","Wilgamuwa","Veheragala","E398D",813,416,397
"2227105","Matale","Wilgamuwa","Himbiliyakada","E396C",253,127,126
"2227110","Matale","Wilgamuwa","Hettipola","E394A",1922,976,946
"2227115","Matale","Wilgamuwa","Naminioya","E394C",913,456,457
"2227120","Matale","Wilgamuwa","Dewagiriya","E394F",780,373,407
"2227125","Matale","Wilgamuwa","Piduruella","E394E",394,193,201
"2227130","Matale","Wilgamuwa","Guruwelayaya","E394D",579,277,302
"2227135","Matale","Wilgamuwa","Naminigama","E394B",1130,576,554
"2227140","Matale","Wilgamuwa","Perakanatta","E395C",828,416,412
"2227145","Matale","Wilgamuwa","Wilgamuwa","E395",438,247,191
"2227150","Matale","Wilgamuwa","Wanarawa","E395G",1060,514,546
"2227155","Matale","Wilgamuwa","Bathgampala","E395D",1483,753,730
"2227160","Matale","Wilgamuwa","Nagolla","E395E",780,375,405
"2227165","Matale","Wilgamuwa","Moragaha Ulpatha","E395F",516,264,252
"2227170","Matale","Wilgamuwa","Nugagolla","E393A",1376,668,708
"2227175","Matale","Wilgamuwa","Meewaobe","E393B",1063,508,555
"2227180","Matale","Wilgamuwa","80 Yaya","E393D",951,457,494
"2227185","Matale","Wilgamuwa","Sonutta","E393",851,418,433
"2227190","Matale","Wilgamuwa","Uduwelwala","E393C",675,339,336
"2227195","Matale","Wilgamuwa","Sulugune","E392C",170,88,82
"2230005","Matale","Rattota","Ikirigolla","E371D",763,359,404
"2230010","Matale","Rattota","Pahala Owala","E372",756,337,419
"2230015","Matale","Rattota","Ihala Owala","E372A",1300,624,676
"2230020","Matale","Rattota","Kaikawala","E373A",1433,671,762
"2230025","Matale","Rattota","Nikawella","E377",1005,481,524
"2230030","Matale","Rattota","Kuruwawa","E376B",1389,624,765
"2230035","Matale","Rattota","Rattota","E376",1761,842,919
"2230040","Matale","Rattota","Bodhikotuwa","E375A",752,341,411
"2230045","Matale","Rattota","Dankanda","E378",714,331,383
"2230050","Matale","Rattota","Kirimetiya","E378B",628,293,335
"2230055","Matale","Rattota","Polwattakanda","E378A",680,318,362
"2230060","Matale","Rattota","Dambagolla","E378C",1019,472,547
"2230065","Matale","Rattota","Medawatta","E375E",770,370,400
"2230070","Matale","Rattota","Weralugasthenna","E375B",829,408,421
"2230075","Matale","Rattota","Madakumbura","E375F",795,392,403
"2230080","Matale","Rattota","Maussagolla","E375",519,261,258
"2230085","Matale","Rattota","Wanaraniya","E375C",959,460,499
"2230090","Matale","Rattota","Lonvil","E373C",1724,782,942
"2230095","Matale","Rattota","Maradurawala","E373B",836,400,436
"2230100","Matale","Rattota","Pallegama","E373",1251,580,671
"2230105","Matale","Rattota","Koswana North","E371A",818,388,430
"2230110","Matale","Rattota","Palle Weragama","E371",933,455,478
"2230115","Matale","Rattota","Viharagama","E371C",2619,1222,1397
"2230120","Matale","Rattota","Kaineka","E371G",1135,558,577
"2230125","Matale","Rattota","Uda Weragama","E371B",803,345,458
"2230130","Matale","Rattota","Meda Weragama","E371F",575,287,288
"2230135","Matale","Rattota","Koswana South","E371E",539,251,288
"2230140","Matale","Rattota","Bogambara","E374A",798,394,404
"2230145","Matale","Rattota","Galekoluwa","E374B",1214,570,644
"2230150","Matale","Rattota","Welangahawatta","E376A",725,337,388
"2230155","Matale","Rattota","Horagolla","E376C",622,300,322
"2230160","Matale","Rattota","Bambarakiriella","E375D",1027,454,573
"2230165","Matale","Rattota","Alakolamada","E374C",606,295,311
"2230170","Matale","Rattota","Udagama","E374",676,313,363
"2230175","Matale","Rattota","Pitakanda","E368C",520,259,261
"2230180","Matale","Rattota","Gansarapola","E374D",506,249,257
"2230185","Matale","Rattota","Epitamulla","E368F",738,357,381
"2230190","Matale","Rattota","Wetasyaya","E368B",704,326,378
"2230195","Matale","Rattota","Godapala","E366A",942,446,496
"2230200","Matale","Rattota","Ulpothapitiya","E370",1653,780,873
"2230205","Matale","Rattota","Bandarapola","E366",1070,495,575
"2230210","Matale","Rattota","Muwandeniya","E368",895,414,481
"2230215","Matale","Rattota","Palleyaya","E368E",529,259,270
"2230220","Matale","Rattota","Neluwakanda","E368A",864,397,467
"2230225","Matale","Rattota","Punchiseluwakanda","E369B",1516,728,788
"2230230","Matale","Rattota","Thambalagala","E369A",909,406,503
"2230235","Matale","Rattota","Kandenuwara West","E368G",1053,507,546
"2230240","Matale","Rattota","Kandenuwara East","E368D",1281,606,675
"2230245","Matale","Rattota","Alwatta","E369",1233,598,635
"2230250","Matale","Rattota","Warapitiya","E366B",434,208,226
"2230255","Matale","Rattota","Dombagoda","E366C",491,225,266
"2230260","Matale","Rattota","Pahala Hapuvida","E367A",973,482,491
"2230265","Matale","Rattota","Uda Hapuvida","E367",674,335,339
"2230270","Matale","Rattota","Hangarankanda","E367B",1396,647,749
"2233005","Matale","Ukuwela","Galaudahena","E343F",491,244,247
"2233010","Matale","Ukuwela","Makulemada","E343B",183,83,100
"2233015","Matale","Ukuwela","Pathingolla","E344B",610,282,328
"2233020","Matale","Ukuwela","Wademada","E344E",445,215,230
"2233025","Matale","Ukuwela","Wattegedara","E343I",210,118,92
"2233030","Matale","Ukuwela","Watagoda","E343C",387,193,194
"2233035","Matale","Ukuwela","Pallekumbura","E343H",362,171,191
"2233040","Matale","Ukuwela","Katuattamada","E343E",479,232,247
"2233045","Matale","Ukuwela","Panwatta","E343D",362,164,198
"2233050","Matale","Ukuwela","Alawathuwala","E344C",424,202,222
"2233055","Matale","Ukuwela","Horagahapitiya","E344F",504,244,260
"2233060","Matale","Ukuwela","Ovilikanda","E344A",715,333,382
"2233065","Matale","Ukuwela","Kirimetiyawa","E343A",336,162,174
"2233070","Matale","Ukuwela","Thenna","E343",632,300,332
"2233075","Matale","Ukuwela","Muwagala","E343G",458,201,257
"2233080","Matale","Ukuwela","Ovilla","E344",440,214,226
"2233085","Matale","Ukuwela","Enasalmada","E344D",688,334,354
"2233090","Matale","Ukuwela","Thibbatuwawa","E345",542,268,274
"2233095","Matale","Ukuwela","Dombagasdeniya","E345A",844,412,432
"2233100","Matale","Ukuwela","Kendagolla","E347B",939,431,508
"2233105","Matale","Ukuwela","Kohombiliwela","E355C",1632,777,855
"2233110","Matale","Ukuwela","Wariyapola Watta","E355E",1917,911,1006
"2233115","Matale","Ukuwela","Wariyapola","E354",1538,731,807
"2233120","Matale","Ukuwela","Pananthadiya","E365E",478,220,258
"2233125","Matale","Ukuwela","Nawarathnagoda","E365B",592,287,305
"2233130","Matale","Ukuwela","Eriyagolla","E365D",505,239,266
"2233135","Matale","Ukuwela","Katudeniya","E354A",918,441,477
"2233140","Matale","Ukuwela","Elwala","E355A",1624,782,842
"2233145","Matale","Ukuwela","Pahalawela","E346A",1478,729,749
"2233150","Matale","Ukuwela","Dehipitiya","E356A",2240,1060,1180
"2233155","Matale","Ukuwela","Purijjala","E346",894,405,489
"2233160","Matale","Ukuwela","Udupihilla","E347",1141,525,616
"2233165","Matale","Ukuwela","Halangoda","E347A",980,459,521
"2233170","Matale","Ukuwela","Nagahathenna","E346B",1405,676,729
"2233175","Matale","Ukuwela","Warakamura","E356",1470,692,778
"2233180","Matale","Ukuwela","Meedeniya","E356B",2118,990,1128
"2233185","Matale","Ukuwela","Nagolla","E355D",1827,890,937
"2233190","Matale","Ukuwela","Thawalankoya","E355B",1472,689,783
"2233195","Matale","Ukuwela","Dumbukola","E354B",1088,480,608
"2233200","Matale","Ukuwela","Ukuwela","E355",2170,1017,1153
"2233205","Matale","Ukuwela","Udupitiya","E357B",884,417,467
"2233210","Matale","Ukuwela","Kalalpitiya","E357A",1064,501,563
"2233215","Matale","Ukuwela","Balakaduwa","E357D",636,310,326
"2233220","Matale","Ukuwela","Bowatta","E357",880,428,452
"2233225","Matale","Ukuwela","Manaboda","E359",2162,1011,1151
"2233230","Matale","Ukuwela","Paragahawela","E359A",2168,1060,1108
"2233235","Matale","Ukuwela","Udathenna","E365C",748,345,403
"2233240","Matale","Ukuwela","Hunuketawala","E363B",822,403,419
"2233245","Matale","Ukuwela","Leliambe","E365A",671,331,340
"2233250","Matale","Ukuwela","Elkaduwa Watta","E363C",1446,678,768
"2233255","Matale","Ukuwela","Elkaduwa","E363A",981,443,538
"2233260","Matale","Ukuwela","Udangamuwa","E363",511,249,262
"2233265","Matale","Ukuwela","Kendagollamada","E362H",399,195,204
"2233270","Matale","Ukuwela","Wehigala","E362A",664,326,338
"2233275","Matale","Ukuwela","Rathwatta","E364",595,278,317
"2233280","Matale","Ukuwela","Weligala","E365",439,207,232
"2233285","Matale","Ukuwela","Kureewela","E360C",1487,665,822
"2233290","Matale","Ukuwela","Maberiya","E359B",1098,474,624
"2233295","Matale","Ukuwela","Marukona","E360",2454,1131,1323
"2233300","Matale","Ukuwela","Gurulawela South","E358A",640,273,367
"2233305","Matale","Ukuwela","Gurulawela North","E358",640,284,356
"2233310","Matale","Ukuwela","Nugapitiya","E357C",864,407,457
"2233315","Matale","Ukuwela","Kandemada","E358B",477,218,259
"2233320","Matale","Ukuwela","Ulpathapitiya","E360B",915,419,496
"2233325","Matale","Ukuwela","Raithalawela","E360A",1204,602,602
"2233330","Matale","Ukuwela","Kaduwela","E361",1089,504,585
"2233335","Matale","Ukuwela","Pujagoda","E362G",682,323,359
"2233340","Matale","Ukuwela","Pahala Wehigala","E362C",609,297,312
"2233345","Matale","Ukuwela","Talingamada","E362D",557,257,300
"2233350","Matale","Ukuwela","Hunnasgiriyawatta","E362E",1322,643,679
"2233355","Matale","Ukuwela","Karagahahinna","E362F",416,188,228
"2233360","Matale","Ukuwela","Imbulpitiya","E362",497,241,256
"2233365","Matale","Ukuwela","Rangama","E362B",468,202,266
"2303005","Nuwara Eliya","Kothmale","Doruwadeniya","460A",464,209,255
"2303010","Nuwara Eliya","Kothmale","Polwathura","460K",659,316,343
"2303015","Nuwara Eliya","Kothmale","Pahala Gorakaoya","460L",1563,693,870
"2303020","Nuwara Eliya","Kothmale","Dambagolla","460D",730,333,397
"2303025","Nuwara Eliya","Kothmale","Nayapana","459C",1010,452,558
"2303030","Nuwara Eliya","Kothmale","Kadadora","459",949,460,489
"2303035","Nuwara Eliya","Kothmale","Kotagepitiya North","459B",528,254,274
"2303040","Nuwara Eliya","Kothmale","Nawa Morape","456D",992,468,524
"2303045","Nuwara Eliya","Kothmale","Nawa Kadadora","456A",1359,649,710
"2303050","Nuwara Eliya","Kothmale","Deltagemunupura","474F",1727,826,901
"2303055","Nuwara Eliya","Kothmale","Hellboda","474J",3353,1636,1717
"2303060","Nuwara Eliya","Kothmale","Karagasthalawa","474A",1672,825,847
"2303065","Nuwara Eliya","Kothmale","Frotoft","474M",2947,1470,1477
"2303070","Nuwara Eliya","Kothmale","Ramboda","474",2027,957,1070
"2303075","Nuwara Eliya","Kothmale","Sangilipalama","471/A",1519,724,795
"2303080","Nuwara Eliya","Kothmale","Panangammana","473",1021,497,524
"2303085","Nuwara Eliya","Kothmale","Katukithula","474E",1033,519,514
"2303090","Nuwara Eliya","Kothmale","Helsirigama","474D",852,395,457
"2303095","Nuwara Eliya","Kothmale","Kothmalgama","474G",1108,519,589
"2303100","Nuwara Eliya","Kothmale","Rajaela","456E",1115,527,588
"2303105","Nuwara Eliya","Kothmale","Mawela East","456",432,207,225
"2303110","Nuwara Eliya","Kothmale","Mawela West","456B",795,386,409
"2303115","Nuwara Eliya","Kothmale","Kotagepitiya South","459A",289,144,145
"2303120","Nuwara Eliya","Kothmale","Ranwanthalawa","458",332,153,179
"2303125","Nuwara Eliya","Kothmale","Thispane Kanda","462A",560,257,303
"2303130","Nuwara Eliya","Kothmale","Harangala","461",951,431,520
"2303135","Nuwara Eliya","Kothmale","Hapugasthalawa","460",1789,823,966
"2303140","Nuwara Eliya","Kothmale","Kaludemada","460E",1800,832,968
"2303145","Nuwara Eliya","Kothmale","Ihala Gorakaoya","460J",1099,514,585
"2303150","Nuwara Eliya","Kothmale","Mallanda","460F",1714,798,916
"2303155","Nuwara Eliya","Kothmale","Ruwanpura","460C",1504,756,748
"2303160","Nuwara Eliya","Kothmale","Werella Pathana","461D",359,174,185
"2303165","Nuwara Eliya","Kothmale","Halgolla","461C",1202,571,631
"2303170","Nuwara Eliya","Kothmale","Harangala South","461A",759,374,385
"2303175","Nuwara Eliya","Kothmale","Kirimetiyawa","461B",602,283,319
"2303180","Nuwara Eliya","Kothmale","Hunugaloya","460H",984,501,483
"2303185","Nuwara Eliya","Kothmale","Godamaditta","462B",897,428,469
"2303190","Nuwara Eliya","Kothmale","Wataddara","463",292,131,161
"2303195","Nuwara Eliya","Kothmale","Maswela","457",313,161,152
"2303200","Nuwara Eliya","Kothmale","Nawangama","464",58,33,25
"2303205","Nuwara Eliya","Kothmale","Mawela Kanda","456C",408,199,209
"2303210","Nuwara Eliya","Kothmale","Wethalawa","465E",360,181,179
"2303215","Nuwara Eliya","Kothmale","Gomburuoya","473C",622,294,328
"2303220","Nuwara Eliya","Kothmale","Wewahinna","473B",483,241,242
"2303225","Nuwara Eliya","Kothmale","Delunthalamada","473A",447,209,238
"2303230","Nuwara Eliya","Kothmale","Ambathalawa","470A",1087,495,592
"2303235","Nuwara Eliya","Kothmale","Malhewa","472A",680,335,345
"2303240","Nuwara Eliya","Kothmale","Rambodagama","472",666,310,356
"2303245","Nuwara Eliya","Kothmale","Wedamulla","474L",2368,1158,1210
"2303250","Nuwara Eliya","Kothmale","Palagolla","474C",2512,1225,1287
"2303255","Nuwara Eliya","Kothmale","Niyamgamdora","470",1077,571,506
"2303260","Nuwara Eliya","Kothmale","Hedunuwewa","465A",366,197,169
"2303265","Nuwara Eliya","Kothmale","Kalapitiya East","465",690,346,344
"2303270","Nuwara Eliya","Kothmale","Kottunugoda","465F",413,184,229
"2303275","Nuwara Eliya","Kothmale","Kalapitiya West","465C",418,201,217
"2303280","Nuwara Eliya","Kothmale","Weerasekarapura","465G",553,264,289
"2303285","Nuwara Eliya","Kothmale","Rojersangama South","465D",610,300,310
"2303290","Nuwara Eliya","Kothmale","Rojersangama North","465B",561,274,287
"2303295","Nuwara Eliya","Kothmale","Dombagasthalawa","465H",1127,527,600
"2303300","Nuwara Eliya","Kothmale","Katugolla","462C",609,295,314
"2303305","Nuwara Eliya","Kothmale","Thelissagala","460I",1348,673,675
"2303310","Nuwara Eliya","Kothmale","Ketabulawa","460G",2925,1365,1560
"2303315","Nuwara Eliya","Kothmale","Wijayabahu Kanda","467A",309,145,164
"2303320","Nuwara Eliya","Kothmale","Rawanagoda West","467E",508,246,262
"2303325","Nuwara Eliya","Kothmale","Udagama","467F",542,257,285
"2303330","Nuwara Eliya","Kothmale","Rawanagoda East","467",289,127,162
"2303335","Nuwara Eliya","Kothmale","Methagama","466",660,321,339
"2303340","Nuwara Eliya","Kothmale","Maldeniya","466A",496,239,257
"2303345","Nuwara Eliya","Kothmale","Katarandana","466B",651,326,325
"2303350","Nuwara Eliya","Kothmale","Kirindiwela","469B",745,357,388
"2303355","Nuwara Eliya","Kothmale","Kumbaloluwa","469",546,278,268
"2303360","Nuwara Eliya","Kothmale","Medakanda","469C",596,293,303
"2303365","Nuwara Eliya","Kothmale","Egodawela","469A",288,151,137
"2303370","Nuwara Eliya","Kothmale","Pundaluoya North","468E",1422,699,723
"2303375","Nuwara Eliya","Kothmale","Labukele","474I",3094,1561,1533
"2303380","Nuwara Eliya","Kothmale","Kudaoya","474B",963,476,487
"2303385","Nuwara Eliya","Kothmale","Samaneliya","474H",595,296,299
"2303390","Nuwara Eliya","Kothmale","Kikiliyamana","468I",696,327,369
"2303395","Nuwara Eliya","Kothmale","Dunsinane","468N",3897,1891,2006
"2303400","Nuwara Eliya","Kothmale","Sheen","468M",2831,1344,1487
"2303405","Nuwara Eliya","Kothmale","Sheengama","468J",1119,513,606
"2303410","Nuwara Eliya","Kothmale","Pundaluoya South","468C",3151,1474,1677
"2303415","Nuwara Eliya","Kothmale","Kadadorapitiya","468A",461,222,239
"2303420","Nuwara Eliya","Kothmale","Kosgaha Pathana","468G",2185,1067,1118
"2303425","Nuwara Eliya","Kothmale","Karagahayatathenna","468F",464,223,241
"2303430","Nuwara Eliya","Kothmale","Bogahawela","468D",431,204,227
"2303435","Nuwara Eliya","Kothmale","Halpola","468H",660,314,346
"2303440","Nuwara Eliya","Kothmale","Madakumbura","468",904,438,466
"2303445","Nuwara Eliya","Kothmale","Beramana","467B",517,256,261
"2303450","Nuwara Eliya","Kothmale","Beramana North","467D",468,212,256
"2303455","Nuwara Eliya","Kothmale","Kolapathana","460B",1229,545,684
"2303460","Nuwara Eliya","Kothmale","Queensberry","460M",1678,769,909
"2303465","Nuwara Eliya","Kothmale","Beramana South","467C",247,130,117
"2303470","Nuwara Eliya","Kothmale","Weerapura","467G",585,288,297
"2303475","Nuwara Eliya","Kothmale","Dunukedeniya","468B",1412,678,734
"2303480","Nuwara Eliya","Kothmale","Medakumbura North","468K",2852,1330,1522
"2306005","Nuwara Eliya","Hanguranketha","Hingurukaduwa","486A",452,217,235
"2306010","Nuwara Eliya","Hanguranketha","Ambewela","486B",570,278,292
"2306015","Nuwara Eliya","Hanguranketha","Welikada","485B",828,390,438
"2306020","Nuwara Eliya","Hanguranketha","Idamalanda","486",991,482,509
"2306025","Nuwara Eliya","Hanguranketha","Adikarigama","486C",1240,591,649
"2306030","Nuwara Eliya","Hanguranketha","Karalliyadda","485",626,305,321
"2306035","Nuwara Eliya","Hanguranketha","Bogahalanda","485A",672,314,358
"2306040","Nuwara Eliya","Hanguranketha","Hakuruthale","488A",170,82,88
"2306045","Nuwara Eliya","Hanguranketha","Maliyadda","485C",348,172,176
"2306050","Nuwara Eliya","Hanguranketha","Mirahampe","487B",172,75,97
"2306055","Nuwara Eliya","Hanguranketha","Pussalamankada","495A",809,373,436
"2306060","Nuwara Eliya","Hanguranketha","Yati Hanguranketha","495B",799,367,432
"2306065","Nuwara Eliya","Hanguranketha","Delgahapitiya","495D",704,351,353
"2306070","Nuwara Eliya","Hanguranketha","Sangaraja Gama","494B",976,460,516
"2306075","Nuwara Eliya","Hanguranketha","Mudunapita","487A",398,179,219
"2306080","Nuwara Eliya","Hanguranketha","Ganga Udagama","487",552,252,300
"2306085","Nuwara Eliya","Hanguranketha","Malulla","488",504,224,280
"2306090","Nuwara Eliya","Hanguranketha","Udawatta East","489A",800,374,426
"2306095","Nuwara Eliya","Hanguranketha","Hilpenkandura","488B",393,198,195
"2306100","Nuwara Eliya","Hanguranketha","Galauda North","489E",719,353,366
"2306105","Nuwara Eliya","Hanguranketha","Endiribedda","491B",317,163,154
"2306110","Nuwara Eliya","Hanguranketha","Happawara","491D",447,211,236
"2306115","Nuwara Eliya","Hanguranketha","Galauda South","489",491,221,270
"2306120","Nuwara Eliya","Hanguranketha","Udakanda","489C",489,233,256
"2306125","Nuwara Eliya","Hanguranketha","Udawatta West","489D",589,292,297
"2306130","Nuwara Eliya","Hanguranketha","Udawatta Kumbura","494F",848,409,439
"2306135","Nuwara Eliya","Hanguranketha","Pallemaluwa","495C",427,214,213
"2306140","Nuwara Eliya","Hanguranketha","Hanguranketha","495",885,500,385
"2306145","Nuwara Eliya","Hanguranketha","Damunumeya North","494E",532,249,283
"2306150","Nuwara Eliya","Hanguranketha","Arattana","496B",774,371,403
"2306155","Nuwara Eliya","Hanguranketha","Ambaliyadda","496A",738,352,386
"2306160","Nuwara Eliya","Hanguranketha","Dampola","496C",708,320,388
"2306165","Nuwara Eliya","Hanguranketha","Rekitipe","497A",994,451,543
"2306170","Nuwara Eliya","Hanguranketha","Hapuwala","496",764,351,413
"2306175","Nuwara Eliya","Hanguranketha","Dolugala","494A",689,322,367
"2306180","Nuwara Eliya","Hanguranketha","Deliwala","494D",623,298,325
"2306185","Nuwara Eliya","Hanguranketha","Madanwala","493",695,375,320
"2306190","Nuwara Eliya","Hanguranketha","Damunumeya","494",642,294,348
"2306195","Nuwara Eliya","Hanguranketha","Kottala","493A",701,352,349
"2306200","Nuwara Eliya","Hanguranketha","Diya - Udagama","492",736,340,396
"2306205","Nuwara Eliya","Hanguranketha","Uda Galauda","489B",658,297,361
"2306210","Nuwara Eliya","Hanguranketha","Illagolla","491",512,240,272
"2306215","Nuwara Eliya","Hanguranketha","Rammalakandura","491C",434,206,228
"2306220","Nuwara Eliya","Hanguranketha","Moragolla","491A",773,379,394
"2306225","Nuwara Eliya","Hanguranketha","Dodamkumbura","492B",1441,663,778
"2306230","Nuwara Eliya","Hanguranketha","Walalawela","492C",478,224,254
"2306235","Nuwara Eliya","Hanguranketha","Rathmetiya","494C",711,363,348
"2306240","Nuwara Eliya","Hanguranketha","Hapugasdeniya","502A",576,245,331
"2306245","Nuwara Eliya","Hanguranketha","Diggalpotta","502B",744,352,392
"2306250","Nuwara Eliya","Hanguranketha","Unanthenna","497",481,222,259
"2306255","Nuwara Eliya","Hanguranketha","Kosgaha Debala","500D",618,291,327
"2306260","Nuwara Eliya","Hanguranketha","Warapitiya","500C",278,130,148
"2306265","Nuwara Eliya","Hanguranketha","Medagama","500B",532,258,274
"2306270","Nuwara Eliya","Hanguranketha","Bowala","500",587,261,326
"2306275","Nuwara Eliya","Hanguranketha","Kithulpe","500A",619,302,317
"2306280","Nuwara Eliya","Hanguranketha","Makempe","498C",380,191,189
"2306285","Nuwara Eliya","Hanguranketha","Puranagama","498E",251,123,128
"2306290","Nuwara Eliya","Hanguranketha","Ekiriya","502",447,198,249
"2306295","Nuwara Eliya","Hanguranketha","Poramadulla","498A",1628,790,838
"2306300","Nuwara Eliya","Hanguranketha","Labuhena","498F",937,437,500
"2306305","Nuwara Eliya","Hanguranketha","Udawela Pathana","482C",387,185,202
"2306310","Nuwara Eliya","Hanguranketha","Welampagoda","482B",546,259,287
"2306315","Nuwara Eliya","Hanguranketha","Denike","482",749,345,404
"2306320","Nuwara Eliya","Hanguranketha","Rikillagaskada","492A",1995,974,1021
"2306325","Nuwara Eliya","Hanguranketha","Alawattegama","479A",671,330,341
"2306330","Nuwara Eliya","Hanguranketha","Uda Makuruppa","484B",748,337,411
"2306335","Nuwara Eliya","Hanguranketha","Palle Makuruppa","484C",308,146,162
"2306340","Nuwara Eliya","Hanguranketha","Bogamuwa","484A",792,365,427
"2306345","Nuwara Eliya","Hanguranketha","Dimbulkumbura","484D",718,345,373
"2306350","Nuwara Eliya","Hanguranketha","Bodhiwela","484E",487,229,258
"2306355","Nuwara Eliya","Hanguranketha","Pallewela","484",495,244,251
"2306360","Nuwara Eliya","Hanguranketha","Kaluattanagolla","479B",608,277,331
"2306365","Nuwara Eliya","Hanguranketha","Wadawala","479",582,279,303
"2306370","Nuwara Eliya","Hanguranketha","Udalumada","482A",851,399,452
"2306375","Nuwara Eliya","Hanguranketha","Bulugahapitiya","501A",428,216,212
"2306380","Nuwara Eliya","Hanguranketha","Wegama","498",408,207,201
"2306385","Nuwara Eliya","Hanguranketha","Agappala","498B",486,245,241
"2306390","Nuwara Eliya","Hanguranketha","Bambaragama","499",382,186,196
"2306395","Nuwara Eliya","Hanguranketha","Bambaragama East","499E",468,230,238
"2306400","Nuwara Eliya","Hanguranketha","Bambaragama West","499F",386,159,227
"2306405","Nuwara Eliya","Hanguranketha","Malanwatta","503A",362,159,203
"2306410","Nuwara Eliya","Hanguranketha","Gannewa Udagama","503",378,181,197
"2306415","Nuwara Eliya","Hanguranketha","Gedereiyawa","503B",183,83,100
"2306420","Nuwara Eliya","Hanguranketha","Daraoya","499C",506,242,264
"2306425","Nuwara Eliya","Hanguranketha","Kirimetiya","499G",443,207,236
"2306430","Nuwara Eliya","Hanguranketha","Hope","501G",3203,1489,1714
"2306435","Nuwara Eliya","Hanguranketha","Wetesthenna","499D",366,172,194
"2306440","Nuwara Eliya","Hanguranketha","Handawalapitiya","499A",658,308,350
"2306445","Nuwara Eliya","Hanguranketha","Karamidula","499B",467,229,238
"2306450","Nuwara Eliya","Hanguranketha","Madumana","501C",799,388,411
"2306455","Nuwara Eliya","Hanguranketha","Rahathungoda","501",885,413,472
"2306460","Nuwara Eliya","Hanguranketha","Enasal Arawa","501E",643,296,347
"2306465","Nuwara Eliya","Hanguranketha","Kawatayamana","501D",289,117,172
"2306470","Nuwara Eliya","Hanguranketha","Ehelamalpe","483A",633,299,334
"2306475","Nuwara Eliya","Hanguranketha","Rathukurusa Janapadaya","481C",711,334,377
"2306480","Nuwara Eliya","Hanguranketha","Wilwala","483",790,361,429
"2306485","Nuwara Eliya","Hanguranketha","Dehipe","481",696,326,370
"2306490","Nuwara Eliya","Hanguranketha","Deniyagama","481B",599,279,320
"2306495","Nuwara Eliya","Hanguranketha","Bodhimalkada","481A",824,380,444
"2306500","Nuwara Eliya","Hanguranketha","Welapahala","481D",668,307,361
"2306505","Nuwara Eliya","Hanguranketha","Uda Padiyapelella","510A",643,303,340
"2306510","Nuwara Eliya","Hanguranketha","Okandagala","510B",134,75,59
"2306515","Nuwara Eliya","Hanguranketha","Rookwood Estate","501F",1853,878,975
"2306520","Nuwara Eliya","Hanguranketha","Muloya","501B",2334,1133,1201
"2306525","Nuwara Eliya","Hanguranketha","Rathyaya","511C",166,76,90
"2306530","Nuwara Eliya","Hanguranketha","Godigamuwa","511D",1232,561,671
"2306535","Nuwara Eliya","Hanguranketha","Manakola","511",442,219,223
"2306540","Nuwara Eliya","Hanguranketha","Marthuwela","511B",793,381,412
"2306545","Nuwara Eliya","Hanguranketha","Idampitiya","510",519,229,290
"2306550","Nuwara Eliya","Hanguranketha","Mathurata","509",776,366,410
"2306555","Nuwara Eliya","Hanguranketha","Udagama","508C",291,136,155
"2306560","Nuwara Eliya","Hanguranketha","Merrygoll","509A",384,172,212
"2306565","Nuwara Eliya","Hanguranketha","Ketayapathana","508",250,124,126
"2306570","Nuwara Eliya","Hanguranketha","Gonakele","508B",568,271,297
"2306575","Nuwara Eliya","Hanguranketha","Gonapitiya","508F",3112,1522,1590
"2306580","Nuwara Eliya","Hanguranketha","Bomellagoda","508E",214,112,102
"2306585","Nuwara Eliya","Hanguranketha","Dunukebedda","508A",343,147,196
"2306590","Nuwara Eliya","Hanguranketha","Wellagiriya","512",472,217,255
"2306595","Nuwara Eliya","Hanguranketha","Ampitigoda","508D",600,275,325
"2306600","Nuwara Eliya","Hanguranketha","Wewathenna","512F",293,145,148
"2306605","Nuwara Eliya","Hanguranketha","Metibembiya","512A",511,248,263
"2306610","Nuwara Eliya","Hanguranketha","Goodwood","512C",536,266,270
"2306615","Nuwara Eliya","Hanguranketha","Hunukotuwa","512I",664,320,344
"2306620","Nuwara Eliya","Hanguranketha","Medawela","512G",525,268,257
"2306625","Nuwara Eliya","Hanguranketha","Labuhenwala","512E",458,230,228
"2306630","Nuwara Eliya","Hanguranketha","Ketahira","511F",480,220,260
"2306635","Nuwara Eliya","Hanguranketha","Deegalahinna","511A",1311,644,667
"2306640","Nuwara Eliya","Hanguranketha","Elamulla","511E",935,479,456
"2306645","Nuwara Eliya","Hanguranketha","Udawela","512D",913,458,455
"2306650","Nuwara Eliya","Hanguranketha","Mandaram Nuwara","512B",551,272,279
"2306655","Nuwara Eliya","Hanguranketha","Malsara Nuwara","512H",730,355,375
"2309005","Nuwara Eliya","Walapane","Serasunthenna","513B",548,286,262
"2309010","Nuwara Eliya","Walapane","Morangathenna","519E",259,122,137
"2309015","Nuwara Eliya","Walapane","Hegasulla","521A",365,177,188
"2309020","Nuwara Eliya","Walapane","Bolagandawela","521",298,139,159
"2309025","Nuwara Eliya","Walapane","Ambagahathenna","521B",740,358,382
"2309030","Nuwara Eliya","Walapane","Helagama","521F",500,240,260
"2309035","Nuwara Eliya","Walapane","Mallagama","521D",504,253,251
"2309040","Nuwara Eliya","Walapane","Dulana","521E",340,161,179
"2309045","Nuwara Eliya","Walapane","Galketiwela","519C",465,224,241
"2309050","Nuwara Eliya","Walapane","Ellakumbura","519F",683,338,345
"2309055","Nuwara Eliya","Walapane","Muganagahapitiya","519G",425,208,217
"2309060","Nuwara Eliya","Walapane","Hapugahapitiya","519D",322,149,173
"2309065","Nuwara Eliya","Walapane","Ketakandura","516",394,194,200
"2309070","Nuwara Eliya","Walapane","Batagolla","515",189,98,91
"2309075","Nuwara Eliya","Walapane","Thennehenwala","514D",460,207,253
"2309080","Nuwara Eliya","Walapane","Deliwela South","514F",393,191,202
"2309085","Nuwara Eliya","Walapane","Deliwala North","514E",448,226,222
"2309090","Nuwara Eliya","Walapane","Pannala","513",665,330,335
"2309095","Nuwara Eliya","Walapane","Serupitiya","513A",779,367,412
"2309100","Nuwara Eliya","Walapane","Mailagasthenna","513E",338,154,184
"2309105","Nuwara Eliya","Walapane","Andawala","513F",213,116,97
"2309110","Nuwara Eliya","Walapane","Naranthalawa","514A",133,60,73
"2309115","Nuwara Eliya","Walapane","Ihala Pannala","513D",311,145,166
"2309120","Nuwara Eliya","Walapane","Wewakele","513C",387,181,206
"2309125","Nuwara Eliya","Walapane","Kumbalgamuwa","514",855,396,459
"2309130","Nuwara Eliya","Walapane","Kumbalgamuwa East","514B",570,254,316
"2309135","Nuwara Eliya","Walapane","Mulhalkele","514C",963,440,523
"2309140","Nuwara Eliya","Walapane","Manelwala","515A",570,273,297
"2309145","Nuwara Eliya","Walapane","Wathumulla","515D",785,362,423
"2309150","Nuwara Eliya","Walapane","Kendagolla","516A",186,79,107
"2309155","Nuwara Eliya","Walapane","Arampitiya","517D",608,294,314
"2309160","Nuwara Eliya","Walapane","Yombuwelthenna","519B",418,204,214
"2309165","Nuwara Eliya","Walapane","Udawela","519A",587,279,308
"2309170","Nuwara Eliya","Walapane","Kalaganwatta","519",616,300,316
"2309175","Nuwara Eliya","Walapane","Theripehe","521C",385,190,195
"2309180","Nuwara Eliya","Walapane","Udamadura North","518B",519,245,274
"2309185","Nuwara Eliya","Walapane","Galkadawela","518C",407,198,209
"2309190","Nuwara Eliya","Walapane","Yatimadura","518D",581,292,289
"2309195","Nuwara Eliya","Walapane","Kandeyaya","527C",878,432,446
"2309200","Nuwara Eliya","Walapane","Madulla North","527",698,340,358
"2309205","Nuwara Eliya","Walapane","Thunhitiyawa","518E",474,215,259
"2309210","Nuwara Eliya","Walapane","Wewathenna","523B",458,216,242
"2309215","Nuwara Eliya","Walapane","Kosgolla","518A",582,273,309
"2309220","Nuwara Eliya","Walapane","Udamadura","518",544,272,272
"2309225","Nuwara Eliya","Walapane","Ambanella","523",508,235,273
"2309230","Nuwara Eliya","Walapane","Dabbare","524D",581,266,315
"2309235","Nuwara Eliya","Walapane","Nildandaheenna","524E",1869,902,967
"2309240","Nuwara Eliya","Walapane","Rambuke","517C",283,134,149
"2309245","Nuwara Eliya","Walapane","Watambe","517A",369,174,195
"2309250","Nuwara Eliya","Walapane","Thibbatugoda","517",302,141,161
"2309255","Nuwara Eliya","Walapane","Egodakanda","516B",934,429,505
"2309260","Nuwara Eliya","Walapane","Kandegama","515C",889,408,481
"2309265","Nuwara Eliya","Walapane","Walapane","515B",1161,589,572
"2309270","Nuwara Eliya","Walapane","Kurunduoya","504E",2196,1035,1161
"2309275","Nuwara Eliya","Walapane","Liyanwela Ihalagama","506D",515,208,307
"2309280","Nuwara Eliya","Walapane","Madumana","506E",699,302,397
"2309285","Nuwara Eliya","Walapane","Ilukpelessa","506F",446,204,242
"2309290","Nuwara Eliya","Walapane","Unagolla","506A",627,282,345
"2309295","Nuwara Eliya","Walapane","Liyanwela Pahalagama","506B",983,445,538
"2309300","Nuwara Eliya","Walapane","Medakandura","506C",934,433,501
"2309305","Nuwara Eliya","Walapane","Galabada","505C",691,347,344
"2309310","Nuwara Eliya","Walapane","Ambagaspitiya","505B",583,272,311
"2309315","Nuwara Eliya","Walapane","Munwatta","506",594,278,316
"2309320","Nuwara Eliya","Walapane","Landupita","505D",421,181,240
"2309325","Nuwara Eliya","Walapane","Wetekegama","505E",311,152,159
"2309330","Nuwara Eliya","Walapane","Padiyapelella","505A",499,241,258
"2309335","Nuwara Eliya","Walapane","Napatawela","505",386,186,200
"2309340","Nuwara Eliya","Walapane","Ukuthule","507",605,269,336
"2309345","Nuwara Eliya","Walapane","Yatiwella","507B",431,212,219
"2309350","Nuwara Eliya","Walapane","Wetakepatha","504",669,320,349
"2309355","Nuwara Eliya","Walapane","Ukuthule East","507A",849,416,433
"2309360","Nuwara Eliya","Walapane","Alakolawewa","504C",602,285,317
"2309365","Nuwara Eliya","Walapane","High Forest","504D",2688,1287,1401
"2309370","Nuwara Eliya","Walapane","Mahakudugala","533I",1130,581,549
"2309375","Nuwara Eliya","Walapane","Brookside","533O",4993,2421,2572
"2309380","Nuwara Eliya","Walapane","High Forest","504B",1511,756,755
"2309385","Nuwara Eliya","Walapane","Binganthalawa","504A",2389,1199,1190
"2309390","Nuwara Eliya","Walapane","Maha Uva","515E",2425,1159,1266
"2309395","Nuwara Eliya","Walapane","Werellapathana","516C",893,412,481
"2309400","Nuwara Eliya","Walapane","Thibbatugoda South","517B",367,167,200
"2309405","Nuwara Eliya","Walapane","Goradiyagolla","524B",517,251,266
"2309410","Nuwara Eliya","Walapane","Denambure","524",328,148,180
"2309415","Nuwara Eliya","Walapane","Purankumbura","524C",411,180,231
"2309420","Nuwara Eliya","Walapane","Hegama","523A",322,147,175
"2309425","Nuwara Eliya","Walapane","Dambagolla","524A",399,192,207
"2309430","Nuwara Eliya","Walapane","Demataarawa","518F",409,206,203
"2309435","Nuwara Eliya","Walapane","Madulla South","527A",616,304,312
"2309440","Nuwara Eliya","Walapane","Morahela","527B",872,401,471
"2309445","Nuwara Eliya","Walapane","Meepanawa","528D",449,205,244
"2309450","Nuwara Eliya","Walapane","Roopaha East","528E",182,86,96
"2309455","Nuwara Eliya","Walapane","Pallewela","528A",447,206,241
"2309460","Nuwara Eliya","Walapane","Palugama","528B",612,283,329
"2309465","Nuwara Eliya","Walapane","Kotambe","525C",475,220,255
"2309470","Nuwara Eliya","Walapane","Karandagolla","525B",596,262,334
"2309475","Nuwara Eliya","Walapane","Udagama","525A",411,199,212
"2309480","Nuwara Eliya","Walapane","Kumbukwela","525",260,109,151
"2309485","Nuwara Eliya","Walapane","Morabedda","526C",534,266,268
"2309490","Nuwara Eliya","Walapane","Harasbedda North","526B",1434,718,716
"2309495","Nuwara Eliya","Walapane","Mahapathana","516D",367,184,183
"2309500","Nuwara Eliya","Walapane","Harasbedda South","526",397,180,217
"2309505","Nuwara Eliya","Walapane","Palalpathana","526A",876,420,456
"2309510","Nuwara Eliya","Walapane","Rathnayakapura","533C",3127,1540,1587
"2309515","Nuwara Eliya","Walapane","Ragala Watta","533N",3342,1635,1707
"2309520","Nuwara Eliya","Walapane","Manthreethenna","529",1469,698,771
"2309525","Nuwara Eliya","Walapane","Pandithaya Kumbura","529A",797,414,383
"2309530","Nuwara Eliya","Walapane","Roopaha","528",342,164,178
"2309535","Nuwara Eliya","Walapane","Mathetilla","528F",676,330,346
"2309540","Nuwara Eliya","Walapane","Embulampaha","531A",397,175,222
"2309545","Nuwara Eliya","Walapane","Maliyadda","528C",679,331,348
"2309550","Nuwara Eliya","Walapane","Kurupanawela","530",766,352,414
"2309555","Nuwara Eliya","Walapane","Wathulanda East","530A",382,174,208
"2309560","Nuwara Eliya","Walapane","Wathulanda West","530B",491,225,266
"2309565","Nuwara Eliya","Walapane","Ambaliyadda","531",535,254,281
"2309570","Nuwara Eliya","Walapane","Galkadapathana","533H",1084,504,580
"2309575","Nuwara Eliya","Walapane","Senarathpura","533B",2585,1230,1355
"2309580","Nuwara Eliya","Walapane","St. Leonard","533M",2491,1166,1325
"2309585","Nuwara Eliya","Walapane","Ragala","533",1914,968,946
"2309590","Nuwara Eliya","Walapane","Ekangapura","533J",1043,527,516
"2309595","Nuwara Eliya","Walapane","Samagipura","533A",884,427,457
"2309600","Nuwara Eliya","Walapane","Delmar","533L",3243,1619,1624
"2309605","Nuwara Eliya","Walapane","Sooriyagahapathana Ihala","533G",444,203,241
"2309610","Nuwara Eliya","Walapane","Sooriyagahapathana Pahala","533F",1016,468,548
"2309615","Nuwara Eliya","Walapane","Udapussellawa South","533E",2312,1115,1197
"2309620","Nuwara Eliya","Walapane","St. Magret","533K",3418,1618,1800
"2309625","Nuwara Eliya","Walapane","Udapussellawa North","533D",1592,768,824
"2312005","Nuwara Eliya","Nuwara Eliya","Bogahawatta","475P",3976,1900,2076
"2312010","Nuwara Eliya","Nuwara Eliya","Mount Vernon","475Q",2319,1079,1240
"2312015","Nuwara Eliya","Nuwara Eliya","Watagoda","475D",3896,1853,2043
"2312020","Nuwara Eliya","Nuwara Eliya","Hollyrood","475S",3393,1631,1762
"2312025","Nuwara Eliya","Nuwara Eliya","Great Western","475Z",3150,1513,1637
"2312030","Nuwara Eliya","Nuwara Eliya","Bangalahatha","476C",3333,1639,1694
"2312035","Nuwara Eliya","Nuwara Eliya","Toppass","535J",2757,1372,1385
"2312040","Nuwara Eliya","Nuwara Eliya","Park","534G",4463,2145,2318
"2312045","Nuwara Eliya","Nuwara Eliya","Concordia","534F",3758,1840,1918
"2312050","Nuwara Eliya","Nuwara Eliya","Kandapola","534",1426,663,763
"2312055","Nuwara Eliya","Nuwara Eliya","Kandapola Central","534C",2853,1401,1452
"2312060","Nuwara Eliya","Nuwara Eliya","Hawaeliya East","535H",2273,1080,1193
"2312065","Nuwara Eliya","Nuwara Eliya","Bambarakele","535K",3143,1508,1635
"2312070","Nuwara Eliya","Nuwara Eliya","Nuwara Eliya West","535L",2481,1353,1128
"2312075","Nuwara Eliya","Nuwara Eliya","Shanthipura","535M",1408,691,717
"2312080","Nuwara Eliya","Nuwara Eliya","Kalapura","535N",3465,1726,1739
"2312085","Nuwara Eliya","Nuwara Eliya","Bearwell","475X",3381,1629,1752
"2312090","Nuwara Eliya","Nuwara Eliya","Thalawakele","475E",4111,2077,2034
"2312095","Nuwara Eliya","Nuwara Eliya","Devon","475C",3227,1545,1682
"2312100","Nuwara Eliya","Nuwara Eliya","Dimbula","475B",4513,2036,2477
"2312105","Nuwara Eliya","Nuwara Eliya","Stonycliff","475M",3214,1527,1687
"2312110","Nuwara Eliya","Nuwara Eliya","Kuduoya","475A",4609,2228,2381
"2312115","Nuwara Eliya","Nuwara Eliya","Kotagala","475",5044,2349,2695
"2312120","Nuwara Eliya","Nuwara Eliya","Drayton","475N",3724,1766,1958
"2312125","Nuwara Eliya","Nuwara Eliya","Yulefield","475Y",4065,1902,2163
"2312130","Nuwara Eliya","Nuwara Eliya","Coombewood","475R",3942,1875,2067
"2312135","Nuwara Eliya","Nuwara Eliya","Lindula","475F",2965,1448,1517
"2312140","Nuwara Eliya","Nuwara Eliya","Rathnagiriya","475G",2309,1082,1227
"2312145","Nuwara Eliya","Nuwara Eliya","Waltrim","475V",7545,3733,3812
"2312150","Nuwara Eliya","Nuwara Eliya","Summerset","475W",3522,1718,1804
"2312155","Nuwara Eliya","Nuwara Eliya","Nanuoya","476",3860,1931,1929
"2312160","Nuwara Eliya","Nuwara Eliya","Windicorner","476E",1667,804,863
"2312165","Nuwara Eliya","Nuwara Eliya","Nuwara Eliya","535",1290,708,582
"2312170","Nuwara Eliya","Nuwara Eliya","Nuwara Eliya Central","535D",4292,2016,2276
"2312175","Nuwara Eliya","Nuwara Eliya","Hawaeliya North","535G",2216,1044,1172
"2312180","Nuwara Eliya","Nuwara Eliya","Hawaeliya West","535F",2072,1014,1058
"2312185","Nuwara Eliya","Nuwara Eliya","Bulu Ela","535I",1751,846,905
"2312190","Nuwara Eliya","Nuwara Eliya","Galpalama","534A",1222,619,603
"2312195","Nuwara Eliya","Nuwara Eliya","Jayalanka","534B",1431,695,736
"2312200","Nuwara Eliya","Nuwara Eliya","Kandapola East","534D",887,438,449
"2312205","Nuwara Eliya","Nuwara Eliya","Pedro","534H",3316,1605,1711
"2312210","Nuwara Eliya","Nuwara Eliya","Goredihela","478",1352,667,685
"2312215","Nuwara Eliya","Nuwara Eliya","Seethaeliya","478A",1815,867,948
"2312220","Nuwara Eliya","Nuwara Eliya","Sandathenna","535E",2816,1398,1418
"2312225","Nuwara Eliya","Nuwara Eliya","Kelegala","535C",1829,857,972
"2312230","Nuwara Eliya","Nuwara Eliya","Kalukele","535B",1093,512,581
"2312235","Nuwara Eliya","Nuwara Eliya","Magasthota","535A",1408,705,703
"2312240","Nuwara Eliya","Nuwara Eliya","Ruwaneliya","476D",2972,1413,1559
"2312245","Nuwara Eliya","Nuwara Eliya","Perakumpura","476B",3653,1714,1939
"2312250","Nuwara Eliya","Nuwara Eliya","Kirimetiya","476A",3967,1876,2091
"2312255","Nuwara Eliya","Nuwara Eliya","Nagasena","475H",5022,2399,2623
"2312260","Nuwara Eliya","Nuwara Eliya","Eildonhall","475T",3541,1682,1859
"2312265","Nuwara Eliya","Nuwara Eliya","Rahanwatta","475U",2764,1294,1470
"2312270","Nuwara Eliya","Nuwara Eliya","Balmoral","476Q",3264,1547,1717
"2312275","Nuwara Eliya","Nuwara Eliya","Hallbrook","475I",3217,1584,1633
"2312280","Nuwara Eliya","Nuwara Eliya","Henfold","476N",3989,1901,2088
"2312285","Nuwara Eliya","Nuwara Eliya","Thangakele","476M",2419,1142,1277
"2312290","Nuwara Eliya","Nuwara Eliya","Magoda","476F",1387,662,725
"2312295","Nuwara Eliya","Nuwara Eliya","Mihindupura","476G",1226,608,618
"2312300","Nuwara Eliya","Nuwara Eliya","Meepilimana","476H",2012,978,1034
"2312305","Nuwara Eliya","Nuwara Eliya","Ambewela","477A",774,404,370
"2312310","Nuwara Eliya","Nuwara Eliya","Pattipola","477",1757,936,821
"2312315","Nuwara Eliya","Nuwara Eliya","Lippakelle","476L",2731,1300,1431
"2312320","Nuwara Eliya","Nuwara Eliya","Dayagama West","475L",3059,1495,1564
"2312325","Nuwara Eliya","Nuwara Eliya","Sandrinham","476R",2780,1387,1393
"2312330","Nuwara Eliya","Nuwara Eliya","Glasgow","476J",4123,1952,2171
"2312335","Nuwara Eliya","Nuwara Eliya","Braemore","476P",2335,1096,1239
"2312340","Nuwara Eliya","Nuwara Eliya","Albian","476K",3811,1776,2035
"2312345","Nuwara Eliya","Nuwara Eliya","Elbedda","475J",3904,1920,1984
"2312350","Nuwara Eliya","Nuwara Eliya","Agarapathana","475K",2143,1064,1079
"2312355","Nuwara Eliya","Nuwara Eliya","Weverly","476T",2820,1326,1494
"2312360","Nuwara Eliya","Nuwara Eliya","Dayagama East","476S",3842,1847,1995
"2315005","Nuwara Eliya","Ambagamuwa","Kalugala","316C",800,361,439
"2315010","Nuwara Eliya","Ambagamuwa","Pitawala","316D",1119,473,646
"2315015","Nuwara Eliya","Ambagamuwa","Bulathgama","316",1677,770,907
"2315020","Nuwara Eliya","Ambagamuwa","Gonawala","316B",1155,508,647
"2315025","Nuwara Eliya","Ambagamuwa","Ambagamuwa North","314B",1250,562,688
"2315030","Nuwara Eliya","Ambagamuwa","Sellipigama","314C",2292,1024,1268
"2315035","Nuwara Eliya","Ambagamuwa","Ambagamuwa East","314A",1505,730,775
"2315040","Nuwara Eliya","Ambagamuwa","Ambagamuwa South","314",1587,694,893
"2315045","Nuwara Eliya","Ambagamuwa","Rampadeniya","316A",1501,739,762
"2315050","Nuwara Eliya","Ambagamuwa","Millagahamula","316E",861,393,468
"2315055","Nuwara Eliya","Ambagamuwa","Dagampitiya","316F",1154,525,629
"2315060","Nuwara Eliya","Ambagamuwa","Polpitiya","318",1324,604,720
"2315065","Nuwara Eliya","Ambagamuwa","Minuwandeniya","318C",706,352,354
"2315070","Nuwara Eliya","Ambagamuwa","Hitigegama","318A",812,390,422
"2315075","Nuwara Eliya","Ambagamuwa","Kehelwarawa","316G",948,430,518
"2315080","Nuwara Eliya","Ambagamuwa","Homagama","314D",1093,498,595
"2315085","Nuwara Eliya","Ambagamuwa","Hebbekanda","314G",990,433,557
"2315090","Nuwara Eliya","Ambagamuwa","Samansirigama","315B",822,362,460
"2315095","Nuwara Eliya","Ambagamuwa","Theeniyagala","315",674,301,373
"2315100","Nuwara Eliya","Ambagamuwa","Ginigathhena","315A",2867,1384,1483
"2315105","Nuwara Eliya","Ambagamuwa","Dehigasthenna","314F",1703,769,934
"2315110","Nuwara Eliya","Ambagamuwa","Kalaweldeniya","314E",919,434,485
"2315115","Nuwara Eliya","Ambagamuwa","Morahenagama","317C",1274,595,679
"2315120","Nuwara Eliya","Ambagamuwa","Hangarapitiya","318B",505,226,279
"2315125","Nuwara Eliya","Ambagamuwa","Jambuthenna","318D",1164,530,634
"2315130","Nuwara Eliya","Ambagamuwa","Kottellena","318E",1742,814,928
"2315135","Nuwara Eliya","Ambagamuwa","Waggama","317B",941,426,515
"2315140","Nuwara Eliya","Ambagamuwa","Lakshapana","317A",1458,688,770
"2315145","Nuwara Eliya","Ambagamuwa","Kiriwaneliya","317",884,408,476
"2315150","Nuwara Eliya","Ambagamuwa","Vidulipura South","315C",1066,526,540
"2315155","Nuwara Eliya","Ambagamuwa","Vidulipura North","315D",677,309,368
"2315160","Nuwara Eliya","Ambagamuwa","Watawala","320F",5690,2674,3016
"2315165","Nuwara Eliya","Ambagamuwa","Rosella","320E",3598,1701,1897
"2315170","Nuwara Eliya","Ambagamuwa","Welioya","320P",4977,2362,2615
"2315175","Nuwara Eliya","Ambagamuwa","Maussakele","320I",4414,2060,2354
"2315180","Nuwara Eliya","Ambagamuwa","Lethant","319K",6172,2887,3285
"2315185","Nuwara Eliya","Ambagamuwa","Shanon","320O",3019,1439,1580
"2315190","Nuwara Eliya","Ambagamuwa","Hatton East","319E",4941,2376,2565
"2315195","Nuwara Eliya","Ambagamuwa","Hatton South","319D",3762,1737,2025
"2315200","Nuwara Eliya","Ambagamuwa","Panmur","320R",2235,1105,1130
"2315205","Nuwara Eliya","Ambagamuwa","Ruwanpura","320G",2288,1126,1162
"2315210","Nuwara Eliya","Ambagamuwa","Hatton West","319C",2011,957,1054
"2315215","Nuwara Eliya","Ambagamuwa","Hatton North","319B",7636,3568,4068
"2315220","Nuwara Eliya","Ambagamuwa","Dickoya","319A",3481,1653,1828
"2315225","Nuwara Eliya","Ambagamuwa","Annfield","319I",7226,3477,3749
"2315230","Nuwara Eliya","Ambagamuwa","Dickoya South","319",3339,1587,1752
"2315235","Nuwara Eliya","Ambagamuwa","Injustry","319L",4822,2309,2513
"2315240","Nuwara Eliya","Ambagamuwa","Wanarajah","319J",4115,1977,2138
"2315245","Nuwara Eliya","Ambagamuwa","Newvalleygama","319H",3638,1719,1919
"2315250","Nuwara Eliya","Ambagamuwa","Norwood","320",6612,3097,3515
"2315255","Nuwara Eliya","Ambagamuwa","Maskeliya","320A",3851,1876,1975
"2315260","Nuwara Eliya","Ambagamuwa","Brownlow","320N",4507,2067,2440
"2315265","Nuwara Eliya","Ambagamuwa","Seethagangula","320B",4296,2097,2199
"2315270","Nuwara Eliya","Ambagamuwa","Moray","320H",3084,1506,1578
"2315275","Nuwara Eliya","Ambagamuwa","Mocha","320Q",5267,2562,2705
"2315280","Nuwara Eliya","Ambagamuwa","Brownswick","320M",5950,2792,3158
"2315285","Nuwara Eliya","Ambagamuwa","Gawarawila","320C",5474,2626,2848
"2315290","Nuwara Eliya","Ambagamuwa","Mahanelu","320K",2303,1081,1222
"2315295","Nuwara Eliya","Ambagamuwa","Venture","320L",5398,2599,2799
"2315300","Nuwara Eliya","Ambagamuwa","Tillary","319M",2248,1039,1209
"2315305","Nuwara Eliya","Ambagamuwa","Kirkoswald","319G",10150,4918,5232
"2315310","Nuwara Eliya","Ambagamuwa","Bogawana","319N",5003,2393,2610
"2315315","Nuwara Eliya","Ambagamuwa","Loinon","319O",6996,3343,3653
"2315320","Nuwara Eliya","Ambagamuwa","Kotiyagala","319P",3033,1491,1542
"2315325","Nuwara Eliya","Ambagamuwa","Bagawanthalawa South","319F",6248,3006,3242
"2315330","Nuwara Eliya","Ambagamuwa","Aulton Watta","320J",5231,2466,2765
"2315335","Nuwara Eliya","Ambagamuwa","Strathspey","320D",5238,2517,2721
"5103005","Batticaloa","Koralai Pattu North (Vaharai)","Kathiraveli","213",2492,1236,1256
"5103010","Batticaloa","Koralai Pattu North (Vaharai)","Ammanthanaaveli","213D",1817,934,883
"5103015","Batticaloa","Koralai Pattu North (Vaharai)","Puchchakkerni","213C",1386,680,706
"5103020","Batticaloa","Koralai Pattu North (Vaharai)","Palchenai","213A",1830,900,930
"5103025","Batticaloa","Koralai Pattu North (Vaharai)","Vakarai North","212A",1989,959,1030
"5103030","Batticaloa","Koralai Pattu North (Vaharai)","Ooriyankattu","212B",2135,1089,1046
"5103035","Batticaloa","Koralai Pattu North (Vaharai)","Kaddumurivu","213B",684,340,344
"5103040","Batticaloa","Koralai Pattu North (Vaharai)","Vakarai Centrel","212",287,140,147
"5103045","Batticaloa","Koralai Pattu North (Vaharai)","Panichchankerni","211C",1749,836,913
"5103050","Batticaloa","Koralai Pattu North (Vaharai)","Mathurankernikulam","211E",579,274,305
"5103055","Batticaloa","Koralai Pattu North (Vaharai)","Punanai East","211B",1987,984,1003
"5103060","Batticaloa","Koralai Pattu North (Vaharai)","Kirmichai","211F",1301,595,706
"5103065","Batticaloa","Koralai Pattu North (Vaharai)","Mankerny Central","211",315,178,137
"5103070","Batticaloa","Koralai Pattu North (Vaharai)","Mankerny South","211G",799,370,429
"5103075","Batticaloa","Koralai Pattu North (Vaharai)","Kayankerny","211A",1027,510,517
"5103080","Batticaloa","Koralai Pattu North (Vaharai)","Vattavan","211D",1160,528,632
"5104005","Batticaloa","Koralai Pattu Central","Punanai East","211B",1747,881,866
"5104010","Batticaloa","Koralai Pattu Central","Thiyavattavan","210C",2279,1153,1126
"5104015","Batticaloa","Koralai Pattu Central","Valaichchenai 5 Muslim","206B",2105,1123,982
"5104020","Batticaloa","Koralai Pattu Central","Valaichchenai 4 Muslim","206",2306,1137,1169
"5104025","Batticaloa","Koralai Pattu Central","Valaichchenai 5Muslim South","206D",2724,1325,1399
"5104030","Batticaloa","Koralai Pattu Central","Brynthuraichenai North","206A",2997,1479,1518
"5104035","Batticaloa","Koralai Pattu Central","Brynthuraichenai  South","206C",4540,2193,2347
"5104040","Batticaloa","Koralai Pattu Central","Mavadichenai","208A",2810,1331,1479
"5104045","Batticaloa","Koralai Pattu Central","Chemmann Odai","208D",4179,1841,2338
"5106005","Batticaloa","Koralai Pattu West (Oddamavadi)","Paper Town","210B",3448,1745,1703
"5106010","Batticaloa","Koralai Pattu West (Oddamavadi)","Oddamavadi 01 North","208B/2",3320,1673,1647
"5106015","Batticaloa","Koralai Pattu West (Oddamavadi)","Oddamavadi 01 South","208B",2243,1109,1134
"5106020","Batticaloa","Koralai Pattu West (Oddamavadi)","Oddamavadi 02","208C",2238,1116,1122
"5106025","Batticaloa","Koralai Pattu West (Oddamavadi)","Oddamavadi 03","208",2498,1206,1292
"5106030","Batticaloa","Koralai Pattu West (Oddamavadi)","Meeravodai Muslim  West","207",2877,1438,1439
"5106035","Batticaloa","Koralai Pattu West (Oddamavadi)","Meeravodai Muslim East","207B",3155,1537,1618
"5106040","Batticaloa","Koralai Pattu West (Oddamavadi)","Mancholai","207A",2403,1131,1272
"5109005","Batticaloa","Koralai Pattu (Valaichchenai)","Nasivanthivu","205C",1037,471,566
"5109010","Batticaloa","Koralai Pattu (Valaichchenai)","Valachchenai Tamil","205",1300,615,685
"5109015","Batticaloa","Koralai Pattu (Valaichchenai)","Puthukudiyiruppu","205A",1960,895,1065
"5109020","Batticaloa","Koralai Pattu (Valaichchenai)","Peththalai","205B",2808,1311,1497
"5109025","Batticaloa","Koralai Pattu (Valaichchenai)","Kalkuda","204",2382,1205,1177
"5109030","Batticaloa","Koralai Pattu (Valaichchenai)","Kalmadu","204A",3934,1900,2034
"5109035","Batticaloa","Koralai Pattu (Valaichchenai)","Kannagipuram","205D",2303,1071,1232
"5109040","Batticaloa","Koralai Pattu (Valaichchenai)","Kumburumulai","203B",691,320,371
"5109045","Batticaloa","Koralai Pattu (Valaichchenai)","Sungankerny","202C",1778,896,882
"5109050","Batticaloa","Koralai Pattu (Valaichchenai)","Kinnayadi","202B",2355,1113,1242
"5109055","Batticaloa","Koralai Pattu (Valaichchenai)","Karuwakerni","202A",2030,985,1045
"5109060","Batticaloa","Koralai Pattu (Valaichchenai)","Meeravodai Tamil","202",798,387,411
"5110005","Batticaloa","Koralai Pattu South (Kiran)","Punanai West","210E",423,213,210
"5110010","Batticaloa","Koralai Pattu South (Kiran)","Vahaneri","210",1723,854,869
"5110015","Batticaloa","Koralai Pattu South (Kiran)","Muruthanai","209A",857,422,435
"5110025","Batticaloa","Koralai Pattu South (Kiran)","Kallichchai","210A",0,0,0
"5110030","Batticaloa","Koralai Pattu South (Kiran)","Vadamunai","210A/1",379,195,184
"5110035","Batticaloa","Koralai Pattu South (Kiran)","Kudumpimalai","209D",867,447,420
"5110040","Batticaloa","Koralai Pattu South (Kiran)","Perillaveli","209",839,429,410
"5110045","Batticaloa","Koralai Pattu South (Kiran)","Poolakadu","209C",1156,575,581
"5110050","Batticaloa","Koralai Pattu South (Kiran)","Kiran East","203",3728,1762,1966
"5110055","Batticaloa","Koralai Pattu South (Kiran)","Kiran West","203A",1491,700,791
"5110060","Batticaloa","Koralai Pattu South (Kiran)","Korakallimadu","203C",2030,964,1066
"5110065","Batticaloa","Koralai Pattu South (Kiran)","Santhiveli","200",3156,1474,1682
"5110070","Batticaloa","Koralai Pattu South (Kiran)","Palaiyadithona","200B",2414,1194,1220
"5110075","Batticaloa","Koralai Pattu South (Kiran)","Thevapuram","199A",2048,910,1138
"5110080","Batticaloa","Koralai Pattu South (Kiran)","Murakkottanchenai","199",1999,945,1054
"5110085","Batticaloa","Koralai Pattu South (Kiran)","Thihilivaddai","200A",1481,709,772
"5110090","Batticaloa","Koralai Pattu South (Kiran)","Koraveli","209B",1146,584,562
"5112005","Batticaloa","Eravur Pattu","Sittandy 3","201/3",2737,1335,1402
"5112010","Batticaloa","Eravur Pattu","Sittandy 2","201/2",972,454,518
"5112015","Batticaloa","Eravur Pattu","Sittandy 4","201/4",1780,836,944
"5112020","Batticaloa","Eravur Pattu","Sittandy 1","201/1",2761,1292,1469
"5112025","Batticaloa","Eravur Pattu","Mavadivembu 2","197E",2007,953,1054
"5112030","Batticaloa","Eravur Pattu","Mavadivembu 1","197A",3093,1461,1632
"5112035","Batticaloa","Eravur Pattu","Kaluwankerny 1","198",2469,1197,1272
"5112040","Batticaloa","Eravur Pattu","Kaluwankerny 2","198A",1866,920,946
"5112045","Batticaloa","Eravur Pattu","Thalavai","193",1399,653,746
"5112050","Batticaloa","Eravur Pattu","Iyankerny Tamil","193C",2644,1243,1401
"5112055","Batticaloa","Eravur Pattu","Kommathurai North","196B",1374,624,750
"5112060","Batticaloa","Eravur Pattu","Palachcholai","197C",1328,623,705
"5112065","Batticaloa","Eravur Pattu","Vantharumoolai East","197",3950,1795,2155
"5112070","Batticaloa","Eravur Pattu","Vantharumoolai West","197B",3303,1606,1697
"5112075","Batticaloa","Eravur Pattu","Iralkulam","201A",1326,686,640
"5112080","Batticaloa","Eravur Pattu","Mayilavaddavan","197D",242,130,112
"5112085","Batticaloa","Eravur Pattu","Koduwamadu","195A",1107,524,583
"5112090","Batticaloa","Eravur Pattu","Kommathurai West","196A",804,395,409
"5112095","Batticaloa","Eravur Pattu","Kommathurai East","196",1721,777,944
"5112100","Batticaloa","Eravur Pattu","Chenkalady - 2","195",1690,812,878
"5112105","Batticaloa","Eravur Pattu","Chenkalady 1","195/1",2786,1362,1424
"5112110","Batticaloa","Eravur Pattu","Iyankerny Muslim","193D",2293,1020,1273
"5112125","Batticaloa","Eravur Pattu","Savukkady","193A",1260,604,656
"5112130","Batticaloa","Eravur Pattu","Thannamunai","189A",1556,726,830
"5112135","Batticaloa","Eravur Pattu","Mylampavely","189B",2924,1398,1526
"5112140","Batticaloa","Eravur Pattu","Arumugathan Kudiyiruppu 2","189C",1953,903,1050
"5112145","Batticaloa","Eravur Pattu","Arumugathan Kudiyiruppu 1","189",1587,761,826
"5112150","Batticaloa","Eravur Pattu","Kumaraveliar Kiramam","195B",2079,981,1098
"5112155","Batticaloa","Eravur Pattu","Pankudahvely","186",1737,843,894
"5112160","Batticaloa","Eravur Pattu","Vepavedduwan","186A",2503,1210,1293
"5112165","Batticaloa","Eravur Pattu","Karadiyannaru","185A",1604,765,839
"5112180","Batticaloa","Eravur Pattu","Rugam","185",624,304,320
"5112190","Batticaloa","Eravur Pattu","Periyapullumalai","146",337,177,160
"5112195","Batticaloa","Eravur Pattu","Gemunupura","135A",1417,699,718
"5115005","Batticaloa","Eravur Town","Ellainagar","194B",1066,519,547
"5115010","Batticaloa","Eravur Town","Eravur 04","194",769,346,423
"5115015","Batticaloa","Eravur Town","Eravur 03","192",3193,1586,1607
"5115020","Batticaloa","Eravur Town","Eravur 03A","192B",3292,1624,1668
"5115025","Batticaloa","Eravur Town","Eravur 02","191",1683,795,888
"5115030","Batticaloa","Eravur Town","Eravur 02B","191B",1014,496,518
"5115035","Batticaloa","Eravur Town","Eravur 02C","191C",2171,1019,1152
"5115045","Batticaloa","Eravur Town","Eravur 01B","190B",1627,749,878
"5115050","Batticaloa","Eravur Town","Eravur 01","190",1239,576,663
"5115055","Batticaloa","Eravur Town","Eravur 01A","190A",1566,729,837
"5115060","Batticaloa","Eravur Town","Eravur 06A","192C",1512,660,852
"5115065","Batticaloa","Eravur Town","Eravur 06D","192D",1209,551,658
"5115070","Batticaloa","Eravur Town","Eravur 06","192A",1161,538,623
"5115075","Batticaloa","Eravur Town","Eravur 05","194A",1526,713,813
"5118005","Batticaloa","Manmunai North","Palameen  Madu","173C",952,475,477
"5118010","Batticaloa","Manmunai North","Navalady","172",281,155,126
"5118015","Batticaloa","Manmunai North","Amirthakali","173",2263,1066,1197
"5118020","Batticaloa","Manmunai North","Punnachcholai","173D",1994,961,1033
"5118025","Batticaloa","Manmunai North","Thiraimadu","173E",3060,1474,1586
"5118030","Batticaloa","Manmunai North","Saththurukondan","176A",1677,766,911
"5118035","Batticaloa","Manmunai North","Panichalady","176D",1312,626,686
"5118040","Batticaloa","Manmunai North","Kokkuvil","176",2295,1136,1159
"5118045","Batticaloa","Manmunai North","Sinna  Oorani","176F",4233,1963,2270
"5118050","Batticaloa","Manmunai North","Jayanthipuram","176G",1082,488,594
"5118055","Batticaloa","Manmunai North","Karuvappankerny","176B",2959,1404,1555
"5118060","Batticaloa","Manmunai North","Mamangam","173A",1971,954,1017
"5118065","Batticaloa","Manmunai North","Koolavadi","173F",886,406,480
"5118070","Batticaloa","Manmunai North","Koolavadi East","173I",1133,547,586
"5118075","Batticaloa","Manmunai North","Thamaraikerny","177B",1546,671,875
"5118080","Batticaloa","Manmunai North","Periya Uppodai","178A",3871,1844,2027
"5118085","Batticaloa","Manmunai North","Dutch Bar","172C",343,177,166
"5118090","Batticaloa","Manmunai North","Thissaveerasingam Sathukam","173J",1349,641,708
"5118095","Batticaloa","Manmunai North","Iruthayapuram  East","173B",1443,666,777
"5118100","Batticaloa","Manmunai North","Iruthayapuram Central","176H",949,435,514
"5118105","Batticaloa","Manmunai North","Iruthayapuram  West","176E",2495,1179,1316
"5118110","Batticaloa","Manmunai North","Periya Oorani","176C",1153,517,636
"5118115","Batticaloa","Manmunai North","Gnasooriyam Sathukam","173G",1540,704,836
"5118120","Batticaloa","Manmunai North","Vettukkadu","173K",604,280,324
"5118125","Batticaloa","Manmunai North","Barathipuram","173H",1555,705,850
"5118130","Batticaloa","Manmunai North","Thandavanveli","177",2907,1335,1572
"5118135","Batticaloa","Manmunai North","Arasadi","177A",1263,609,654
"5118140","Batticaloa","Manmunai North","Koddamunai","178",1893,1116,777
"5118145","Batticaloa","Manmunai North","Kallady Mugathuvaram","172A",1254,590,664
"5118150","Batticaloa","Manmunai North","Thiruchendhoor","172B",2369,1137,1232
"5118155","Batticaloa","Manmunai North","Kallady","171",2484,1265,1219
"5118160","Batticaloa","Manmunai North","Kallady Veloor","171C",3106,1457,1649
"5118165","Batticaloa","Manmunai North","Kallady Uppodai","171B",1907,916,991
"5118170","Batticaloa","Manmunai North","Puliyanthivu  East","179 A",1590,724,866
"5118175","Batticaloa","Manmunai North","Puliyanthivu  Central","179B",1098,485,613
"5118180","Batticaloa","Manmunai North","Puliyanthivu West","179",1272,541,731
"5118185","Batticaloa","Manmunai North","Puliyanthivu  South","179C",3093,1504,1589
"5118190","Batticaloa","Manmunai North","Thiruperunthurai","181A",1376,687,689
"5118195","Batticaloa","Manmunai North","Puthunagar","181C",1886,902,984
"5118200","Batticaloa","Manmunai North","Seththukudah","181D",1009,458,551
"5118205","Batticaloa","Manmunai North","Veechikalmunai","181B",770,357,413
"5118210","Batticaloa","Manmunai North","Thimilathivu","181",1141,515,626
"5118215","Batticaloa","Manmunai North","Nochchimunai","171A",4009,1773,2236
"5118220","Batticaloa","Manmunai North","Navatkudah","168B",1270,556,714
"5118225","Batticaloa","Manmunai North","Navatkudah East","168C",2900,1320,1580
"5118230","Batticaloa","Manmunai North","Navatkudah South","168D",844,373,471
"5118235","Batticaloa","Manmunai North","Manjanthoduvai North","168",649,301,348
"5118240","Batticaloa","Manmunai North","Manjanthoduvai South","168A",3191,1589,1602
"5121005","Batticaloa","Manmunai West","Narippulthoddam","184D",891,426,465
"5121010","Batticaloa","Manmunai West","Mahilavedduvaan","184",1654,792,862
"5121015","Batticaloa","Manmunai West","Karaveddi","183",1798,883,915
"5121020","Batticaloa","Manmunai West","Vilavedduwan","183A",1603,790,813
"5121025","Batticaloa","Manmunai West","Naavatkaadu","182B",1491,715,776
"5121030","Batticaloa","Manmunai West","Eachchantivu","182",1127,540,587
"5121035","Batticaloa","Manmunai West","Mankikaddu","182C",512,234,278
"5121040","Batticaloa","Manmunai West","Vavunativu","182A",876,463,413
"5121045","Batticaloa","Manmunai West","Ayithiyamalai South","184C",822,425,397
"5121050","Batticaloa","Manmunai West","Ayithiyamalai North","184B",1948,928,1020
"5121055","Batticaloa","Manmunai West","Nediyamadu","184E",684,352,332
"5121060","Batticaloa","Manmunai West","Pavatkodichenai","148A",1643,809,834
"5121065","Batticaloa","Manmunai West","Kurinchaamunai","149B",1152,565,587
"5121070","Batticaloa","Manmunai West","Paruththichenai","149D",1038,508,530
"5121075","Batticaloa","Manmunai West","Kannankudah","149",1010,502,508
"5121080","Batticaloa","Manmunai West","Mandapathadi","149C",777,378,399
"5121085","Batticaloa","Manmunai West","Karaiyakkantivu","149A",949,463,486
"5121090","Batticaloa","Manmunai West","Puthumandapaththadi","149E",1809,875,934
"5121095","Batticaloa","Manmunai West","Kaanthinagar","148C",535,254,281
"5121100","Batticaloa","Manmunai West","Unnichchi","184A",986,479,507
"5121105","Batticaloa","Manmunai West","Panchenai","148B",757,366,391
"5121110","Batticaloa","Manmunai West","Iluppadichenai","148",1170,577,593
"5121115","Batticaloa","Manmunai West","Koththiyapulai","148E",1002,478,524
"5121120","Batticaloa","Manmunai West","Kaanchirankudah","148D",2255,1085,1170
"5124005","Batticaloa","Kattankudy","Kattankudy Division 1","167",1133,534,599
"5124010","Batticaloa","Kattankudy","Kattankudy Division 1 South","167E",1817,836,981
"5124015","Batticaloa","Kattankudy","Kattankudy Division 2","166",1989,918,1071
"5124020","Batticaloa","Kattankudy","Kattankudy Division 2 North","166A",2436,1174,1262
"5124025","Batticaloa","Kattankudy","New Kattankudy Division North","167A",4837,2262,2575
"5124030","Batticaloa","Kattankudy","New Kattankudy Division South","167C",4874,2345,2529
"5124035","Batticaloa","Kattankudy","Kattankudy Division 3 East","165B",1289,621,668
"5124040","Batticaloa","Kattankudy","Kattankudy Division 3","165",1323,588,735
"5124045","Batticaloa","Kattankudy","Kattankudy Division 3 West","165A",964,448,516
"5124055","Batticaloa","Kattankudy","Kattankudy Division 4","164",1045,455,590
"5124060","Batticaloa","Kattankudy","Kattankudy Division 6","162",2517,1148,1369
"5124065","Batticaloa","Kattankudy","New Kattankudy Division West","167D",2049,893,1156
"5124070","Batticaloa","Kattankudy","New Kattankudy Division East","167B",5420,2523,2897
"5124075","Batticaloa","Kattankudy","Kattankudy Division 6 South","162A",2588,1145,1443
"5124080","Batticaloa","Kattankudy","Kattankudy Division 6 West","162B",1740,763,977
"5124085","Batticaloa","Kattankudy","Kattankudy Division 5","164A",2043,863,1180
"5124090","Batticaloa","Kattankudy","Kattankudy Division 5 South","164 B",868,415,453
"5127005","Batticaloa","Manmunai Pattu (Araipattai)","Kirankulam North","150",1531,770,761
"5127010","Batticaloa","Manmunai Pattu (Araipattai)","Kirankulam South","150A",1148,528,620
"5127015","Batticaloa","Manmunai Pattu (Araipattai)","Kirankulam","150B",1353,661,692
"5127020","Batticaloa","Manmunai Pattu (Araipattai)","Kirankulam  Central","150C",900,424,476
"5127025","Batticaloa","Manmunai Pattu (Araipattai)","Puthukudiyiruppu","151",1108,486,622
"5127030","Batticaloa","Manmunai Pattu (Araipattai)","Puthukudiyiruppu South","151A",991,425,566
"5127035","Batticaloa","Manmunai Pattu (Araipattai)","Puthukudiyiruppu North","151B",1640,745,895
"5127040","Batticaloa","Manmunai Pattu (Araipattai)","Palamunai","152",2607,1269,1338
"5127045","Batticaloa","Manmunai Pattu (Araipattai)","Thalankudah","153",1240,545,695
"5127050","Batticaloa","Manmunai Pattu (Araipattai)","Manmunai","153A",998,471,527
"5127055","Batticaloa","Manmunai Pattu (Araipattai)","Vedarkudiyiruppu","153B",1037,467,570
"5127060","Batticaloa","Manmunai Pattu (Araipattai)","Mavilankanthurai","154",936,439,497
"5127065","Batticaloa","Manmunai Pattu (Araipattai)","Kankeyanodai","155",931,393,538
"5127070","Batticaloa","Manmunai Pattu (Araipattai)","Ollikulam","155A",571,270,301
"5127075","Batticaloa","Manmunai Pattu (Araipattai)","Kankeyanodai South","155B",1411,643,768
"5127080","Batticaloa","Manmunai Pattu (Araipattai)","Araipattai  03","156",603,273,330
"5127085","Batticaloa","Manmunai Pattu (Araipattai)","Rajadurai Kiramam","156A",955,456,499
"5127090","Batticaloa","Manmunai Pattu (Araipattai)","Araipattai South","156B",711,300,411
"5127095","Batticaloa","Manmunai Pattu (Araipattai)","Kovilkulam","156C",1010,460,550
"5127100","Batticaloa","Manmunai Pattu (Araipattai)","Araipattai  Central","156D",498,231,267
"5127105","Batticaloa","Manmunai Pattu (Araipattai)","Araipattai 02","157",382,186,196
"5127110","Batticaloa","Manmunai Pattu (Araipattai)","Selvanagar","157A",1413,649,764
"5127115","Batticaloa","Manmunai Pattu (Araipattai)","Selvanagar East","157B",2355,1135,1220
"5127120","Batticaloa","Manmunai Pattu (Araipattai)","Araipattai East","157C",2335,1075,1260
"5127125","Batticaloa","Manmunai Pattu (Araipattai)","Araipattai North","157D",615,291,324
"5127130","Batticaloa","Manmunai Pattu (Araipattai)","Araipattai  01","158",815,367,448
"5127135","Batticaloa","Manmunai Pattu (Araipattai)","Araipattai West","158A",600,255,345
"5130005","Batticaloa","Manmunai South-West","Munaikkadu West","133A",1000,471,529
"5130010","Batticaloa","Manmunai South-West","Munaikkadu North","133C",1237,589,648
"5130015","Batticaloa","Manmunai South-West","Munaikkadu East","133",632,280,352
"5130020","Batticaloa","Manmunai South-West","Muthalaikkudah West","131A",1100,496,604
"5130025","Batticaloa","Manmunai South-West","Muthalaikkudah","131",789,373,416
"5130030","Batticaloa","Manmunai South-West","Mahiladitivu","129A",717,331,386
"5130035","Batticaloa","Manmunai South-West","Mahiladitivu South","129B",2034,987,1047
"5130040","Batticaloa","Manmunai South-West","Kokkadichcholai","134",1784,871,913
"5130045","Batticaloa","Manmunai South-West","Munaikkadu South","133B",1030,513,517
"5130050","Batticaloa","Manmunai South-West","Kokkadichcholai South","134A",1468,721,747
"5130055","Batticaloa","Manmunai South-West","Pandariyaveli","129",1356,662,694
"5130060","Batticaloa","Manmunai South-West","Arasaditivu North","128C",1035,512,523
"5130065","Batticaloa","Manmunai South-West","Paddippalai","128B",823,442,381
"5130070","Batticaloa","Manmunai South-West","Kuluvinamadu","135B",677,317,360
"5130075","Batticaloa","Manmunai South-West","Arasaditivu","128",1184,584,600
"5130080","Batticaloa","Manmunai South-West","Kadukkamunai","128A",1556,766,790
"5130085","Batticaloa","Manmunai South-West","Ampilanthurai North","127B",654,330,324
"5130090","Batticaloa","Manmunai South-West","Ampilanthurai","127",1206,602,604
"5130095","Batticaloa","Manmunai South-West","Ampilanthurai West","127A",815,405,410
"5130100","Batticaloa","Manmunai South-West","Katchenai","127C",689,353,336
"5130105","Batticaloa","Manmunai South-West","Mavadimunmaari","135",589,309,280
"5130110","Batticaloa","Manmunai South-West","Thanthamalai","135A",897,445,452
"5130115","Batticaloa","Manmunai South-West","Kachchakodi","135C",1113,574,539
"5130120","Batticaloa","Manmunai South-West","Panichchiyadimunmari","135D",341,172,169
"5133005","Batticaloa","Porativu Pattu","Selvapuram","107F",870,416,454
"5133010","Batticaloa","Porativu Pattu","Vammiyadiyoottu","107C",1413,697,716
"5133015","Batticaloa","Porativu Pattu","Thumpankerni (Y.F.S.)","107H",771,353,418
"5133020","Batticaloa","Porativu Pattu","Kalumunthanveli","107E",784,398,386
"5133030","Batticaloa","Porativu Pattu","Maavelkudah","107D",1135,506,629
"5133035","Batticaloa","Porativu Pattu","Vipulananthapuram","107G",766,326,440
"5133040","Batticaloa","Porativu Pattu","Palugaamam I","107",446,203,243
"5133045","Batticaloa","Porativu Pattu","Palugaamam II","106",805,396,409
"5133050","Batticaloa","Porativu Pattu","Vanninagar","106D",1147,562,585
"5133055","Batticaloa","Porativu Pattu","Veeranchenai","106B",636,280,356
"5133060","Batticaloa","Porativu Pattu","Thumpankerni","106C",457,189,268
"5133065","Batticaloa","Porativu Pattu","Saravanayadiyoottu","106E",548,223,325
"5133070","Batticaloa","Porativu Pattu","Thikkodai","106A",1413,635,778
"5133075","Batticaloa","Porativu Pattu","Navakirinagar","107A",330,166,164
"5133080","Batticaloa","Porativu Pattu","Kannapuram","99G",407,198,209
"5133085","Batticaloa","Porativu Pattu","Paalaiyadivaddai","99B",602,276,326
"5133090","Batticaloa","Porativu Pattu","Nellikkadu","99F",571,255,316
"5133095","Batticaloa","Porativu Pattu","Vivekananthapuram","99J",527,236,291
"5133100","Batticaloa","Porativu Pattu","Vellaveli","99",953,417,536
"5133105","Batticaloa","Porativu Pattu","Punnakkulam","108B",591,271,320
"5133110","Batticaloa","Porativu Pattu","Kovilporativu West","109B",1094,476,618
"5133115","Batticaloa","Porativu Pattu","Kovilporativu","109",958,423,535
"5133120","Batticaloa","Porativu Pattu","Munaitivu","108A",1365,556,809
"5133125","Batticaloa","Porativu Pattu","Paddaapuram","108C",798,355,443
"5133130","Batticaloa","Porativu Pattu","Periyaporativu","108",763,288,475
"5133135","Batticaloa","Porativu Pattu","Kovilporativu South","109A",1068,493,575
"5133140","Batticaloa","Porativu Pattu","Mandur 1 and  2 South","97B",940,440,500
"5133145","Batticaloa","Porativu Pattu","Mandur Koddaimunai","96A",906,437,469
"5133150","Batticaloa","Porativu Pattu","Mandur 3","96",861,367,494
"5133155","Batticaloa","Porativu Pattu","Mandur 1 and  2 North","97",642,281,361
"5133160","Batticaloa","Porativu Pattu","Paalamunai","97A",1796,820,976
"5133165","Batticaloa","Porativu Pattu","Thambalawatta","98",1279,573,706
"5133175","Batticaloa","Porativu Pattu","Sangarpuram","98B",1379,561,818
"5133180","Batticaloa","Porativu Pattu","Palachcholai","99I",795,374,421
"5133185","Batticaloa","Porativu Pattu","Kaakkachchivaddai","99A",1054,480,574
"5133190","Batticaloa","Porativu Pattu","Kannapuram East","99K",527,235,292
"5133195","Batticaloa","Porativu Pattu","Vilanthoddam","99D",517,219,298
"5133200","Batticaloa","Porativu Pattu","Sinnawattai","99C",950,439,511
"5133205","Batticaloa","Porativu Pattu","Maalaiyarkaddu","99H",391,180,211
"5133210","Batticaloa","Porativu Pattu","Anaikaddiyaveli","99E",634,301,333
"5133215","Batticaloa","Porativu Pattu","Raanamadu","98A",505,239,266
"5136005","Batticaloa","Manmunai South & Eruvil Pattu","Kurukkalmadam North","126C",1039,538,501
"5136010","Batticaloa","Manmunai South & Eruvil Pattu","Kurukkalmadam South","126",637,297,340
"5136015","Batticaloa","Manmunai South & Eruvil Pattu","Cheddipalayam North","126A 1",1923,948,975
"5136020","Batticaloa","Manmunai South & Eruvil Pattu","Cheddipalayam South","126A2",1921,879,1042
"5136025","Batticaloa","Manmunai South & Eruvil Pattu","Mankadu","123",1921,878,1043
"5136050","Batticaloa","Manmunai South & Eruvil Pattu","Kaluthawalai 1","119",1598,758,840
"5136055","Batticaloa","Manmunai South & Eruvil Pattu","Kaluthawalai Central","119B",1217,587,630
"5136060","Batticaloa","Manmunai South & Eruvil Pattu","Kaluthawalai 2","119A",1207,604,603
"5136065","Batticaloa","Manmunai South & Eruvil Pattu","Kaluthawalai 3","117",1167,596,571
"5136070","Batticaloa","Manmunai South & Eruvil Pattu","Kaluthawalai 4","117A",1680,768,912
"5136075","Batticaloa","Manmunai South & Eruvil Pattu","Kaluthawalai 4 Santhipuram","117B",1485,726,759
"5136080","Batticaloa","Manmunai South & Eruvil Pattu","Kaluwanchikudy North 1","116B",1668,782,886
"5136085","Batticaloa","Manmunai South & Eruvil Pattu","Kaluwanchikudy North","116",1183,563,620
"5136090","Batticaloa","Manmunai South & Eruvil Pattu","Paddiruppu","116C",914,455,459
"5136095","Batticaloa","Manmunai South & Eruvil Pattu","Eruvil North","115",1602,769,833
"5136100","Batticaloa","Manmunai South & Eruvil Pattu","Kaluwanchikudy South","116A",3268,1543,1725
"5136105","Batticaloa","Manmunai South & Eruvil Pattu","Onthachimadam North","111",1974,955,1019
"5136110","Batticaloa","Manmunai South & Eruvil Pattu","Eruvil East","115B",2351,1190,1161
"5136115","Batticaloa","Manmunai South & Eruvil Pattu","Eruvil  South","115A",1984,1002,982
"5136120","Batticaloa","Manmunai South & Eruvil Pattu","Kurumanvely 11 West","114B",1225,591,634
"5136125","Batticaloa","Manmunai South & Eruvil Pattu","Kurumanvely 11 East","114",915,462,453
"5136130","Batticaloa","Manmunai South & Eruvil Pattu","Kurumanvely 12","114A",1248,607,641
"5136135","Batticaloa","Manmunai South & Eruvil Pattu","Mahiloor West","110",1534,766,768
"5136140","Batticaloa","Manmunai South & Eruvil Pattu","Mahiloor South West","110C",1317,648,669
"5136145","Batticaloa","Manmunai South & Eruvil Pattu","Mahiloor East","110A",1934,923,1011
"5136150","Batticaloa","Manmunai South & Eruvil Pattu","Onthachimadam South","111A",1006,478,528
"5136155","Batticaloa","Manmunai South & Eruvil Pattu","Koddaikallar North","113",1711,823,888
"5136160","Batticaloa","Manmunai South & Eruvil Pattu","Koddaikallar West","113C",1115,558,557
"5136165","Batticaloa","Manmunai South & Eruvil Pattu","Mahiloor Munai","110B",940,462,478
"5136170","Batticaloa","Manmunai South & Eruvil Pattu","Koddaikallar East","113B",1061,512,549
"5136175","Batticaloa","Manmunai South & Eruvil Pattu","Koddaikallar South","113A",979,474,505
"5136180","Batticaloa","Manmunai South & Eruvil Pattu","Periyakallar 1","76",1125,512,613
"5136185","Batticaloa","Manmunai South & Eruvil Pattu","Periyakallar 1 South","76A",1110,530,580
"5136190","Batticaloa","Manmunai South & Eruvil Pattu","Periyakallar 2 West","75B",1255,604,651
"5136195","Batticaloa","Manmunai South & Eruvil Pattu","Periyakallar 2","75",1087,525,562
"5136200","Batticaloa","Manmunai South & Eruvil Pattu","Periyakallar 3 South","75C",1088,510,578
"5136205","Batticaloa","Manmunai South & Eruvil Pattu","Periyakallar 3","75A",806,397,409
"5136210","Batticaloa","Manmunai South & Eruvil Pattu","Thuraineelavanai North","74",1393,654,739
"5136215","Batticaloa","Manmunai South & Eruvil Pattu","Thuraineelavanai North 1","74B",864,426,438
"5136220","Batticaloa","Manmunai South & Eruvil Pattu","Thuraineelavanai  South","74A",969,487,482
"5136225","Batticaloa","Manmunai South & Eruvil Pattu","Thuraineelavanai South 1","74C",1576,775,801
"5203005","Ampara","Dehiattakandiya","Rideela","142L",4008,1979,2029
"5203010","Ampara","Dehiattakandiya","Bakmeedeniya","142K",4369,2155,2214
"5203015","Ampara","Dehiattakandiya","Dehiattakandiya","142J",7847,3927,3920
"5203020","Ampara","Dehiattakandiya","Kadirapura","142N",10860,5436,5424
"5203025","Ampara","Dehiattakandiya","Mawanagama","142I",4019,2021,1998
"5203030","Ampara","Dehiattakandiya","Lihiniyagama","142H",3740,1878,1862
"5203035","Ampara","Dehiattakandiya","Serupitiya","142G",4376,2204,2172
"5203040","Ampara","Dehiattakandiya","Sadamadulla","142F",3426,1736,1690
"5203045","Ampara","Dehiattakandiya","Sandunpura","142E",4549,2210,2339
"5203050","Ampara","Dehiattakandiya","Paranagama","142C",4440,2187,2253
"5203055","Ampara","Dehiattakandiya","Ihalagama","142D",2847,1372,1475
"5203060","Ampara","Dehiattakandiya","Nawa Medagama","142B",3121,1524,1597
"5203065","Ampara","Dehiattakandiya","Wewmedagama","142A",2576,1268,1308
"5206005","Ampara","Padiyathalawa","Galode","141A",1018,499,519
"5206010","Ampara","Padiyathalawa","Palathuruwella","137C",720,326,394
"5206015","Ampara","Padiyathalawa","Pulungasmulla","137D",935,451,484
"5206020","Ampara","Padiyathalawa","Serankada","137A",1066,524,542
"5206025","Ampara","Padiyathalawa","Unapana","141B",499,248,251
"5206030","Ampara","Padiyathalawa","Hagamwela","141C",861,428,433
"5206035","Ampara","Padiyathalawa","Kirawana","140C",1353,676,677
"5206040","Ampara","Padiyathalawa","Padiyathalawa","140A",1605,923,682
"5206045","Ampara","Padiyathalawa","Thalapitaoya  Left","140D",802,385,417
"5206050","Ampara","Padiyathalawa","Saranagama","141D",936,464,472
"5206055","Ampara","Padiyathalawa","Pallegama","141",800,363,437
"5206060","Ampara","Padiyathalawa","Moradeniya","137B",1038,506,532
"5206065","Ampara","Padiyathalawa","Thalapitaoya South","140B",641,311,330
"5206070","Ampara","Padiyathalawa","Holike","138",885,456,429
"5206075","Ampara","Padiyathalawa","Kehelulla","140",1136,564,572
"5206080","Ampara","Padiyathalawa","Miriswatta","138A",827,413,414
"5206085","Ampara","Padiyathalawa","Kolamanthalawa","138B",721,384,337
"5206090","Ampara","Padiyathalawa","Dorakumbura","139",734,371,363
"5206095","Ampara","Padiyathalawa","Marangala","139A",853,430,423
"5206100","Ampara","Padiyathalawa","Komana","139B",860,418,442
"5209005","Ampara","Mahaoya","Bogmuyaya","144B/1",247,128,119
"5209010","Ampara","Mahaoya","Tempitiya","145",780,379,401
"5209015","Ampara","Mahaoya","Poolawala","145A",608,288,320
"5209020","Ampara","Mahaoya","Bedirekka","144C",655,316,339
"5209025","Ampara","Mahaoya","Unuwathura Bubula","144B",1686,839,847
"5209030","Ampara","Mahaoya","Iddapola","144A/1",913,444,469
"5209035","Ampara","Mahaoya","Thepelpola","144D",1317,640,677
"5209040","Ampara","Mahaoya","Mahaoya","144",1219,718,501
"5209045","Ampara","Mahaoya","Samagipura","136A/2",1815,910,905
"5209050","Ampara","Mahaoya","Borapola","136A/1",939,481,458
"5209055","Ampara","Mahaoya","Kelavinna","136",1506,780,726
"5209060","Ampara","Mahaoya","Dambadeniya","137A/1",1641,821,820
"5209065","Ampara","Mahaoya","Kekirihena","144A",1611,764,847
"5209070","Ampara","Mahaoya","Kudaharasgala","137A/2",1424,734,690
"5209075","Ampara","Mahaoya","Lahugala","137",1193,600,593
"5209080","Ampara","Mahaoya","Pollebedda","136B",1966,1055,911
"5209085","Ampara","Mahaoya","Aranthalawa","136A",1308,644,664
"5212005","Ampara","Uhana","Piyangala","W/104/5",502,250,252
"5212010","Ampara","Uhana","Nugelanda North","W/104/1",715,340,375
"5212015","Ampara","Uhana","Nugelanda South","W/104/2",778,390,388
"5212020","Ampara","Uhana","Bakkiella","W/104",411,190,221
"5212025","Ampara","Uhana","Rajagalathenna South","W/104/4",1155,575,580
"5212030","Ampara","Uhana","Rajagalathenna North","W/104/3",2020,1049,971
"5212035","Ampara","Uhana","Gonagolla","W/104B/1",1495,722,773
"5212040","Ampara","Uhana","Galapitagala West","W/104C/1",783,386,397
"5212045","Ampara","Uhana","Galapitagala East","W/104C",650,327,323
"5212050","Ampara","Uhana","Kothmale","W/104A/1",620,302,318
"5212055","Ampara","Uhana","Mayadunna","W/104A",2337,1139,1198
"5212060","Ampara","Uhana","Nawagiriyawa","W/104B",1408,702,706
"5212065","Ampara","Uhana","Bandaradoowa","W/104B/2",1328,649,679
"5212070","Ampara","Uhana","Lathugala","W/100/1",603,296,307
"5212075","Ampara","Uhana","Bokkabedda","W/100",654,331,323
"5212080","Ampara","Uhana","Kohombana","W/102",520,260,260
"5212085","Ampara","Uhana","Walagampura","W/102/1",2082,1020,1062
"5212090","Ampara","Uhana","Verenketagoda","W/102A",2496,1210,1286
"5212095","Ampara","Uhana","Senagama North","W/102A/1",1198,582,616
"5212100","Ampara","Uhana","Senagama South","W/102A/2",703,355,348
"5212105","Ampara","Uhana","Gonagala","W/104C/2",1220,620,600
"5212110","Ampara","Uhana","Veheragama East","W/94A/2",438,208,230
"5212115","Ampara","Uhana","Veheragama West","W/94A/3",456,226,230
"5212120","Ampara","Uhana","Gemunupura","W/94A/4",1146,565,581
"5212125","Ampara","Uhana","Siyambalawewa","W/94A/5",661,333,328
"5212130","Ampara","Uhana","Rajagama North","W/94A",552,292,260
"5212135","Ampara","Uhana","Rajagama South","W/94A/1",612,280,332
"5212140","Ampara","Uhana","Suhadagama North","W/93A/2",217,108,109
"5212145","Ampara","Uhana","Suhadagama South","W/93A/3",212,108,104
"5212150","Ampara","Uhana","Kumarigama","W/88B/3",1137,566,571
"5212155","Ampara","Uhana","Komariya","W/88B/2",1053,512,541
"5212160","Ampara","Uhana","Udagirigama West","W/88B/1",675,344,331
"5212165","Ampara","Uhana","Udagirigama East","W/88B",1088,531,557
"5212170","Ampara","Uhana","Galahitiyagoda","W/88A",2125,1052,1073
"5212175","Ampara","Uhana","Mahakandiya","W/100A/1",1718,869,849
"5212180","Ampara","Uhana","Kahatagasyaya","W/100A",602,332,270
"5212185","Ampara","Uhana","Velikahagolla","W/88A/1",1435,714,721
"5212190","Ampara","Uhana","Dematamalpelessa","W/88A/2",1439,703,736
"5212195","Ampara","Uhana","Uhana","W/88",2742,1451,1291
"5212200","Ampara","Uhana","Uhana Thissapura West","W/88/1",1578,745,833
"5212205","Ampara","Uhana","Uhana Thissapura East","W/88/2",872,440,432
"5212210","Ampara","Uhana","Udayapura","W/93A/1",1086,530,556
"5212215","Ampara","Uhana","Sandanadapura","W/93A",1108,541,567
"5212220","Ampara","Uhana","Weeragoda North","W/93C/4",772,382,390
"5212225","Ampara","Uhana","Weeragoda South","W/93C/3",895,444,451
"5212230","Ampara","Uhana","Dadayanthalawa West","W/93B/1",1304,642,662
"5212235","Ampara","Uhana","Dadayanthalawa East","W/93B",637,311,326
"5212240","Ampara","Uhana","Wijayapura East","W/93B/2",582,265,317
"5212245","Ampara","Uhana","Wijayapura West","W/93B/3",653,326,327
"5212250","Ampara","Uhana","Kumudugama","W/93C/2",710,348,362
"5212255","Ampara","Uhana","Ruhunugama","W/93C/1",795,374,421
"5212260","Ampara","Uhana","Buddhangala","W/93C",725,355,370
"5212265","Ampara","Uhana","Palam Kandavura","W/88/3",1752,838,914
"5212270","Ampara","Uhana","Himidurawa","W/88C",2142,1027,1115
"5212275","Ampara","Uhana","Abhayapura","W/88C/01",728,368,360
"5215005","Ampara","Ampara","Dambethalawa","W/86C",3013,1482,1531
"5215010","Ampara","Ampara","Samapura","W/89B",1651,815,836
"5215015","Ampara","Ampara","Karangawa","W/89J",2933,1487,1446
"5215020","Ampara","Ampara","Gemunupura","W/89G",1428,658,770
"5215025","Ampara","Ampara","Thissapura","W/89C",2141,1067,1074
"5215030","Ampara","Ampara","Nawagampura","W/89I",3756,1826,1930
"5215035","Ampara","Ampara","Senanayakepura","W/89D",3327,1597,1730
"5215040","Ampara","Ampara","Jayawardhanapura","W/89A",3153,1601,1552
"5215045","Ampara","Ampara","Indrasarapura","W/89E",1379,700,679
"5215050","Ampara","Ampara","Mihindupura","W/89H",2133,1038,1095
"5215055","Ampara","Ampara","Saddhathissapura","W/89F",2232,938,1294
"5215060","Ampara","Ampara","Kotavehera","W/89K",1268,638,630
"5215065","Ampara","Ampara","Paragahakele East","W/86J",1419,706,713
"5215070","Ampara","Ampara","Paragahakele West","W/86",1489,721,768
"5215075","Ampara","Ampara","Ambagahawella","W/86B",1599,792,807
"5215080","Ampara","Ampara","Ambamalthalawa","W/86H",1559,754,805
"5215085","Ampara","Ampara","Namalthalawa","W/86I",1500,718,782
"5215090","Ampara","Ampara","Namal Oya (ii)","W/86 G",1416,764,652
"5215095","Ampara","Ampara","Polwaga Janapadaya","W/86F",1994,960,1034
"5215100","Ampara","Ampara","Wavinna North","W/86D",1218,596,622
"5215105","Ampara","Ampara","Wavinna South","W/86E",1838,887,951
"5215110","Ampara","Ampara","Namal Oya (i)","W/86A",1383,677,706
"5216005","Ampara","Navithanveli","Central Camp 01","SP/93/A",917,433,484
"5216010","Ampara","Navithanveli","Central Camp 02","SP/93/B",744,351,393
"5216015","Ampara","Navithanveli","Central Camp 03","SP/93C",1012,516,496
"5216020","Ampara","Navithanveli","Central Camp 05","SP/93E",862,415,447
"5216025","Ampara","Navithanveli","Central Camp 06","SP/93/F",1106,506,600
"5216030","Ampara","Navithanveli","Central Camp 04","SP/93D",674,311,363
"5216035","Ampara","Navithanveli","Chalambaikerny 03","SP/94D",1067,509,558
"5216040","Ampara","Navithanveli","Chalambaikerny 04","SP/94E",1561,695,866
"5216045","Ampara","Navithanveli","Chalambaikerny 05","SP/94F",557,267,290
"5216050","Ampara","Navithanveli","Chalambaikerny 01","SP/94A",1513,681,832
"5216055","Ampara","Navithanveli","Chalambaikerny 02","SP/94B",526,232,294
"5216060","Ampara","Navithanveli","Sorikalmunai 3","SP/90B",832,364,468
"5216065","Ampara","Navithanveli","Sorikalmunai 1","SP/90",1133,527,606
"5216070","Ampara","Navithanveli","Sorikalmunai 2","SP/90A",479,216,263
"5216075","Ampara","Navithanveli","Chavalakade","SP/93",673,343,330
"5216080","Ampara","Navithanveli","Navithanveli 02","SP/94/2",970,420,550
"5216085","Ampara","Navithanveli","Annamalai 03","SP/95/C",511,236,275
"5216090","Ampara","Navithanveli","Annamalai 02","SP/95/B",1481,674,807
"5216095","Ampara","Navithanveli","Navithanveli 01","SP/94/1",1154,545,609
"5216100","Ampara","Navithanveli","Annamalai 01","SP/95A",955,442,513
"5218005","Ampara","Samanthurai","Veeramunai 04","92F",518,270,248
"5218010","Ampara","Samanthurai","Sammanthurai 08","81",1191,650,541
"5218015","Ampara","Samanthurai","Sammanthurai 06","80",484,248,236
"5218020","Ampara","Samanthurai","Sammanthurai Tamil Division 01","77",757,368,389
"5218025","Ampara","Samanthurai","Sammanthurai Tamil Division 04","77E",324,163,161
"5218030","Ampara","Samanthurai","Sammanthurai Tamil Division 02","77C",724,335,389
"5218035","Ampara","Samanthurai","Sammanthurai 01","78C",900,437,463
"5218040","Ampara","Samanthurai","Sammanthurai 02","78",1564,768,796
"5218045","Ampara","Samanthurai","Sammanthurai 05","78B",814,388,426
"5218050","Ampara","Samanthurai","Karuwaddukal 01","92A",1333,623,710
"5218055","Ampara","Samanthurai","Karuwaddukal 03","92H",1672,811,861
"5218060","Ampara","Samanthurai","Karuwaddukal 02","92G",1259,614,645
"5218065","Ampara","Samanthurai","Sammanthurai 11","92C",493,214,279
"5218070","Ampara","Samanthurai","Sammanthurai 10","92B",789,383,406
"5218075","Ampara","Samanthurai","Sammanthurai 09","81A",1477,709,768
"5218080","Ampara","Samanthurai","Sammanthurai 07","80A",957,437,520
"5218085","Ampara","Samanthurai","Sammanthurai 04","78A",846,431,415
"5218090","Ampara","Samanthurai","Sammanthurai Tamil Division 03","77D",1219,567,652
"5218095","Ampara","Samanthurai","Maddakalaputharavai 02","77B",1401,746,655
"5218100","Ampara","Samanthurai","Maddakalaputharavai 01","77A",1090,515,575
"5218105","Ampara","Samanthurai","Sammanthurai 03","78D",1269,632,637
"5218110","Ampara","Samanthurai","Veeramunai 03","92I",521,244,277
"5218115","Ampara","Samanthurai","Veeramunai 02","92E",567,288,279
"5218120","Ampara","Samanthurai","Veeramunai 01","92",506,232,274
"5218125","Ampara","Samanthurai","Sammanthurai 12","92D",694,326,368
"5218130","Ampara","Samanthurai","Malwatte 02","89D",1010,470,540
"5218135","Ampara","Samanthurai","Block 'J' East 01","79",1569,736,833
"5218140","Ampara","Samanthurai","Block 'J' West 02","79R",1301,594,707
"5218145","Ampara","Samanthurai","Kallarichchel 02","79M",2399,1117,1282
"5218150","Ampara","Samanthurai","Block 'J' West 01","79A",1120,524,596
"5218155","Ampara","Samanthurai","Kallarichchel 03","79N",1196,548,648
"5218160","Ampara","Samanthurai","Udanga 01","79B",1954,948,1006
"5218165","Ampara","Samanthurai","Udanga 02","79G",1402,674,728
"5218170","Ampara","Samanthurai","Vilinayadi 01","79C",2023,952,1071
"5218175","Ampara","Samanthurai","Sennelgramam 01","79E",1955,828,1127
"5218180","Ampara","Samanthurai","Sennelgramam 02","79H",2408,1114,1294
"5218185","Ampara","Samanthurai","Block 'J' East 03","79L",1312,583,729
"5218190","Ampara","Samanthurai","Block 'J' East 02","79K",1368,648,720
"5218195","Ampara","Samanthurai","Malayadikiramam 01","79F",1870,904,966
"5218200","Ampara","Samanthurai","Malayadikiramam 03","79P",1686,791,895
"5218205","Ampara","Samanthurai","Malwatte 03","89E",986,427,559
"5218210","Ampara","Samanthurai","Malwatte 01","89",966,453,513
"5218215","Ampara","Samanthurai","Malkampiddy","82",427,196,231
"5218220","Ampara","Samanthurai","Malayadikiramam 04","79Q",1102,518,584
"5218225","Ampara","Samanthurai","Malayadikiramam 02","79O",2476,1165,1311
"5218230","Ampara","Samanthurai","Vilinayadi 02","79I",1046,485,561
"5218235","Ampara","Samanthurai","Vilinayadi 03","79J",1180,559,621
"5218240","Ampara","Samanthurai","Kallarichchel 01","79D",785,355,430
"5218245","Ampara","Samanthurai","Valathapitty 02","89C",241,118,123
"5218250","Ampara","Samanthurai","Valathapitty 01","89B",2859,1371,1488
"5218255","Ampara","Samanthurai","Malwatte 04","89A",455,193,262
"5221005","Ampara","Kalmunai Tamil Division (Sub Division)","Periyaneelavanai 01B","KP/71/3",1874,865,1009
"5221010","Ampara","Kalmunai Tamil Division (Sub Division)","Periyaneelavanai 01A","KP/71/2",791,377,414
"5221015","Ampara","Kalmunai Tamil Division (Sub Division)","Periyaneelavanai 01","KP/71/1",1260,572,688
"5221020","Ampara","Kalmunai Tamil Division (Sub Division)","Periyaneelavanai 02","KP/71/4",2923,1365,1558
"5221025","Ampara","Kalmunai Tamil Division (Sub Division)","Chenaikudiyiruppu 01A","KP/69/2",1499,678,821
"5221030","Ampara","Kalmunai Tamil Division (Sub Division)","Pandiruppu  01","KP/66/1",941,438,503
"5221035","Ampara","Kalmunai Tamil Division (Sub Division)","Pandiruppu  01B","KP/66/3",857,385,472
"5221040","Ampara","Kalmunai Tamil Division (Sub Division)","Pandiruppu  01C","KP/66/4",766,340,426
"5221045","Ampara","Kalmunai Tamil Division (Sub Division)","Pandiruppu  01A","KP/66/2",672,317,355
"5221050","Ampara","Kalmunai Tamil Division (Sub Division)","Pandiruppu  02","KP/66A/1",1745,799,946
"5221055","Ampara","Kalmunai Tamil Division (Sub Division)","Pandiruppu 02B","KP/66A/3",667,281,386
"5221060","Ampara","Kalmunai Tamil Division (Sub Division)","Pandiruppu  02C","KP/66A/4",1051,484,567
"5221065","Ampara","Kalmunai Tamil Division (Sub Division)","Pandiruppu  02A","KP/66A/2",770,383,387
"5221070","Ampara","Kalmunai Tamil Division (Sub Division)","Kalmunai  01D","KP/61/5",892,447,445
"5221075","Ampara","Kalmunai Tamil Division (Sub Division)","Kalmunai  01B","KP/61/3",564,278,286
"5221080","Ampara","Kalmunai Tamil Division (Sub Division)","Kalmunai  01A","KP/61/2",805,368,437
"5221085","Ampara","Kalmunai Tamil Division (Sub Division)","Kalmunai  01","KP/61/1",1021,450,571
"5221090","Ampara","Kalmunai Tamil Division (Sub Division)","Natpiddimunai (T.P.) 03","KP/62/3",1083,496,587
"5221095","Ampara","Kalmunai Tamil Division (Sub Division)","Natpiddimunai (T.P.) 02","KP/62/2",1323,629,694
"5221100","Ampara","Kalmunai Tamil Division (Sub Division)","Natpiddimunai (T.P.) 01","KP/62/1",951,459,492
"5221105","Ampara","Kalmunai Tamil Division (Sub Division)","Chenaikudiyiruppu 01B","KP/69/3",985,434,551
"5221110","Ampara","Kalmunai Tamil Division (Sub Division)","Chenaikudiyiruppu  01","KP/69/1",904,392,512
"5221115","Ampara","Kalmunai Tamil Division (Sub Division)","Kalmunai  01C","KP/61/4",672,341,331
"5221120","Ampara","Kalmunai Tamil Division (Sub Division)","Kalmunai  01E","KP/61/6",932,428,504
"5221125","Ampara","Kalmunai Tamil Division (Sub Division)","Kalmunai  02B","KP/61/9",585,292,293
"5221130","Ampara","Kalmunai Tamil Division (Sub Division)","Kalmunai  02A","KP/61/8",832,403,429
"5221135","Ampara","Kalmunai Tamil Division (Sub Division)","Kalmunai  02","KP/61/7",1311,632,679
"5221140","Ampara","Kalmunai Tamil Division (Sub Division)","Kalmunai  03","KP/59/1",579,254,325
"5221145","Ampara","Kalmunai Tamil Division (Sub Division)","Kalmunai  03A","KP/59/2",545,257,288
"5224005","Ampara","Kalmunai","Periyaneelavanai Muslim Section 01","KP/72",2014,957,1057
"5224010","Ampara","Kalmunai","Periyaneelavanai Muslim Section 02","KP/72A",930,460,470
"5224015","Ampara","Kalmunai","Maruthamunai 01","KP/67B",801,377,424
"5224020","Ampara","Kalmunai","Maruthamunai  02","KP/67",1054,508,546
"5224025","Ampara","Kalmunai","Maruthamunai  03","KP/67A",3988,1930,2058
"5224030","Ampara","Kalmunai","Maruthamunai  04","KP/67C",1540,769,771
"5224035","Ampara","Kalmunai","Maruthamunai 05","KP/67D",1203,575,628
"5224040","Ampara","Kalmunai","Maruthamunai 06","KP/68",3577,1699,1878
"5224045","Ampara","Kalmunai","Natpiddimunai (M.P) 03","KP/64",995,463,532
"5224050","Ampara","Kalmunai","Natpiddimunai (M.P) 02","KP/64B",823,406,417
"5224055","Ampara","Kalmunai","Natpiddimunai (M.P) 01","KP/64A",978,488,490
"5224060","Ampara","Kalmunai","Natpiddimunai (M.P) 05","KP/64D",926,425,501
"5224065","Ampara","Kalmunai","Natpiddimunai (M.P) 04","KP/64C",1117,540,577
"5224070","Ampara","Kalmunai","Islamabad & Kalmunai Town","KP/59A",1335,773,562
"5224075","Ampara","Kalmunai","Kalmunai Muslim Section","KP/59",2929,1385,1544
"5224080","Ampara","Kalmunai","Kalmunaikudi 01","KP/58",1438,668,770
"5224085","Ampara","Kalmunai","Kalmunaikudi 03","KP/58A",2467,1199,1268
"5224090","Ampara","Kalmunai","Kalmunaikudi 02","KP/58C",1349,661,688
"5224095","Ampara","Kalmunai","Kalmunaikudi 04","KP/58B",819,444,375
"5224100","Ampara","Kalmunai","Kalmunaikudi 05","KP/56",1624,808,816
"5224105","Ampara","Kalmunai","Kalmunaikudi 06","KP/56F",1140,561,579
"5224110","Ampara","Kalmunai","Kalmunaikudi 08","KP/56D",1115,544,571
"5224115","Ampara","Kalmunai","Kalmunaikudi 09","KP/56B",2498,1168,1330
"5224120","Ampara","Kalmunai","Kalmunaikudi 07","KP/56E",1423,695,728
"5224125","Ampara","Kalmunai","Kalmunaikudi 10","KP/56C",1008,507,501
"5224130","Ampara","Kalmunai","Kalmunaikudi 11","KP/56A",1025,467,558
"5224135","Ampara","Kalmunai","Kalmunaikudi 12","KP/55",1031,499,532
"5224140","Ampara","Kalmunai","Kalmunaikudi 13","KP/54A",1620,777,843
"5224145","Ampara","Kalmunai","Kalmunaikudi 14","KP/54",1865,830,1035
"5225005","Ampara","Sainthamarathu","Sainthamaruthu  1","KP/53",1938,910,1028
"5225010","Ampara","Sainthamarathu","Sainthamaruthu  2","KP/53A",1843,922,921
"5225015","Ampara","Sainthamarathu","Sainthamaruthu  3","KP/52",1956,929,1027
"5225020","Ampara","Sainthamarathu","Sainthamaruthu  4","KP/52B",1325,626,699
"5225025","Ampara","Sainthamarathu","Sainthamaruthu  5","KP/52A",1096,512,584
"5225030","Ampara","Sainthamarathu","Sainthamaruthu  6","KP/52C",1066,507,559
"5225035","Ampara","Sainthamarathu","Sainthamaruthu  7","KP/50A",1645,787,858
"5225040","Ampara","Sainthamarathu","Sainthamaruthu  8","KP/50B",1149,542,607
"5225045","Ampara","Sainthamarathu","Sainthamaruthu  9","KP/50",1498,720,778
"5225050","Ampara","Sainthamarathu","Sainthamaruthu 10","KP/50C",1312,635,677
"5225055","Ampara","Sainthamarathu","Sainthamaruthu 11","KP/47A",1813,876,937
"5225060","Ampara","Sainthamarathu","Sainthamaruthu 13","KP/47D",1000,498,502
"5225065","Ampara","Sainthamarathu","Sainthamaruthu 12","KP/47B",1509,732,777
"5225070","Ampara","Sainthamarathu","Sainthamaruthu 17","KP/47",1609,773,836
"5225075","Ampara","Sainthamarathu","Sainthamaruthu 14","KP/47E",1217,568,649
"5225080","Ampara","Sainthamarathu","Sainthamaruthu 15","KP/47F",1961,952,1009
"5225085","Ampara","Sainthamarathu","Sainthamaruthu 16","KP/47C",1524,740,784
"5227005","Ampara","Karaitivu","Mavadipalli West","43A",1416,697,719
"5227010","Ampara","Karaitivu","Mavadipalli East","43",1326,582,744
"5227015","Ampara","Karaitivu","Maligaikadu West","44A",1474,698,776
"5227020","Ampara","Karaitivu","Maligaikadu Central","44B",1250,601,649
"5227025","Ampara","Karaitivu","Maligaikadu East","44C",1316,662,654
"5227030","Ampara","Karaitivu","Karaitheevu 03","45A",402,196,206
"5227035","Ampara","Karaitivu","Karaitheevu 02","45",557,265,292
"5227040","Ampara","Karaitivu","Karaitheevu 01","44",999,451,548
"5227045","Ampara","Karaitivu","Karaitheevu 06","44D",514,233,281
"5227050","Ampara","Karaitivu","Karaitheevu 05","45C",715,322,393
"5227055","Ampara","Karaitivu","Karaitheevu 04","45B",391,194,197
"5227060","Ampara","Karaitivu","Karaitheevu 08","42B",1219,593,626
"5227065","Ampara","Karaitivu","Karaitheevu 07","42",1095,522,573
"5227070","Ampara","Karaitivu","Karaitheevu 10","42A",869,412,457
"5227075","Ampara","Karaitivu","Karaitheevu 09","42C",258,131,127
"5227080","Ampara","Karaitivu","Karaitheevu 11","42D",1152,540,612
"5227085","Ampara","Karaitivu","Karaitheevu 12","42E",1886,920,966
"5230005","Ampara","Ninthavur","Ninthavur 24","39C",579,259,320
"5230010","Ampara","Ninthavur","Ninthavur 11","41A",1288,557,731
"5230015","Ampara","Ninthavur","Ninthavur 12","41B",968,439,529
"5230020","Ampara","Ninthavur","Ninthavur 01","41",1439,648,791
"5230025","Ampara","Ninthavur","Ninthavur 02","40",1180,536,644
"5230030","Ampara","Ninthavur","Ninthavur 13","40A",768,343,425
"5230035","Ampara","Ninthavur","Ninthavur 14","39A",729,342,387
"5230040","Ampara","Ninthavur","Ninthavur 15","39B",957,449,508
"5230045","Ampara","Ninthavur","Ninthavur 03","39",1643,789,854
"5230050","Ampara","Ninthavur","Ninthavur 04","38",1657,788,869
"5230055","Ampara","Ninthavur","Ninthavur 16","38B",794,374,420
"5230060","Ampara","Ninthavur","Ninthavur 17","38C",758,337,421
"5230065","Ampara","Ninthavur","Ninthavur 18","37D",659,306,353
"5230070","Ampara","Ninthavur","Ninthavur 05","37",2076,990,1086
"5230075","Ampara","Ninthavur","Ninthavur 06","38A",1202,568,634
"5230080","Ampara","Ninthavur","Ninthavur 19","38D",609,282,327
"5230085","Ampara","Ninthavur","Ninthavur 25","38E",498,252,246
"5230090","Ampara","Ninthavur","Ninthavur 20","37E",500,231,269
"5230095","Ampara","Ninthavur","Ninthavur 07","37A",1146,505,641
"5230100","Ampara","Ninthavur","Ninthavur 08","37B",1485,683,802
"5230105","Ampara","Ninthavur","Ninthavur 21","37F",608,277,331
"5230110","Ampara","Ninthavur","Ninthavur 22","37G",1222,567,655
"5230115","Ampara","Ninthavur","Ninthavur 09","37C",1897,893,1004
"5230120","Ampara","Ninthavur","Ninthavur 10","36",897,429,468
"5230125","Ampara","Ninthavur","Ninthavur 23","36A",802,361,441
"5233010","Ampara","Addalachchenai","Oluvil 01","AD/35",2263,1076,1187
"5233015","Ampara","Addalachchenai","Oluvil 04","AD/35E",1434,708,726
"5233020","Ampara","Addalachchenai","Oluvil 06","AD/35C/2",1151,559,592
"5233025","Ampara","Addalachchenai","Oluvil 05","AD/35C/1",771,382,389
"5233030","Ampara","Addalachchenai","Oluvil 03","AD/35C",431,198,233
"5233035","Ampara","Addalachchenai","Oluvil 02","AD/35B",1953,900,1053
"5233040","Ampara","Addalachchenai","Palamuna 06","AD/34B/1",420,182,238
"5233045","Ampara","Addalachchenai","Oluvil 07","AD/35C/3",1273,622,651
"5233050","Ampara","Addalachchenai","Palamuna 02","AD/34A",1342,661,681
"5233055","Ampara","Addalachchenai","Palamuna 01","AD/34",2013,929,1084
"5233060","Ampara","Addalachchenai","Palamuna 03","AD/34B",1141,525,616
"5233065","Ampara","Addalachchenai","Palamuna 04","AD/34A/1",1678,792,886
"5233070","Ampara","Addalachchenai","Palamuna 05","AD/34A/2",1524,717,807
"5233075","Ampara","Addalachchenai","Addalachchenai 02","AD/31",1139,534,605
"5233080","Ampara","Addalachchenai","Addalachchenai 09","AD/33A",1281,618,663
"5233085","Ampara","Addalachchenai","Addalachchenai 10","AD/33B",1459,675,784
"5233090","Ampara","Addalachchenai","Addalachchenai 08","AD/30C/2",2130,1019,1111
"5233095","Ampara","Addalachchenai","Addalachchenai 06","AD/30C",1949,931,1018
"5233100","Ampara","Addalachchenai","Addalachchenai 01","AD/33",1123,532,591
"5233105","Ampara","Addalachchenai","Addalachchenai 11","AD/31A",1012,489,523
"5233110","Ampara","Addalachchenai","Addalachchenai 03","AD/30A",927,441,486
"5233115","Ampara","Addalachchenai","Addalachchenai 07","AD/30C/1",1205,581,624
"5233120","Ampara","Addalachchenai","Addalachchenai 12","AD/30A/1",833,412,421
"5233125","Ampara","Addalachchenai","Addalachchenai 14","AD/30E",1568,673,895
"5233130","Ampara","Addalachchenai","Addalachchenai 13","AD/30D",1358,660,698
"5233135","Ampara","Addalachchenai","Addalachchenai 04","AD/30",1617,787,830
"5233140","Ampara","Addalachchenai","Addalachchenai 15","AD/30B/1",1731,845,886
"5233145","Ampara","Addalachchenai","Addalachchenai 16","AD/30B/2",1405,687,718
"5233150","Ampara","Addalachchenai","Addalachchenai 05","AD/30B",790,377,413
"5233155","Ampara","Addalachchenai","Addalachchenai 17","AD/30B/3",978,475,503
"5234005","Ampara","Irakkamam","Irakkamam 07","IR84C",979,485,494
"5234010","Ampara","Irakkamam","Varipathanchenai 01","IR85",1289,620,669
"5234015","Ampara","Irakkamam","Irakkamam 02","IR84G",1213,608,605
"5234020","Ampara","Irakkamam","Irakkamam 08","IR84D",966,494,472
"5234025","Ampara","Irakkamam","Irakkamam 09","IR84H",534,253,281
"5234030","Ampara","Irakkamam","Irakkamam 06","IR84",776,384,392
"5234035","Ampara","Irakkamam","Irakkamam 01","IR84B",927,475,452
"5234040","Ampara","Irakkamam","Irakkamam 03","IR84A",1956,954,1002
"5234045","Ampara","Irakkamam","Varipathanchenai 03","IR85B",1450,721,729
"5234050","Ampara","Irakkamam","Irakkamam 05","IR84F",1416,700,716
"5234055","Ampara","Irakkamam","Irakkamam 04","IR84E",1281,646,635
"5234060","Ampara","Irakkamam","Varipathanchenai 02","IR85A",1596,792,804
"5236005","Ampara","Akkaraipattu","Alim Nagar","AP/20A/4",952,466,486
"5236010","Ampara","Akkaraipattu","Easankanichcheemai","AP/20A/3",543,258,285
"5236015","Ampara","Akkaraipattu","Pallikudiyiruppu 02","AP/20A/2",1700,819,881
"5236020","Ampara","Akkaraipattu","Paddyadippiddy","AP/20A",1830,881,949
"5236025","Ampara","Akkaraipattu","Akkaraipattu 06","AP/20",2933,1419,1514
"5236030","Ampara","Akkaraipattu","Akkaraipattu 05","AP/19",1501,776,725
"5236035","Ampara","Akkaraipattu","Akkaraipattu 04","AP/18",1219,620,599
"5236040","Ampara","Akkaraipattu","Akkaraipattu 16","AP/17A",796,388,408
"5236045","Ampara","Akkaraipattu","Akkaraipattu 15","AP/16A",848,431,417
"5236050","Ampara","Akkaraipattu","Akkaraipattu 14","AP/15/5",2347,1159,1188
"5236055","Ampara","Akkaraipattu","Akkaraipattu 13","AP/15/4",2645,1284,1361
"5236060","Ampara","Akkaraipattu","Akkaraipattu 12","AP/15/3",1411,700,711
"5236065","Ampara","Akkaraipattu","Akkaraipattu 11","AP/15/2",1282,603,679
"5236070","Ampara","Akkaraipattu","Akkaraipattu 01","AP/15",1142,539,603
"5236075","Ampara","Akkaraipattu","Town Division 03","AP/15A/2",1597,751,846
"5236080","Ampara","Akkaraipattu","Akkaraipattu 10","AP/15/1",1108,532,576
"5236085","Ampara","Akkaraipattu","Town Division 02","AP/15A/1",1205,586,619
"5236090","Ampara","Akkaraipattu","Akkaraipattu  02","AP/16",1206,593,613
"5236095","Ampara","Akkaraipattu","Akkaraipattu  03","AP/17",782,375,407
"5236100","Ampara","Akkaraipattu","Akkaraipattu  17","AP/18A",1026,505,521
"5236105","Ampara","Akkaraipattu","Akkaraipattu  18","AP/19A",1062,524,538
"5236110","Ampara","Akkaraipattu","Akkaraipattu  20","AP/20/1",1337,641,696
"5236115","Ampara","Akkaraipattu","Akkaraipattu  21","AP/20/2",1255,597,658
"5236120","Ampara","Akkaraipattu","Pallikudiyiruppu 01","AP/20A/1",1706,787,919
"5236125","Ampara","Akkaraipattu","Akkaraipattu  19","AP/18/19/20",1037,502,535
"5236130","Ampara","Akkaraipattu","Town Division 01","AP/15A",1098,538,560
"5236135","Ampara","Akkaraipattu","Town Division 05","AP/15A/4",2358,1164,1194
"5236140","Ampara","Akkaraipattu","Town Division 04","AP/15A/3",1240,599,641
"5239005","Ampara","Alayadiwembu","Akkaraipattu 8/1","AV/10",531,245,286
"5239010","Ampara","Alayadiwembu","Akkaraipattu 9","AP/22A",593,278,315
"5239015","Ampara","Alayadiwembu","Akkaraipattu 8/3","AV/12",661,316,345
"5239020","Ampara","Alayadiwembu","Akkaraipattu 8/2","AV/11",551,275,276
"5239025","Ampara","Alayadiwembu","Akkaraipattu 7/1","AV/05",487,219,268
"5239030","Ampara","Alayadiwembu","Akkaraipattu 7/2","AV/06",604,278,326
"5239035","Ampara","Alayadiwembu","Vachchikuda","AV/1",1272,583,689
"5239040","Ampara","Alayadiwembu","Kannahikiramam  01","AV/20",612,290,322
"5239045","Ampara","Alayadiwembu","Aligambai","AV/22",951,476,475
"5239050","Ampara","Alayadiwembu","Akkaraipattu 7/4","AV/08",1350,645,705
"5239055","Ampara","Alayadiwembu","Akkaraipattu 7/3","AV/07",547,255,292
"5239060","Ampara","Alayadiwembu","Akkaraipattu 7","AP/21",739,341,398
"5239065","Ampara","Alayadiwembu","Akkaraipattu 8","AP/22",1180,569,611
"5239070","Ampara","Alayadiwembu","Sinnamugathuwaram","AV/14",184,99,85
"5239075","Ampara","Alayadiwembu","Kolavil  03","AP/23",1532,721,811
"5239080","Ampara","Alayadiwembu","Navatkadu","AV/03",1745,852,893
"5239085","Ampara","Alayadiwembu","Kolavil  02","AV/17",1675,834,841
"5239090","Ampara","Alayadiwembu","Kolavil  01","AV/16",1531,727,804
"5239095","Ampara","Alayadiwembu","Panankadu","AP/13",1538,751,787
"5239100","Ampara","Alayadiwembu","Sinna Panankadu","AV/19",992,455,537
"5239105","Ampara","Alayadiwembu","Kannahikiramam  02","AV/21",721,328,393
"5239110","Ampara","Alayadiwembu","Alayadivembu","AP/21A",2462,1172,1290
"5242005","Ampara","Damana","Keenawatta","W/27E",844,399,445
"5242010","Ampara","Damana","Muwangala","W/27B",1997,970,1027
"5242015","Ampara","Damana","Galmaduwa","W/27H",1383,689,694
"5242020","Ampara","Damana","Uksiripura","W/27I",1959,941,1018
"5242025","Ampara","Damana","Helagampura","W/27G",518,251,267
"5242030","Ampara","Damana","Karalewa","W/27F",2502,1249,1253
"5242035","Ampara","Damana","Hingurana","W/27A",719,348,371
"5242040","Ampara","Damana","Diviyagala","W/27D",1376,666,710
"5242045","Ampara","Damana","Padagoda","W/28",1211,566,645
"5242050","Ampara","Damana","Pahalalanda","W/28A",1201,590,611
"5242055","Ampara","Damana","Hindakalugama","W/28D",686,332,354
"5242060","Ampara","Damana","Kalugolla","W/28E",774,386,388
"5242065","Ampara","Damana","Dewalahida","W/26E",1446,708,738
"5242070","Ampara","Damana","Koknahara","W/28B",1869,912,957
"5242075","Ampara","Damana","Moragahapallama","W/28C",1203,577,626
"5242080","Ampara","Damana","Damana","W/27",1099,591,508
"5242085","Ampara","Damana","Alahena","W/27C",980,493,487
"5242090","Ampara","Damana","Madawalalanda","W/24A",1114,552,562
"5242095","Ampara","Damana","Madana","W/24",1156,570,586
"5242100","Ampara","Damana","Ekgaloya","W/24B",899,445,454
"5242105","Ampara","Damana","Kethsirigama","W/26A",1116,533,583
"5242110","Ampara","Damana","Galkanda","W/26D",964,472,492
"5242115","Ampara","Damana","Pallanoya","W/26B",591,302,289
"5242120","Ampara","Damana","Kivulegama","W/26C",317,163,154
"5242125","Ampara","Damana","Thimbirigolla","W/24C",1309,643,666
"5242130","Ampara","Damana","Ambalanoya","W/24D",1277,637,640
"5242135","Ampara","Damana","Veheragala","W/25C",534,261,273
"5242140","Ampara","Damana","18A. Janapadaya","W/25E",1038,516,522
"5242145","Ampara","Damana","Thottama","W/25",1601,799,802
"5242150","Ampara","Damana","Kumana","W/25D",1004,500,504
"5242155","Ampara","Damana","Wadinagala","W/26",2020,1007,1013
"5242160","Ampara","Damana","Pannalgama","W/25A",1324,648,676
"5242165","Ampara","Damana","Bakmitiyawa","W/25B",661,333,328
"5245005","Ampara","Thirukkovil","Thambiluvil 2","TK/12A/1",324,161,163
"5245010","Ampara","Thirukkovil","Thambiluvil 1","TK/12A",667,336,331
"5245015","Ampara","Thirukkovil","Thambiluvil 1 West","TK/12",1469,716,753
"5245020","Ampara","Thirukkovil","Thambiluvil 1 East","TK/12C",1753,811,942
"5245025","Ampara","Thirukkovil","Thambiluvil 1 South","TK/12B",1130,523,607
"5245030","Ampara","Thirukkovil","Sangamam","TK/11C",621,313,308
"5245035","Ampara","Thirukkovil","Thambiluvil 2 West","TK/11B",1141,549,592
"5245040","Ampara","Thirukkovil","Thambiluvil 2 North","TK/11",1141,533,608
"5245045","Ampara","Thirukkovil","Thambiluvil 2 East","TK/11A",1276,645,631
"5245050","Ampara","Thirukkovil","Thirukkovil 3","TK/10/2",1479,715,764
"5245055","Ampara","Thirukkovil","Thirukkovil 1","TK/10",1347,635,712
"5245060","Ampara","Thirukkovil","Thirukkovil 2","TK/10/1",1390,668,722
"5245065","Ampara","Thirukkovil","Vinayagapuram 4","TK/10A/3",1746,824,922
"5245070","Ampara","Thirukkovil","Vinayagapuram 1","TK/10A",1169,569,600
"5245075","Ampara","Thirukkovil","Vinayagapuram 2","TK/10A/1",1481,710,771
"5245080","Ampara","Thirukkovil","Thirukkovil 4","TK/10E/1",3119,1483,1636
"5245085","Ampara","Thirukkovil","Kanchirankuda","TK/10D/1",371,193,178
"5245090","Ampara","Thirukkovil","Kanchikudicharu","TK/10B",101,55,46
"5245095","Ampara","Thirukkovil","Vinayagapuram 3","TK/10A/2",2053,972,1081
"5245100","Ampara","Thirukkovil","Sangamangramam","TK/10D",837,404,433
"5245105","Ampara","Thirukkovil","Thandiyadi","TK/10C",399,183,216
"5245110","Ampara","Thirukkovil","Thangavelayudapuram","TK/10E",263,125,138
"5248005","Ampara","Pothuvil","Sangaman Kandy","P/22",731,347,384
"5248010","Ampara","Pothuvil","Sinna Ullai","P/18",1251,623,628
"5248015","Ampara","Pothuvil","Sinna Puthukkudiyiruppu","P/06",2195,1059,1136
"5248020","Ampara","Pothuvil","Victor Estate 2","P/17",1551,757,794
"5248025","Ampara","Pothuvil","Vaddively","P/11",707,402,305
"5248030","Ampara","Pothuvil","Victor Estate 1","P/16",1357,649,708
"5248035","Ampara","Pothuvil","Rasak Moulana Nagar","P/27",2682,1313,1369
"5248040","Ampara","Pothuvil","Sarvodayapuram","P/05",2390,1150,1240
"5248045","Ampara","Pothuvil","Pothuvil 02 / Unit 3","P/08",842,405,437
"5248050","Ampara","Pothuvil","Kundumadu","P/09",1092,512,580
"5248055","Ampara","Pothuvil","Pothuvil 01 / Unit II","P/02",1052,510,542
"5248060","Ampara","Pothuvil","Pakkiyawatta 2","P/14",983,454,529
"5248065","Ampara","Pothuvil","Pasarichchenai","P/19",1505,730,775
"5248070","Ampara","Pothuvil","Pothuvil Town","P/12",492,273,219
"5248075","Ampara","Pothuvil","Pakkiyawatta 1","P/13",992,510,482
"5248080","Ampara","Pothuvil","Komarie 02","P/24",1135,538,597
"5248085","Ampara","Pothuvil","Komarie 01","P/23",1203,565,638
"5248090","Ampara","Pothuvil","Kalappukaddu","P/15",3175,1549,1626
"5248095","Ampara","Pothuvil","Jalaldeen Square","P/04",1377,710,667
"5248100","Ampara","Pothuvil","Hidayapuram 2","P/21",1228,547,681
"5248105","Ampara","Pothuvil","Hidayapuram 1","P/20",1554,739,815
"5248110","Ampara","Pothuvil","Kanagarkiramam","P/25",733,360,373
"5248115","Ampara","Pothuvil","Hijra Nagar","P/26",668,320,348
"5248120","Ampara","Pothuvil","Pothuvil 01 / Unit I","P/01",694,335,359
"5248125","Ampara","Pothuvil","Pothuvil 01 / Unit III","P/03",1150,535,615
"5248130","Ampara","Pothuvil","Inspector Etham","P/10",837,386,451
"5248135","Ampara","Pothuvil","Pothuvil 02 / Unit 2","P/07",1233,585,648
"5251005","Ampara","Lahugala","Kandahindagama","PP13",388,193,195
"5251010","Ampara","Lahugala","Hulannugee West","PP12",578,296,282
"5251015","Ampara","Lahugala","Hulannuge","PP/11",777,388,389
"5251020","Ampara","Lahugala","Perani Lahugala","PP10",582,271,311
"5251025","Ampara","Lahugala","Lahugala","PP09",777,393,384
"5251030","Ampara","Lahugala","Dewalagoda","PP08",682,334,348
"5251035","Ampara","Lahugala","Pansalgoda","PP07",422,212,210
"5251040","Ampara","Lahugala","Panama West","PP03",766,371,395
"5251045","Ampara","Lahugala","Shasthrawela","PP06",770,383,387
"5251050","Ampara","Lahugala","Panama Central","PP05",666,311,355
"5251055","Ampara","Lahugala","Panama North","PP/04",1297,613,684
"5251060","Ampara","Lahugala","Panama South","PP02",1209,601,608
"5303005","Trincomalee","Padavi Sri Pura","Seva Janapadaya","31 K",2207,1071,1136
"5303010","Trincomalee","Padavi Sri Pura","Gemunupura","31N",522,243,279
"5303015","Trincomalee","Padavi Sri Pura","Kavanthissapura","31H",638,320,318
"5303020","Trincomalee","Padavi Sri Pura","Lassanagama","31P",776,377,399
"5303025","Trincomalee","Padavi Sri Pura","Singhapura","31J",955,472,483
"5303030","Trincomalee","Padavi Sri Pura","Parana Medawachchiya","31 F",817,404,413
"5303035","Trincomalee","Padavi Sri Pura","Samanpura","31M",1322,688,634
"5303040","Trincomalee","Padavi Sri Pura","Sri Thissapura","31L",1202,598,604
"5303045","Trincomalee","Padavi Sri Pura","Sri Pura","31D",1656,799,857
"5303050","Trincomalee","Padavi Sri Pura","Jayanthiwewa","31I",1787,878,909
"5306005","Trincomalee","Kuchchaveli","Thennaimaravady","31 E",39,28,11
"5306010","Trincomalee","Kuchchaveli","Pulmoddai Division No. 3","31G",1725,876,849
"5306015","Trincomalee","Kuchchaveli","Pulmoddai Division No. 2","31H",2246,1216,1030
"5306020","Trincomalee","Kuchchaveli","Pulmoddai Division No. 1","31I",3978,2090,1888
"5306025","Trincomalee","Kuchchaveli","Pulmoddai Division No. 4","31J",3010,1635,1375
"5306030","Trincomalee","Kuchchaveli","Thiriyai","237",640,348,292
"5306035","Trincomalee","Kuchchaveli","Senthoor","237B",1393,704,689
"5306040","Trincomalee","Kuchchaveli","Kaddukulam","237C",459,232,227
"5306045","Trincomalee","Kuchchaveli","Kallampattai","237D",111,52,59
"5306050","Trincomalee","Kuchchaveli","Kuchchaveli","239",686,365,321
"5306055","Trincomalee","Kuchchaveli","Iranaikerni","239A",412,208,204
"5306060","Trincomalee","Kuchchaveli","Veerancholai","239B",178,68,110
"5306065","Trincomalee","Kuchchaveli","Jayanagar","239C",1686,847,839
"5306070","Trincomalee","Kuchchaveli","Cassimnagar","239D",1036,495,541
"5306075","Trincomalee","Kuchchaveli","Kumburupiddy South","240",660,314,346
"5306080","Trincomalee","Kuchchaveli","Kumburupiddy North","240A",486,230,256
"5306085","Trincomalee","Kuchchaveli","Kumburupiddy East","240B",2718,1375,1343
"5306090","Trincomalee","Kuchchaveli","Nilaveli","241",950,422,528
"5306095","Trincomalee","Kuchchaveli","Irakkandy","241A",2235,1128,1107
"5306100","Trincomalee","Kuchchaveli","Gopalapuram","241B",1743,831,912
"5306105","Trincomalee","Kuchchaveli","Veloor","241C",1480,743,737
"5306110","Trincomalee","Kuchchaveli","Iqbalnagar","241D",3031,1501,1530
"5306115","Trincomalee","Kuchchaveli","Periyakulam","241E",1011,495,516
"5306120","Trincomalee","Kuchchaveli","Valayoothu","241G",1305,695,610
"5309005","Trincomalee","Gomarankadawala","Gomarankadawala","231",1015,606,409
"5309010","Trincomalee","Gomarankadawala","Kalyanapura","231C",826,412,414
"5309015","Trincomalee","Gomarankadawala","Galkadawala","232",1034,491,543
"5309020","Trincomalee","Gomarankadawala","Pamburugaswewa","232A",402,210,192
"5309025","Trincomalee","Gomarankadawala","Kandamalawa","232B",1094,550,544
"5309030","Trincomalee","Gomarankadawala","Madawachchiya","233",493,229,264
"5309035","Trincomalee","Gomarankadawala","Kivulakadawala","233A",998,479,519
"5309040","Trincomalee","Gomarankadawala","Pulikandikulama","233B",540,288,252
"5309045","Trincomalee","Gomarankadawala","Mailawewa","233C",250,169,81
"5309050","Trincomalee","Gomarankadawala","Bakmeegama","233D",730,351,379
"5312005","Trincomalee","Morawewa","Peniketiyawa","230",1990,967,1023
"5312015","Trincomalee","Morawewa","Mahadivulwewa Stage II","230B",905,457,448
"5312020","Trincomalee","Morawewa","Nochchikulama","230C",863,443,420
"5312025","Trincomalee","Morawewa","Morawewa South","231A",704,365,339
"5312030","Trincomalee","Morawewa","Morawewa North","231B",558,313,245
"5312035","Trincomalee","Morawewa","Awvainagar","231G",157,83,74
"5312040","Trincomalee","Morawewa","Namalwatta","231D",490,276,214
"5312045","Trincomalee","Morawewa","Kithuluthuwa","231E",214,115,99
"5315005","Trincomalee","Trincomalee Town and Gravets","Wilgama","243E",268,138,130
"5315010","Trincomalee","Trincomalee Town and Gravets","Welveri","243Q",1,1,0
"5315015","Trincomalee","Trincomalee Town and Gravets","Kanniya","243B",280,133,147
"5315020","Trincomalee","Trincomalee Town and Gravets","Eluppaikulam","242B",1323,636,687
"5315025","Trincomalee","Trincomalee Town and Gravets","Sampalthivu","242",2332,1117,1215
"5315030","Trincomalee","Trincomalee Town and Gravets","Salli","242A",1995,977,1018
"5315035","Trincomalee","Trincomalee Town and Gravets","Uppuveli","243",1772,915,857
"5315040","Trincomalee","Trincomalee Town and Gravets","Puliyankulam","243L",6860,3218,3642
"5315045","Trincomalee","Trincomalee Town and Gravets","Varothayanagar","243N",1954,934,1020
"5315050","Trincomalee","Trincomalee Town and Gravets","Peeliyady","243J",359,173,186
"5315055","Trincomalee","Trincomalee Town and Gravets","Mankaiyoottu","243K",620,297,323
"5315060","Trincomalee","Trincomalee Town and Gravets","Andankulama","243A",2585,1295,1290
"5315065","Trincomalee","Trincomalee Town and Gravets","Singhapura","243H",1974,1003,971
"5315070","Trincomalee","Trincomalee Town and Gravets","Kovilady","243P",1685,816,869
"5315075","Trincomalee","Trincomalee Town and Gravets","Palaiyoottu","243D",2095,1011,1084
"5315080","Trincomalee","Trincomalee Town and Gravets","Abayapura","244N",3801,1883,1918
"5315085","Trincomalee","Trincomalee Town and Gravets","Anpuvalipuram","243C",4205,2011,2194
"5315090","Trincomalee","Trincomalee Town and Gravets","Mihindupura","243I",1125,546,579
"5315095","Trincomalee","Trincomalee Town and Gravets","Selvanayahapuram","243M",2220,1076,1144
"5315100","Trincomalee","Trincomalee Town and Gravets","Jinnanagar","244O",2855,1451,1404
"5315105","Trincomalee","Trincomalee Town and Gravets","Murugapuri","243G",3066,1476,1590
"5315110","Trincomalee","Trincomalee Town and Gravets","Thirukadaloor","243F",3358,1634,1724
"5315115","Trincomalee","Trincomalee Town and Gravets","Pattanatheru","244K",1266,655,611
"5315120","Trincomalee","Trincomalee Town and Gravets","Peruntheru","244L",1818,872,946
"5315125","Trincomalee","Trincomalee Town and Gravets","Sivapuri","244Q",3900,1853,2047
"5315130","Trincomalee","Trincomalee Town and Gravets","Linganagar","244R",3387,1539,1848
"5315135","Trincomalee","Trincomalee Town and Gravets","Mudcove","244M",2260,1067,1193
"5315140","Trincomalee","Trincomalee Town and Gravets","Poompuhar","243O",3307,1590,1717
"5315145","Trincomalee","Trincomalee Town and Gravets","Sumedhankarapura","229B",3179,1563,1616
"5315150","Trincomalee","Trincomalee Town and Gravets","Muththunagar","229F",531,287,244
"5315155","Trincomalee","Trincomalee Town and Gravets","Kappalthurai","229E",1224,606,618
"5315160","Trincomalee","Trincomalee Town and Gravets","Kavaddikuda","229D",2702,1377,1325
"5315165","Trincomalee","Trincomalee Town and Gravets","Nachchikuda","229C",1444,700,744
"5315170","Trincomalee","Trincomalee Town and Gravets","Wellaimanal","229",2988,1451,1537
"5315175","Trincomalee","Trincomalee Town and Gravets","Chaina Bay","229A",1718,918,800
"5315180","Trincomalee","Trincomalee Town and Gravets","Orr's Hill","244P",5169,2499,2670
"5315185","Trincomalee","Trincomalee Town and Gravets","Thillainagar","244H",2287,1101,1186
"5315190","Trincomalee","Trincomalee Town and Gravets","Arasadi","244J",2065,906,1159
"5315195","Trincomalee","Trincomalee Town and Gravets","Manayaveli","244F",4583,2173,2410
"5315200","Trincomalee","Trincomalee Town and Gravets","Sonagavadi","244I",2507,1162,1345
"5315205","Trincomalee","Trincomalee Town and Gravets","Arunagirinagar","244G",2009,909,1100
"5315210","Trincomalee","Trincomalee Town and Gravets","Villundy","244E",2410,1176,1234
"5318005","Trincomalee","Thambalagamuwa","Galmetiyawa North","228L",2107,1025,1082
"5318010","Trincomalee","Thambalagamuwa","Palampoddaru","228",790,356,434
"5318015","Trincomalee","Thambalagamuwa","Puthukudiyirippu","228J",1154,535,619
"5318020","Trincomalee","Thambalagamuwa","Porkuruni","228I",1250,613,637
"5318025","Trincomalee","Thambalagamuwa","Meeranagar","228H",3220,1577,1643
"5318030","Trincomalee","Thambalagamuwa","Siraj Nagar","228E",4744,2372,2372
"5318035","Trincomalee","Thambalagamuwa","Kovil Kudiyiruppu","228K",353,163,190
"5318045","Trincomalee","Thambalagamuwa","Mollipothana North","228G",3858,1906,1952
"5318050","Trincomalee","Thambalagamuwa","Galmetiyawa South","228C",2667,1300,1367
"5318055","Trincomalee","Thambalagamuwa","Mollipothana","228B",5544,2745,2799
"5318060","Trincomalee","Thambalagamuwa","Mollipothana East","228F",1393,704,689
"5321005","Trincomalee","Kanthale","Vendrasanpura Unit 16","227R",1852,917,935
"5321010","Trincomalee","Kanthale","Ganthalawa Unit 12","227S",1034,517,517
"5321015","Trincomalee","Kanthale","Ganthalawa Unit 11","227P",890,428,462
"5321020","Trincomalee","Kanthale","Wanela East","227D",1776,904,872
"5321025","Trincomalee","Kanthale","Wanela West","227V",1174,569,605
"5321030","Trincomalee","Kanthale","Pansalgodella","227W",1334,675,659
"5321035","Trincomalee","Kanthale","Sooriyapura","227F",1094,560,534
"5321040","Trincomalee","Kanthale","Jayanthipura","227J",2797,1420,1377
"5321045","Trincomalee","Kanthale","Rajaela Unit 04","227M",1601,776,825
"5321050","Trincomalee","Kanthale","Rajaela Unit 05","227N",1086,553,533
"5321055","Trincomalee","Kanthale","Vendrasanpura Unit 15","227Q",1585,782,803
"5321060","Trincomalee","Kanthale","Vendrasanpura  Unit 14","227A",2128,1024,1104
"5321065","Trincomalee","Kanthale","Bhathiyagama","227L",5614,2765,2849
"5321070","Trincomalee","Kanthale","Rajaela  Unit 03","227B",1066,495,571
"5321075","Trincomalee","Kanthale","Peraru Unit 02","227G",1506,706,800
"5321080","Trincomalee","Kanthale","Peraru East","227O",2302,1144,1158
"5321085","Trincomalee","Kanthale","Peraru West","227H",3175,1585,1590
"5321100","Trincomalee","Kanthale","Agbopura","227C",3242,1500,1742
"5321105","Trincomalee","Kanthale","Batukachchiya","227T",2150,1064,1086
"5321110","Trincomalee","Kanthale","Rajawewa","227U",2919,1451,1468
"5321115","Trincomalee","Kanthale","Seenipura","227E",544,285,259
"5324005","Trincomalee","Kinniya","Munaichenai","226I",3471,1644,1827
"5324010","Trincomalee","Kinniya","Maniarasankulam","226P",912,459,453
"5324015","Trincomalee","Kinniya","Mancholai","225C",2603,1320,1283
"5324020","Trincomalee","Kinniya","Malinthurai","226C",1539,771,768
"5324025","Trincomalee","Kinniya","Majeed Nagar","226O",616,326,290
"5324030","Trincomalee","Kinniya","Maharoof Gramam","226L",2842,1466,1376
"5324035","Trincomalee","Kinniya","Maharuf Nagar","225E",3152,1604,1548
"5324040","Trincomalee","Kinniya","Ayiliyady","226Q",2531,1315,1216
"5324045","Trincomalee","Kinniya","Annal Nagar","225F",3173,1611,1562
"5324050","Trincomalee","Kinniya","Alankerny","225J",1191,545,646
"5324055","Trincomalee","Kinniya","Ehuthar Nagar","226A",1388,719,669
"5324060","Trincomalee","Kinniya","Echchanthivu","225L",539,246,293
"5324065","Trincomalee","Kinniya","Kuddikarachchi","226E",2175,1117,1058
"5324070","Trincomalee","Kinniya","Kurinchakerny","226G",2357,1157,1200
"5324075","Trincomalee","Kinniya","Mancholaichenai","225D",4147,2115,2032
"5324080","Trincomalee","Kinniya","Nadoottu","226M",2396,1192,1204
"5324085","Trincomalee","Kinniya","Naduthivu","226H",2194,1158,1036
"5324090","Trincomalee","Kinniya","Periya Kinniya","226B",1320,618,702
"5324095","Trincomalee","Kinniya","Periyaththumunai","226",1597,809,788
"5324100","Trincomalee","Kinniya","Poovarasanthivu","225H",1375,681,694
"5324105","Trincomalee","Kinniya","Kinniya","226D",1459,716,743
"5324110","Trincomalee","Kinniya","Idiman","226F",1979,969,1010
"5324115","Trincomalee","Kinniya","Faizal Nagar","225G",5238,2629,2609
"5324120","Trincomalee","Kinniya","Kachchakodithivu","226J",2381,1201,1180
"5324125","Trincomalee","Kinniya","Kattaiaru","225B",1298,659,639
"5324130","Trincomalee","Kinniya","Kakamunai","226K",2962,1513,1449
"5324135","Trincomalee","Kinniya","Rahumaniya Nagar","225",1976,982,994
"5324140","Trincomalee","Kinniya","Samavechchativu","225I",1650,841,809
"5324145","Trincomalee","Kinniya","Sinna Kinniya","225A",1998,981,1017
"5324150","Trincomalee","Kinniya","Soorangal","226N",2036,1033,1003
"5324155","Trincomalee","Kinniya","Upparu","225K",118,71,47
"5327005","Trincomalee","Muttur","Sampoor West","220A",0,0,0
"5327010","Trincomalee","Muttur","Koonitivu","221",0,0,0
"5327015","Trincomalee","Muttur","Navarathnapuram","221A",319,153,166
"5327020","Trincomalee","Muttur","Sampoor East","220",2,2,0
"5327025","Trincomalee","Muttur","Kadarkaraichenai","222C",1481,738,743
"5327030","Trincomalee","Muttur","Kaddaiparichchan North","222B",1650,780,870
"5327035","Trincomalee","Muttur","Thaqwa Nagar","223C",2161,1103,1058
"5327040","Trincomalee","Muttur","Muttur East","223A",3369,1761,1608
"5327045","Trincomalee","Muttur","Naduthivu","223E",2473,1268,1205
"5327050","Trincomalee","Muttur","Thaha Nagar","224C",1156,547,609
"5327055","Trincomalee","Muttur","Muttur Central","223F",568,269,299
"5327060","Trincomalee","Muttur","Muttur West","224",975,471,504
"5327065","Trincomalee","Muttur","Ralkully","224D",994,484,510
"5327070","Trincomalee","Muttur","Shaffi Nagar","224F",1440,707,733
"5327075","Trincomalee","Muttur","Periyapalam","224A",2523,1244,1279
"5327080","Trincomalee","Muttur","Jayanagar","224G",2723,1386,1337
"5327085","Trincomalee","Muttur","Alimnagar","224B",1615,823,792
"5327090","Trincomalee","Muttur","Anaichenai","223B",1647,765,882
"5327095","Trincomalee","Muttur","Neithal Nagar","223D",2832,1370,1462
"5327100","Trincomalee","Muttur","Palanagar","223G",1776,889,887
"5327105","Trincomalee","Muttur","Kaddaiparichchan South","222",1680,821,859
"5327110","Trincomalee","Muttur","Pallikkudiyiruppu","219",1925,936,989
"5327115","Trincomalee","Muttur","Chenaiyoor","222A",1116,536,580
"5327120","Trincomalee","Muttur","Paddalipuram","219B",1450,694,756
"5327125","Trincomalee","Muttur","Nalloor","219A",889,444,445
"5327130","Trincomalee","Muttur","Iqbal Nagar","216B",861,421,440
"5327135","Trincomalee","Muttur","Allainagar East","216A",1996,979,1017
"5327140","Trincomalee","Muttur","Allainagar West","216E",1890,949,941
"5327145","Trincomalee","Muttur","Thoppur","216",1305,658,647
"5327150","Trincomalee","Muttur","Palathoppur","216C",1499,724,775
"5327155","Trincomalee","Muttur","Jinna Nagar","224E",1008,480,528
"5327160","Trincomalee","Muttur","Iruthayapuram","218E",1112,540,572
"5327165","Trincomalee","Muttur","Peruveli","218D",1273,608,665
"5327170","Trincomalee","Muttur","Mallikaithivu","218",546,241,305
"5327175","Trincomalee","Muttur","Paddithidal","218B",1253,592,661
"5327180","Trincomalee","Muttur","Palathadichenai","218F",704,340,364
"5327185","Trincomalee","Muttur","Jinna Nagar","216D",1275,612,663
"5327190","Trincomalee","Muttur","Assathnagar","218H",947,465,482
"5327195","Trincomalee","Muttur","Barathipuram","218G",1248,616,632
"5327200","Trincomalee","Muttur","Kiliveddi","218A",1356,610,746
"5327205","Trincomalee","Muttur","Mengamam","218I",713,316,397
"5327210","Trincomalee","Muttur","Kanguvely","218C",871,420,451
"5330005","Trincomalee","Seruvila","Neelapola","217B",627,305,322
"5330010","Trincomalee","Seruvila","Samagipura","217C",705,353,352
"5330015","Trincomalee","Seruvila","Sivapuram","217F",243,110,133
"5330020","Trincomalee","Seruvila","Dehiwatta","217",588,305,283
"5330025","Trincomalee","Seruvila","Thanganagar","215G",954,448,506
"5330030","Trincomalee","Seruvila","Kavanthissapura","215E",889,408,481
"5330035","Trincomalee","Seruvila","Seruvila","215",422,235,187
"5330040","Trincomalee","Seruvila","Navatkernikadu","215B",2438,1204,1234
"5330045","Trincomalee","Seruvila","Sumedhankarapura","215D",297,159,138
"5330050","Trincomalee","Seruvila","Mahindapura","215C",373,207,166
"5330055","Trincomalee","Seruvila","Serunuwara","215F",2217,1095,1122
"5330060","Trincomalee","Seruvila","Mahaweligama","215A",1185,595,590
"5330065","Trincomalee","Seruvila","Lingapuram","217E",489,224,265
"5330070","Trincomalee","Seruvila","Ariyamankerni","217D",512,241,271
"5330075","Trincomalee","Seruvila","Sirimangalapura","217G",828,414,414
"5330080","Trincomalee","Seruvila","Somapura","217A",865,439,426
"5333005","Trincomalee","Verugal/Echchilampattai","Ilangaithurai","214C",545,267,278
"5333010","Trincomalee","Verugal/Echchilampattai","Ilangaithurai Mugathuvaram","214F",1916,924,992
"5333015","Trincomalee","Verugal/Echchilampattai","Karukkamunai","214G",911,451,460
"5333020","Trincomalee","Verugal/Echchilampattai","Poonagar","214B",1276,641,635
"5333025","Trincomalee","Verugal/Echchilampattai","Poomarathadichenai","214H",826,388,438
"5333030","Trincomalee","Verugal/Echchilampattai","Eachchilampathai","214",692,346,346
"5333035","Trincomalee","Verugal/Echchilampattai","Verugal","214A",1464,710,754
"5333040","Trincomalee","Verugal/Echchilampattai","Anaitheevu","214D",1376,695,681
"5333045","Trincomalee","Verugal/Echchilampattai","Verugal Mugathuvaram","214E",1632,801,831
"5333050","Trincomalee","Verugal/Echchilampattai","Uppooral","215H",771,351,420
"7103005","Anuradhapura","Padaviya","Buddhangala","5",1342,713,629
"7103010","Anuradhapura","Padaviya","Elikimbulagala","7",1761,842,919
"7103015","Anuradhapura","Padaviya","Abhayapura","9",1779,819,960
"7103020","Anuradhapura","Padaviya","Maithreepura","8",1451,699,752
"7103025","Anuradhapura","Padaviya","Parakramapura","6",2271,1107,1164
"7103030","Anuradhapura","Padaviya","Track B","4",1944,950,994
"7103035","Anuradhapura","Padaviya","Bisokotuwa","1",1184,609,575
"7103040","Anuradhapura","Padaviya","Sudarshanagama","3",2159,1055,1104
"7103045","Anuradhapura","Padaviya","Balayawewa","15",940,469,471
"7103050","Anuradhapura","Padaviya","Mahasenpura","12",1244,614,630
"7103055","Anuradhapura","Padaviya","Urewa","11",167,86,81
"7103060","Anuradhapura","Padaviya","Kumbukwewa","10",1544,770,774
"7103065","Anuradhapura","Padaviya","Ruwanpura","13",1107,530,577
"7103070","Anuradhapura","Padaviya","Bogahawewa","14",1985,968,1017
"7103075","Anuradhapura","Padaviya","Padaviya","2",2120,1122,998
"7106005","Anuradhapura","Kebithigollewa","Halmillawetiya","27",1001,513,488
"7106010","Anuradhapura","Kebithigollewa","Kanugahawewa","28",845,438,407
"7106015","Anuradhapura","Kebithigollewa","Herathhalmillewa","35",400,200,200
"7106020","Anuradhapura","Kebithigollewa","Bellankadawala","37",737,362,375
"7106025","Anuradhapura","Kebithigollewa","Punchimudagama","38",329,157,172
"7106030","Anuradhapura","Kebithigollewa","D 06 Wahalkada","41",267,139,128
"7106035","Anuradhapura","Kebithigollewa","D 05 Wahalkada","40",812,396,416
"7106040","Anuradhapura","Kebithigollewa","D 04 Wahalkada","39",774,378,396
"7106045","Anuradhapura","Kebithigollewa","Kahatagollewa","36",622,309,313
"7106050","Anuradhapura","Kebithigollewa","Thammennawa","34",544,255,289
"7106055","Anuradhapura","Kebithigollewa","Kunchuttuwa","26",631,330,301
"7106060","Anuradhapura","Kebithigollewa","Galawewa","30",967,461,506
"7106065","Anuradhapura","Kebithigollewa","Thittagonewa","33",955,483,472
"7106070","Anuradhapura","Kebithigollewa","Kurulugama","32",1565,787,778
"7106075","Anuradhapura","Kebithigollewa","Sinhalaetaweerawewa","22",586,291,295
"7106080","Anuradhapura","Kebithigollewa","Ethalvidda Wewa","29",629,305,324
"7106085","Anuradhapura","Kebithigollewa","Gonumeriyawa","25",1159,580,579
"7106090","Anuradhapura","Kebithigollewa","Kebithigollewa","18",2183,1119,1064
"7106095","Anuradhapura","Kebithigollewa","Ihala Usgollewa","23",924,472,452
"7106100","Anuradhapura","Kebithigollewa","Aiyathigewewa","24",1157,554,603
"7106105","Anuradhapura","Kebithigollewa","Bandaraulpatha","31",532,253,279
"7106110","Anuradhapura","Kebithigollewa","Kiriketuwewa","21",1530,755,775
"7106115","Anuradhapura","Kebithigollewa","Gonahathdenawa","19",677,333,344
"7106120","Anuradhapura","Kebithigollewa","Thimbiriwewa","17",793,387,406
"7106125","Anuradhapura","Kebithigollewa","Handagala Kirimetiyawa","16",638,307,331
"7106130","Anuradhapura","Kebithigollewa","Wattewewa","20",1068,534,534
"7109005","Anuradhapura","Medawachchiya","Prabodhagama","43",1638,761,877
"7109010","Anuradhapura","Medawachchiya","Paranahalmillewa","45",1326,641,685
"7109015","Anuradhapura","Medawachchiya","Lolugaswewa","53",1249,608,641
"7109020","Anuradhapura","Medawachchiya","Puhudivula","44",1323,652,671
"7109025","Anuradhapura","Medawachchiya","Heerallugama","54",1408,657,751
"7109030","Anuradhapura","Medawachchiya","Ethakada","55",1714,814,900
"7109035","Anuradhapura","Medawachchiya","Etaweeragollewa","56",1017,469,548
"7109040","Anuradhapura","Medawachchiya","Kadawath Rambewa","52",674,328,346
"7109045","Anuradhapura","Medawachchiya","Maha Kumbukgollewa","46",1557,737,820
"7109050","Anuradhapura","Medawachchiya","Kidawarankulama","42",1484,688,796
"7109055","Anuradhapura","Medawachchiya","Anekattiya","48",970,479,491
"7109060","Anuradhapura","Medawachchiya","Periyakulama","49",1275,621,654
"7109065","Anuradhapura","Medawachchiya","Poonewa","47",1473,699,774
"7109070","Anuradhapura","Medawachchiya","Isinbessagama","58",1471,719,752
"7109075","Anuradhapura","Medawachchiya","Maha Divulwewa","57",916,419,497
"7109080","Anuradhapura","Medawachchiya","Kidagalegama","73",783,373,410
"7109085","Anuradhapura","Medawachchiya","Moragoda","74",1283,601,682
"7109090","Anuradhapura","Medawachchiya","Unagaswewa","75",753,354,399
"7109095","Anuradhapura","Medawachchiya","Kirigalwewa","72",861,419,442
"7109100","Anuradhapura","Medawachchiya","Angunochchiya","71",1064,483,581
"7109105","Anuradhapura","Medawachchiya","Ekirikanda","59",1252,608,644
"7109110","Anuradhapura","Medawachchiya","Railway Town","61",905,423,482
"7109115","Anuradhapura","Medawachchiya","Kadawathgama","60",1179,572,607
"7109120","Anuradhapura","Medawachchiya","Kuda Kumbukgollewa","51",1252,602,650
"7109125","Anuradhapura","Medawachchiya","Yakawewa","50",1651,803,848
"7109130","Anuradhapura","Medawachchiya","Thammenne Elawaka","63",1586,789,797
"7109135","Anuradhapura","Medawachchiya","Puleliya","62",1491,743,748
"7109140","Anuradhapura","Medawachchiya","Viralmurippuwa","64",1186,572,614
"7109145","Anuradhapura","Medawachchiya","Walpola","65",879,389,490
"7109150","Anuradhapura","Medawachchiya","Katuwela","66",2263,1120,1143
"7109155","Anuradhapura","Medawachchiya","Medawachchiya West","67",2330,1233,1097
"7109160","Anuradhapura","Medawachchiya","Medawachchiya East","68",1526,747,779
"7109165","Anuradhapura","Medawachchiya","Kanadara Divulwewa","69",886,431,455
"7109170","Anuradhapura","Medawachchiya","Helambagaswewa","70",966,463,503
"7109175","Anuradhapura","Medawachchiya","Sangilikanadarawa","78",1725,819,906
"7109180","Anuradhapura","Medawachchiya","Lindawewa","77",751,360,391
"7109185","Anuradhapura","Medawachchiya","Karambankulama","76",839,387,452
"7112005","Anuradhapura","Mahavilachchiya","Dematamalgama","367",1221,621,600
"7112010","Anuradhapura","Mahavilachchiya","Thanthirimale","366",1239,660,579
"7112015","Anuradhapura","Mahavilachchiya","Nelumvila","368",1684,847,837
"7112020","Anuradhapura","Mahavilachchiya","Sandamaleliya","369",1465,771,694
"7112025","Anuradhapura","Mahavilachchiya","Thuppitiyawa","372",1103,549,554
"7112030","Anuradhapura","Mahavilachchiya","Ethdathkalla","370",1245,599,646
"7112035","Anuradhapura","Mahavilachchiya","Randoowa","363",1489,724,765
"7112040","Anuradhapura","Mahavilachchiya","Palugaswewa","364",1171,588,583
"7112045","Anuradhapura","Mahavilachchiya","Mannaram Junction","365",1680,815,865
"7112050","Anuradhapura","Mahavilachchiya","Kuda Vilachchiya","360",1188,564,624
"7112055","Anuradhapura","Mahavilachchiya","Maha Vilachchiya","359",1212,566,646
"7112060","Anuradhapura","Mahavilachchiya","Pemaduwa","362",1505,779,726
"7112065","Anuradhapura","Mahavilachchiya","Kiralpetiyawa","361",1091,554,537
"7112070","Anuradhapura","Mahavilachchiya","Navodagama","371",1665,837,828
"7112075","Anuradhapura","Mahavilachchiya","Oyamaduwa","358",1680,805,875
"7112080","Anuradhapura","Mahavilachchiya","Helambawewa","357",803,401,402
"7112085","Anuradhapura","Mahavilachchiya","Dunumadalawa","356",1026,497,529
"7115005","Anuradhapura","Nuwaragam Palatha Central","Helambagaswewa","306",618,316,302
"7115010","Anuradhapura","Nuwaragam Palatha Central","Asirikgama","308",1063,510,553
"7115015","Anuradhapura","Nuwaragam Palatha Central","Gambirigaswewa","309",1350,657,693
"7115020","Anuradhapura","Nuwaragam Palatha Central","Aluthgama","307",1555,785,770
"7115025","Anuradhapura","Nuwaragam Palatha Central","Galpottegama","305",1319,667,652
"7115030","Anuradhapura","Nuwaragam Palatha Central","Maha Ehetuwewa","288",1023,521,502
"7115035","Anuradhapura","Nuwaragam Palatha Central","Maningamuwa","287",1140,585,555
"7115040","Anuradhapura","Nuwaragam Palatha Central","Elayapattuwa","286",1166,567,599
"7115045","Anuradhapura","Nuwaragam Palatha Central","Diganegama","289",655,313,342
"7115050","Anuradhapura","Nuwaragam Palatha Central","Karambewa","303",1331,648,683
"7115055","Anuradhapura","Nuwaragam Palatha Central","Galkadawala","304",1183,570,613
"7115060","Anuradhapura","Nuwaragam Palatha Central","Poowarsankulama","310",1651,766,885
"7115065","Anuradhapura","Nuwaragam Palatha Central","Paniyankadawala","312",1144,559,585
"7115070","Anuradhapura","Nuwaragam Palatha Central","Parasangahawewa","311",1536,763,773
"7115075","Anuradhapura","Nuwaragam Palatha Central","Mankadawala","313",2271,1122,1149
"7115080","Anuradhapura","Nuwaragam Palatha Central","Saliyapura","314",1051,540,511
"7115085","Anuradhapura","Nuwaragam Palatha Central","Ashokaramaya","301",1216,593,623
"7115090","Anuradhapura","Nuwaragam Palatha Central","Perimiyankulama","300",1299,631,668
"7115095","Anuradhapura","Nuwaragam Palatha Central","Katukeliyawa","302",1439,703,736
"7115100","Anuradhapura","Nuwaragam Palatha Central","Pusiyankulama","290",1567,783,784
"7115105","Anuradhapura","Nuwaragam Palatha Central","Maha Mankadawala","284",1234,615,619
"7115110","Anuradhapura","Nuwaragam Palatha Central","Ilandagahawewa","285",1161,587,574
"7115115","Anuradhapura","Nuwaragam Palatha Central","Vihara Kallanchiya","291",1061,505,556
"7115120","Anuradhapura","Nuwaragam Palatha Central","Vihara Palugama","292",1813,899,914
"7115125","Anuradhapura","Nuwaragam Palatha Central","Dewanampiyathissa Pura","295A",6063,2929,3134
"7115130","Anuradhapura","Nuwaragam Palatha Central","Abhayawewa","294",1967,963,1004
"7115135","Anuradhapura","Nuwaragam Palatha Central","Pethispura","298",1877,890,987
"7115140","Anuradhapura","Nuwaragam Palatha Central","Bandara Puliyankulama","319",1711,905,806
"7115145","Anuradhapura","Nuwaragam Palatha Central","Jayanthi Gramaya","315",2672,1274,1398
"7115150","Anuradhapura","Nuwaragam Palatha Central","Theppankulama","316",2302,1144,1158
"7115155","Anuradhapura","Nuwaragam Palatha Central","Thannayamkulama","317",1122,561,561
"7115160","Anuradhapura","Nuwaragam Palatha Central","Saliya Mawatha","318",1895,898,997
"7115165","Anuradhapura","Nuwaragam Palatha Central","Shuddha Nagaraya","299",727,419,308
"7115170","Anuradhapura","Nuwaragam Palatha Central","Thisawewa","295",121,66,55
"7115175","Anuradhapura","Nuwaragam Palatha Central","Wessagiriya","297",1208,667,541
"7115180","Anuradhapura","Nuwaragam Palatha Central","Isurumuniya","296",1525,732,793
"7115185","Anuradhapura","Nuwaragam Palatha Central","Pandulagama","293",2481,1261,1220
"7115190","Anuradhapura","Nuwaragam Palatha Central","Pahalagama","282",1386,713,673
"7115195","Anuradhapura","Nuwaragam Palatha Central","Maha Bulankulama","283",1651,838,813
"7115200","Anuradhapura","Nuwaragam Palatha Central","Ulukkulama","281",1669,831,838
"7118005","Anuradhapura","Rambewa","Kolibendawewa","105",1067,501,566
"7118010","Anuradhapura","Rambewa","Medagama","104",1186,587,599
"7118015","Anuradhapura","Rambewa","Kadurugasdamana","116",1290,627,663
"7118020","Anuradhapura","Rambewa","Siyambalagaswewa","107",665,333,332
"7118025","Anuradhapura","Rambewa","Katukeliyawa","106",851,402,449
"7118030","Anuradhapura","Rambewa","Wahamalgollewa Track 05","110",1069,530,539
"7118035","Anuradhapura","Rambewa","Sangilikanadarawa","111",1076,512,564
"7118040","Anuradhapura","Rambewa","Diviyaudabendawewa","103",793,381,412
"7118045","Anuradhapura","Rambewa","Thalgahawewa","84",1062,501,561
"7118050","Anuradhapura","Rambewa","Galkandegama","85",1241,617,624
"7118055","Anuradhapura","Rambewa","Balahondawewa","86",706,351,355
"7118060","Anuradhapura","Rambewa","Pihimbiyagollewa","81",1056,518,538
"7118065","Anuradhapura","Rambewa","Galweeragollewa","79",446,189,257
"7118070","Anuradhapura","Rambewa","Ambagahawewa","80",660,317,343
"7118075","Anuradhapura","Rambewa","Thamarahalmillewa","83",524,254,270
"7118080","Anuradhapura","Rambewa","Wewelketiya","82",1024,481,543
"7118085","Anuradhapura","Rambewa","Ihala Kolongaswewa","87",553,266,287
"7118090","Anuradhapura","Rambewa","Konakumbukwewa","91",696,327,369
"7118095","Anuradhapura","Rambewa","Kedewa","97",597,269,328
"7118100","Anuradhapura","Rambewa","Kallanchiya","89",790,405,385
"7118105","Anuradhapura","Rambewa","Gonewa","92",1091,542,549
"7118110","Anuradhapura","Rambewa","Ikirigollewa","102",4018,1989,2029
"7118115","Anuradhapura","Rambewa","Wahamalgollewa","108",926,435,491
"7118120","Anuradhapura","Rambewa","Wahamalgollewa Track 03","109",676,306,370
"7118125","Anuradhapura","Rambewa","Pallankulama","99",1265,597,668
"7118130","Anuradhapura","Rambewa","Mahawewa","114",1175,554,621
"7118135","Anuradhapura","Rambewa","Pandukabhayapura","115",855,414,441
"7118140","Anuradhapura","Rambewa","Katupuliyankulama","112",1091,536,555
"7118145","Anuradhapura","Rambewa","Sandamalgama","113",931,459,472
"7118150","Anuradhapura","Rambewa","Rambewa","100",1568,803,765
"7118155","Anuradhapura","Rambewa","Nabadagaswewa","101",843,416,427
"7118160","Anuradhapura","Rambewa","Mahakanadarawa R. B. Track 02","93",853,427,426
"7118165","Anuradhapura","Rambewa","Kapiriggama","98",456,215,241
"7118170","Anuradhapura","Rambewa","Peenagama","90",817,378,439
"7118175","Anuradhapura","Rambewa","Meemalwewa","88",544,276,268
"7118180","Anuradhapura","Rambewa","Rotawewa","95",693,339,354
"7118185","Anuradhapura","Rambewa","Kudagama","96",702,367,335
"7118190","Anuradhapura","Rambewa","Mahakanadarawa R. B. Track 01","94",926,466,460
"7121005","Anuradhapura","Kahatagasdigiliya","Kirigallewa","226",808,389,419
"7121010","Anuradhapura","Kahatagasdigiliya","Rathmalgahawewa","225",865,435,430
"7121015","Anuradhapura","Kahatagasdigiliya","Kudapattiya","207",1283,596,687
"7121020","Anuradhapura","Kahatagasdigiliya","Maha Kumbukwewa","222",803,374,429
"7121025","Anuradhapura","Kahatagasdigiliya","Palippothana","224",587,253,334
"7121030","Anuradhapura","Kahatagasdigiliya","Gonumeru Wewa","223",787,361,426
"7121035","Anuradhapura","Kahatagasdigiliya","Thurukkuragama","234",1039,531,508
"7121040","Anuradhapura","Kahatagasdigiliya","Maha Kiribbewa","233",1081,525,556
"7121045","Anuradhapura","Kahatagasdigiliya","Maha Galkandegama","235",708,340,368
"7121050","Anuradhapura","Kahatagasdigiliya","Dachchihalmillawewa","206",1054,482,572
"7121055","Anuradhapura","Kahatagasdigiliya","Maha Hammillawewa","208",840,396,444
"7121060","Anuradhapura","Kahatagasdigiliya","Kumbukgollewa","209",885,470,415
"7121065","Anuradhapura","Kahatagasdigiliya","Pandarellewa","210",763,352,411
"7121070","Anuradhapura","Kahatagasdigiliya","Sampathgama","205",1388,669,719
"7121075","Anuradhapura","Kahatagasdigiliya","Thallattewa","217",876,441,435
"7121080","Anuradhapura","Kahatagasdigiliya","Mahawewa","221",1363,665,698
"7121085","Anuradhapura","Kahatagasdigiliya","Kahatagasdigiliya East","231",1746,886,860
"7121090","Anuradhapura","Kahatagasdigiliya","Kahatagasdigiliya West","232",2204,1084,1120
"7121095","Anuradhapura","Kahatagasdigiliya","Kokmaduwa","201",1146,550,596
"7121100","Anuradhapura","Kahatagasdigiliya","Moragahawela","202",652,299,353
"7121105","Anuradhapura","Kahatagasdigiliya","Samadhigama","204",697,337,360
"7121110","Anuradhapura","Kahatagasdigiliya","Mekichchawa","203",1379,661,718
"7121115","Anuradhapura","Kahatagasdigiliya","Ranpathvila","196",1388,633,755
"7121120","Anuradhapura","Kahatagasdigiliya","Bethkewa - Thulana","198",1192,557,635
"7121125","Anuradhapura","Kahatagasdigiliya","Maha Messalewa","230",1692,792,900
"7121130","Anuradhapura","Kahatagasdigiliya","Kohombagaskada","220",933,444,489
"7121135","Anuradhapura","Kahatagasdigiliya","Konwewa","216",1240,580,660
"7121140","Anuradhapura","Kahatagasdigiliya","Ambagahawewa","213",868,432,436
"7121145","Anuradhapura","Kahatagasdigiliya","Panwella","211",627,319,308
"7121150","Anuradhapura","Kahatagasdigiliya","Mee - Kumbukwewa","212",849,391,458
"7121155","Anuradhapura","Kahatagasdigiliya","Tikkampothana","214",430,218,212
"7121160","Anuradhapura","Kahatagasdigiliya","Punchi Halmillewa","219",648,320,328
"7121165","Anuradhapura","Kahatagasdigiliya","Weligollewa","218",837,424,413
"7121170","Anuradhapura","Kahatagasdigiliya","Divulwewa","215",1202,595,607
"7121175","Anuradhapura","Kahatagasdigiliya","Diganhalmillawewa","229",1191,566,625
"7121180","Anuradhapura","Kahatagasdigiliya","Kelenikawewa","227",952,465,487
"7121185","Anuradhapura","Kahatagasdigiliya","Nelugollakada","228",671,322,349
"7121190","Anuradhapura","Kahatagasdigiliya","Ellawewa","197",873,411,462
"7121195","Anuradhapura","Kahatagasdigiliya","Nekutunu Wewa","200",1103,515,588
"7121200","Anuradhapura","Kahatagasdigiliya","Kanadara - Rathmale","199",689,318,371
"7124005","Anuradhapura","Horowpothana","Wahalkada D 2","145",1240,610,630
"7124010","Anuradhapura","Horowpothana","Wahalkada D 1","144",1011,524,487
"7124015","Anuradhapura","Horowpothana","Maradanmaduwa","146",875,427,448
"7124020","Anuradhapura","Horowpothana","Pahala Divulwewa","141",638,324,314
"7124025","Anuradhapura","Horowpothana","Weerasole","139",1080,529,551
"7124030","Anuradhapura","Horowpothana","Anaolondewa","138",1428,691,737
"7124035","Anuradhapura","Horowpothana","Kapugollewa","140",1008,497,511
"7124040","Anuradhapura","Horowpothana","Wagollakada","143",611,317,294
"7124045","Anuradhapura","Horowpothana","Dutuwewa","142",1067,518,549
"7124050","Anuradhapura","Horowpothana","Morawewa","135",951,496,455
"7124055","Anuradhapura","Horowpothana","Thawalanhalmillewa","137",436,204,232
"7124060","Anuradhapura","Horowpothana","Thimbiriettawala","123",1059,517,542
"7124065","Anuradhapura","Horowpothana","Nikawewa","121",1120,518,602
"7124070","Anuradhapura","Horowpothana","Welimuwapothana","120",903,437,466
"7124075","Anuradhapura","Horowpothana","Kivulekada","129",1330,696,634
"7124080","Anuradhapura","Horowpothana","Puhulewewa","134",1065,504,561
"7124085","Anuradhapura","Horowpothana","Rathmale","147",856,441,415
"7124090","Anuradhapura","Horowpothana","Welangahaulpatha","148",319,169,150
"7124095","Anuradhapura","Horowpothana","Maradankadawala","133",1630,787,843
"7124100","Anuradhapura","Horowpothana","Horowpothana","128",1886,1037,849
"7124110","Anuradhapura","Horowpothana","Mukkarawewa","122",1427,722,705
"7124115","Anuradhapura","Horowpothana","Ihala Angunachchiya","119",1095,515,580
"7124120","Anuradhapura","Horowpothana","Rasnaka Wewa","118",565,267,298
"7124125","Anuradhapura","Horowpothana","Walahaviddawewa","117",1174,582,592
"7124130","Anuradhapura","Horowpothana","Gammahegewewa","124",727,362,365
"7124135","Anuradhapura","Horowpothana","Morakewa","127",1779,892,887
"7124140","Anuradhapura","Horowpothana","Nanumillawewa","131",832,412,420
"7124145","Anuradhapura","Horowpothana","Thirappankadawala","136",831,395,436
"7124150","Anuradhapura","Horowpothana","Parangiyawadiya","149",977,465,512
"7124155","Anuradhapura","Horowpothana","Nabadawewa","152",978,485,493
"7124160","Anuradhapura","Horowpothana","Puliyankadawala","150",1080,547,533
"7124165","Anuradhapura","Horowpothana","Vilewewa","132",560,237,323
"7124170","Anuradhapura","Horowpothana","Wadigawewa","126",671,322,349
"7124175","Anuradhapura","Horowpothana","Kalpe","125",834,377,457
"7124180","Anuradhapura","Horowpothana","Dekethipothana","153",834,364,470
"7124185","Anuradhapura","Horowpothana","Dematawewa","154",622,311,311
"7124190","Anuradhapura","Horowpothana","Diyatittawewa","151",741,368,373
"7127005","Anuradhapura","Galenbindunuwewa","Konwewa","156",620,316,304
"7127010","Anuradhapura","Galenbindunuwewa","Ellawewa","178",1784,869,915
"7127015","Anuradhapura","Galenbindunuwewa","Kataranpuraya","168",974,483,491
"7127020","Anuradhapura","Galenbindunuwewa","Dutuwewa","165",898,470,428
"7127025","Anuradhapura","Galenbindunuwewa","Perettupala Gama","167",1097,522,575
"7127030","Anuradhapura","Galenbindunuwewa","Kokawewa","169",1732,877,855
"7127035","Anuradhapura","Galenbindunuwewa","Dutuwewa Paranagama","166",1333,660,673
"7127040","Anuradhapura","Galenbindunuwewa","21 Colony East","180",674,327,347
"7127045","Anuradhapura","Galenbindunuwewa","21 Colony West","179",799,392,407
"7127050","Anuradhapura","Galenbindunuwewa","Ulpathgama","158",1002,486,516
"7127055","Anuradhapura","Galenbindunuwewa","Upuldeniya","155",1338,648,690
"7127060","Anuradhapura","Galenbindunuwewa","Himbutugollewa","157",884,415,469
"7127065","Anuradhapura","Galenbindunuwewa","Mailagaswewa","159",780,392,388
"7127070","Anuradhapura","Galenbindunuwewa","Ihalagama","163",532,247,285
"7127075","Anuradhapura","Galenbindunuwewa","Galenbindunuwewa","162",1949,1098,851
"7127080","Anuradhapura","Galenbindunuwewa","Karuwalagaswewa","173",1599,777,822
"7127085","Anuradhapura","Galenbindunuwewa","Palugollagama","170",1091,523,568
"7127090","Anuradhapura","Galenbindunuwewa","Aluth Divulwewa","171",1058,522,536
"7127095","Anuradhapura","Galenbindunuwewa","Getalawa","172",1812,871,941
"7127100","Anuradhapura","Galenbindunuwewa","Hurulunikawewa","176",1281,607,674
"7127105","Anuradhapura","Galenbindunuwewa","Ilukbadayagama","164",1819,892,927
"7127110","Anuradhapura","Galenbindunuwewa","Kuda Galenbindunuwewa","161",1043,491,552
"7127115","Anuradhapura","Galenbindunuwewa","Thammennagama","160",412,213,199
"7127120","Anuradhapura","Galenbindunuwewa","Sivalakulama","182",929,456,473
"7127125","Anuradhapura","Galenbindunuwewa","Gomarankalla","190",824,410,414
"7127130","Anuradhapura","Galenbindunuwewa","Hurulunikawewa","177",1148,531,617
"7127135","Anuradhapura","Galenbindunuwewa","Kumbukwewa","175",1514,731,783
"7127140","Anuradhapura","Galenbindunuwewa","Janasirigama","174",2145,1045,1100
"7127145","Anuradhapura","Galenbindunuwewa","Kurunegala Colony","194",1413,668,745
"7127150","Anuradhapura","Galenbindunuwewa","Nuwaragam Colony","195",772,379,393
"7127155","Anuradhapura","Galenbindunuwewa","Hurulu Jayapura","189",931,436,495
"7127160","Anuradhapura","Galenbindunuwewa","Sunanda Mawatha","191",1074,513,561
"7127165","Anuradhapura","Galenbindunuwewa","Galwaduwagama","183",1489,727,762
"7127170","Anuradhapura","Galenbindunuwewa","Muriyakadawala","181",880,438,442
"7127175","Anuradhapura","Galenbindunuwewa","Ihala Galkulama","187",1345,660,685
"7127180","Anuradhapura","Galenbindunuwewa","Hurulumeegahapattiya","188",793,353,440
"7127185","Anuradhapura","Galenbindunuwewa","Nuwaraeli Colony","193",459,215,244
"7127190","Anuradhapura","Galenbindunuwewa","Pandikaramaduwa","192",1096,540,556
"7127195","Anuradhapura","Galenbindunuwewa","Yakalla","186",2044,1007,1037
"7127200","Anuradhapura","Galenbindunuwewa","Manankattiya","184",1121,551,570
"7127205","Anuradhapura","Galenbindunuwewa","Wannamkulama","185",504,261,243
"7130005","Anuradhapura","Mihinthale","Ukkulankulama","588",1147,544,603
"7130010","Anuradhapura","Mihinthale","Mahakanadarawa Track 03","585",816,389,427
"7130015","Anuradhapura","Mihinthale","Mahakanadarawa Track 02","584",1074,496,578
"7130020","Anuradhapura","Mihinthale","Mahakanadarawa Track 01","583",1030,487,543
"7130025","Anuradhapura","Mihinthale","Maradankulama","586",1373,676,697
"7130030","Anuradhapura","Mihinthale","Doramadalawa","587",810,413,397
"7130035","Anuradhapura","Mihinthale","Kunchikulama","573",2850,1381,1469
"7130040","Anuradhapura","Mihinthale","Hena Watta","572",2126,1006,1120
"7130045","Anuradhapura","Mihinthale","Nuwarawewa","571",1468,701,767
"7130050","Anuradhapura","Mihinthale","Kurundankulama","574",1736,824,912
"7130055","Anuradhapura","Mihinthale","Kannattiya","575",1553,709,844
"7130060","Anuradhapura","Mihinthale","Mihinthale","577",4263,1800,2463
"7130065","Anuradhapura","Mihinthale","Ruwangama","578",2164,1042,1122
"7130070","Anuradhapura","Mihinthale","Namalwewa","579",1272,604,668
"7130075","Anuradhapura","Mihinthale","Bogahayaya","582",1181,580,601
"7130080","Anuradhapura","Mihinthale","Pothana","564",1453,702,751
"7130085","Anuradhapura","Mihinthale","Seeppukulama","566",1270,610,660
"7130090","Anuradhapura","Mihinthale","Thammennawa","567",703,351,352
"7130095","Anuradhapura","Mihinthale","Kasamaduwa","568",1077,509,568
"7130100","Anuradhapura","Mihinthale","Katukeliyawa","569",1362,626,736
"7130110","Anuradhapura","Mihinthale","Kahapathvilagama","576",651,325,326
"7130115","Anuradhapura","Mihinthale","Ihalagama","565",828,402,426
"7130120","Anuradhapura","Mihinthale","Maradankalla","581",1298,631,667
"7130125","Anuradhapura","Mihinthale","Wellaragama","580",1134,570,564
"7133005","Anuradhapura","Nuwaragam Palatha East","Nuwara Wewa","250",1894,952,942
"7133010","Anuradhapura","Nuwaragam Palatha East","Step 1 part i","248",1859,957,902
"7133015","Anuradhapura","Nuwaragam Palatha East","Mahakalattewa","279",1790,883,907
"7133020","Anuradhapura","Nuwaragam Palatha East","Thariyankulama","280",1246,635,611
"7133030","Anuradhapura","Nuwaragam Palatha East","Kuda Nelumkulama","277",1639,806,833
"7133035","Anuradhapura","Nuwaragam Palatha East","Keerikkulama","276",1767,858,909
"7133040","Anuradhapura","Nuwaragam Palatha East","Thammennapura","241",1619,784,835
"7133045","Anuradhapura","Nuwaragam Palatha East","Wannithammennawa","239",1681,835,846
"7133050","Anuradhapura","Nuwaragam Palatha East","Thammennakulama","240",4379,2124,2255
"7133055","Anuradhapura","Nuwaragam Palatha East","Step 1 part ii","249",2517,1261,1256
"7133060","Anuradhapura","Nuwaragam Palatha East","Step 2 part iii","253",2653,1218,1435
"7133065","Anuradhapura","Nuwaragam Palatha East","Step 2 part ii","252",4560,2674,1886
"7133070","Anuradhapura","Nuwaragam Palatha East","Pothanegama","258",2838,1375,1463
"7133075","Anuradhapura","Nuwaragam Palatha East","Step 3 part iii","257",4814,2316,2498
"7133080","Anuradhapura","Nuwaragam Palatha East","Step 2 part i","251",4726,2079,2647
"7133085","Anuradhapura","Nuwaragam Palatha East","Step 2 part iv","254",3082,1464,1618
"7133090","Anuradhapura","Nuwaragam Palatha East","Wanniyankulama Kotasa 4","245",1719,837,882
"7133095","Anuradhapura","Nuwaragam Palatha East","Wanniyankulama Kotasa 5","246",2001,910,1091
"7133100","Anuradhapura","Nuwaragam Palatha East","Wanniyankulama Kotasa 6","247",1785,825,960
"7133105","Anuradhapura","Nuwaragam Palatha East","Gnanikulama","238",1661,763,898
"7133110","Anuradhapura","Nuwaragam Palatha East","Kawarakkulama","275",1942,965,977
"7133115","Anuradhapura","Nuwaragam Palatha East","Mahapaladikulama","237",2546,1222,1324
"7133120","Anuradhapura","Nuwaragam Palatha East","Step 3 part i","255",3255,1537,1718
"7133125","Anuradhapura","Nuwaragam Palatha East","Step 3 part ii","256",3202,1543,1659
"7133130","Anuradhapura","Nuwaragam Palatha East","Wanniyankulama Kotasa 3","244",1301,603,698
"7133135","Anuradhapura","Nuwaragam Palatha East","Wanniyankulama Kotasa 1","242",2829,1387,1442
"7133140","Anuradhapura","Nuwaragam Palatha East","Wanniyankulama Kotasa 2","243",1497,754,743
"7133145","Anuradhapura","Nuwaragam Palatha East","Sucharithagama","236",1575,775,800
"7136005","Anuradhapura","Nachchadoowa","Kimbulakada","262",1575,783,792
"7136010","Anuradhapura","Nachchadoowa","Shrawasthipura","259",2167,1048,1119
"7136015","Anuradhapura","Nachchadoowa","Kuda Nelubewa","265",1271,594,677
"7136020","Anuradhapura","Nachchadoowa","Shrawasthiwatta","260",1636,771,865
"7136025","Anuradhapura","Nachchadoowa","Aluthwewa","261",1733,838,895
"7136030","Anuradhapura","Nachchadoowa","Amane","263",1603,775,828
"7136035","Anuradhapura","Nachchadoowa","Maha Nelubewa","266",1271,623,648
"7136040","Anuradhapura","Nachchadoowa","Divulwewa","264",1113,548,565
"7136045","Anuradhapura","Nachchadoowa","Hidogama","271",1520,749,771
"7136050","Anuradhapura","Nachchadoowa","Pawakkulama","267",1147,581,566
"7136055","Anuradhapura","Nachchadoowa","Kaluvila North","274",908,418,490
"7136060","Anuradhapura","Nachchadoowa","Madawalagama","273",659,343,316
"7136065","Anuradhapura","Nachchadoowa","Nachchadoowa","535",1181,593,588
"7136070","Anuradhapura","Nachchadoowa","Nachchadoowa New Town","536",1820,831,989
"7136075","Anuradhapura","Nachchadoowa","Palayakulama","538",1152,559,593
"7136080","Anuradhapura","Nachchadoowa","Suhadagama","272",1113,554,559
"7136085","Anuradhapura","Nachchadoowa","Thuruvila","270",1393,676,717
"7136090","Anuradhapura","Nachchadoowa","Kaluarachchiyagama","268",1087,548,539
"7136095","Anuradhapura","Nachchadoowa","Pahalawewa","269",1028,507,521
"7139005","Anuradhapura","Nochchiyagama","Kukulkatuwa","320",636,315,321
"7139010","Anuradhapura","Nochchiyagama","Ittikulama","321",887,435,452
"7139015","Anuradhapura","Nochchiyagama","Ranorawa","322",438,215,223
"7139020","Anuradhapura","Nochchiyagama","Mahalindawewa","323",132,63,69
"7139025","Anuradhapura","Nochchiyagama","Bogahawewa","324",1497,755,742
"7139030","Anuradhapura","Nochchiyagama","Ambagahawewa","325",717,349,368
"7139035","Anuradhapura","Nochchiyagama","Ehetuwagama","326",982,496,486
"7139040","Anuradhapura","Nochchiyagama","Thalgaswewa","332",858,410,448
"7139045","Anuradhapura","Nochchiyagama","Hunuvilagama","327",945,471,474
"7139050","Anuradhapura","Nochchiyagama","Horuvila","355",778,378,400
"7139055","Anuradhapura","Nochchiyagama","Lindawewa","331",1217,576,641
"7139060","Anuradhapura","Nochchiyagama","Kusumpura","333",1828,881,947
"7139065","Anuradhapura","Nochchiyagama","Mudithagama","337",3120,1514,1606
"7139070","Anuradhapura","Nochchiyagama","Ralapanawagama","338",1534,769,765
"7139075","Anuradhapura","Nochchiyagama","Adampane","340",1216,585,631
"7139080","Anuradhapura","Nochchiyagama","Andarawewa","341",1519,762,757
"7139085","Anuradhapura","Nochchiyagama","Ralapanawa Colony","339",1586,754,832
"7139090","Anuradhapura","Nochchiyagama","Nochchiyagama","334",3669,1897,1772
"7139095","Anuradhapura","Nochchiyagama","Dunudambuwewa","336",1393,697,696
"7139100","Anuradhapura","Nochchiyagama","Thimbiriwewa","328",1103,547,556
"7139105","Anuradhapura","Nochchiyagama","Katupathwewa","329",1212,592,620
"7139110","Anuradhapura","Nochchiyagama","Pahala Maragahawewa","330",1125,526,599
"7139115","Anuradhapura","Nochchiyagama","Nelawagama","349",1811,889,922
"7139120","Anuradhapura","Nochchiyagama","Pahala Halmillewa","350",1797,856,941
"7139125","Anuradhapura","Nochchiyagama","Halmillakulama","335",2003,955,1048
"7139130","Anuradhapura","Nochchiyagama","Dunupothagama","345",1004,500,504
"7139135","Anuradhapura","Nochchiyagama","Dombawalagama","346",1433,718,715
"7139140","Anuradhapura","Nochchiyagama","Pahamunegama","342",1614,782,832
"7139145","Anuradhapura","Nochchiyagama","Navakkulama","343",1599,775,824
"7139150","Anuradhapura","Nochchiyagama","Galadivulwewa","344",1021,482,539
"7139155","Anuradhapura","Nochchiyagama","Jayagama","347",1123,540,583
"7139160","Anuradhapura","Nochchiyagama","Amunukole","348",1844,909,935
"7139165","Anuradhapura","Nochchiyagama","Mihiripura","352",854,411,443
"7139170","Anuradhapura","Nochchiyagama","Pahala Kedithokkuwa","351",1629,834,795
"7139175","Anuradhapura","Nochchiyagama","Rankethgama","353",2130,1050,1080
"7139180","Anuradhapura","Nochchiyagama","Ottappuwa","354",1632,792,840
"7142005","Anuradhapura","Rajanganaya","Track 13,18","456",1463,723,740
"7142010","Anuradhapura","Rajanganaya","Track 16,17","458",3268,1589,1679
"7142015","Anuradhapura","Rajanganaya","Veheragala","455",2843,1390,1453
"7142020","Anuradhapura","Rajanganaya","Yaya 12","454",1463,716,747
"7142025","Anuradhapura","Rajanganaya","Track 09 - 10","452",1864,938,926
"7142030","Anuradhapura","Rajanganaya","Track 11","453",1281,611,670
"7142035","Anuradhapura","Rajanganaya","Track 15","457",2509,1181,1328
"7142040","Anuradhapura","Rajanganaya","Gemunupura","451",1857,919,938
"7142045","Anuradhapura","Rajanganaya","Track 07","450",1259,584,675
"7142050","Anuradhapura","Rajanganaya","Thumbullegama","449",1358,643,715
"7142055","Anuradhapura","Rajanganaya","Randenigama","447",1281,641,640
"7142060","Anuradhapura","Rajanganaya","Track 04","445",1355,662,693
"7142065","Anuradhapura","Rajanganaya","Track 03","444",1092,528,564
"7142070","Anuradhapura","Rajanganaya","Naigala","443",1351,652,699
"7142075","Anuradhapura","Rajanganaya","Thissapura","446",878,418,460
"7142080","Anuradhapura","Rajanganaya","Maha Thimbirikalla","442",1913,911,1002
"7142085","Anuradhapura","Rajanganaya","Angamuwa","448",1330,642,688
"7142090","Anuradhapura","Rajanganaya","04 1/2 Kanuwa","441",1375,663,712
"7142095","Anuradhapura","Rajanganaya","Sirimapura","440",1161,587,574
"7142100","Anuradhapura","Rajanganaya","Panthiyawa","439",1148,562,586
"7142105","Anuradhapura","Rajanganaya","Kalundegama","438",1494,705,789
"7145005","Anuradhapura","Thambuttegama","Kongollewa","431",2530,1243,1287
"7145010","Anuradhapura","Thambuttegama","Kelegama","433",1610,799,811
"7145015","Anuradhapura","Thambuttegama","Pahalagama","432",1654,852,802
"7145020","Anuradhapura","Thambuttegama","Solama","434",1129,581,548
"7145025","Anuradhapura","Thambuttegama","Maha Bellankadawala","435",1600,775,825
"7145030","Anuradhapura","Thambuttegama","Eriyagama","430",1204,594,610
"7145035","Anuradhapura","Thambuttegama","Delnegama","436",1259,633,626
"7145040","Anuradhapura","Thambuttegama","Kuda Bellankadawala","437",1139,538,601
"7145045","Anuradhapura","Thambuttegama","Konwewa","425",1774,866,908
"7145050","Anuradhapura","Thambuttegama","Jayasirigama","423",885,437,448
"7145055","Anuradhapura","Thambuttegama","Lunuwewa","422",1177,566,611
"7145060","Anuradhapura","Thambuttegama","Veheragala","426",2037,1004,1033
"7145065","Anuradhapura","Thambuttegama","Thammennagama","424",3304,1584,1720
"7145070","Anuradhapura","Thambuttegama","Nallachchiya","421",2553,1241,1312
"7145075","Anuradhapura","Thambuttegama","Galviharawewa","429",1237,611,626
"7145080","Anuradhapura","Thambuttegama","Thelhiriyawa","427",1641,812,829
"7145085","Anuradhapura","Thambuttegama","Ikiriwewa","419",3371,1647,1724
"7145090","Anuradhapura","Thambuttegama","Musalpitiya","420",1651,807,844
"7145095","Anuradhapura","Thambuttegama","Thambuttegama","418",1837,937,900
"7145100","Anuradhapura","Thambuttegama","Thispanepura","428",875,423,452
"7145105","Anuradhapura","Thambuttegama","Makulewa","415",1359,676,683
"7145110","Anuradhapura","Thambuttegama","Thammennawa","417",1787,866,921
"7145115","Anuradhapura","Thambuttegama","Mudungoda","416",1531,731,800
"7145120","Anuradhapura","Thambuttegama","Helambawewa","413",891,435,456
"7145125","Anuradhapura","Thambuttegama","Hureegaswewa","412",1195,596,599
"7145130","Anuradhapura","Thambuttegama","Weliyawa","414",1207,586,621
"7148005","Anuradhapura","Thalawa","Daladapura","408",791,408,383
"7148010","Anuradhapura","Thalawa","Pahala Thalawa","407",1173,574,599
"7148015","Anuradhapura","Thalawa","Moragoda","405",1770,889,881
"7148020","Anuradhapura","Thalawa","Kumbukgahawewa","410",1684,807,877
"7148025","Anuradhapura","Thalawa","Nawa Hanguranketha","409",1752,854,898
"7148030","Anuradhapura","Thalawa","Hirigollegama","411",2011,967,1044
"7148035","Anuradhapura","Thalawa","Karagahawewa","406",2381,1154,1227
"7148040","Anuradhapura","Thalawa","Ihala Thalawa","404",2308,1110,1198
"7148045","Anuradhapura","Thalawa","Hinguruwewa","401",1063,519,544
"7148050","Anuradhapura","Thalawa","Korakahawewa","402",835,433,402
"7148055","Anuradhapura","Thalawa","Kurunduwewa","403",1881,909,972
"7148060","Anuradhapura","Thalawa","Meegassegama","400",1545,756,789
"7148065","Anuradhapura","Thalawa","Kiralogama","398",1575,757,818
"7148070","Anuradhapura","Thalawa","Kadurugaswewa","389",1117,583,534
"7148075","Anuradhapura","Thalawa","Palugaswewa","391",2246,1125,1121
"7148080","Anuradhapura","Thalawa","Ketakale","399",1568,753,815
"7148085","Anuradhapura","Thalawa","Rajjallegama","396",1030,480,550
"7148090","Anuradhapura","Thalawa","Eliyadivulwewa","388",1779,874,905
"7148095","Anuradhapura","Thalawa","Ihala Siyambalewa","390",1841,919,922
"7148100","Anuradhapura","Thalawa","Eppawala","373",1981,994,987
"7148105","Anuradhapura","Thalawa","Mawathawewa","377",1132,549,583
"7148110","Anuradhapura","Thalawa","Nallamudawa","376",1321,648,673
"7148115","Anuradhapura","Thalawa","Medagama","381",1462,726,736
"7148120","Anuradhapura","Thalawa","Kiriamunukole","375",1627,791,836
"7148125","Anuradhapura","Thalawa","Kadigawa","374",1220,581,639
"7148130","Anuradhapura","Thalawa","Mediyawa","392",960,467,493
"7148135","Anuradhapura","Thalawa","Katiyawa Track 02","387",749,382,367
"7148140","Anuradhapura","Thalawa","Galwaduwagama","394",1125,568,557
"7148145","Anuradhapura","Thalawa","Ihala Halmillewa","395",998,474,524
"7148150","Anuradhapura","Thalawa","Adhiranigama","397",1615,795,820
"7148155","Anuradhapura","Thalawa","Katiyawa Track 10","385",1251,619,632
"7148160","Anuradhapura","Thalawa","Katiyawa Track 09","384",1803,846,957
"7148165","Anuradhapura","Thalawa","Katiyawa Track 01","386",1934,945,989
"7148170","Anuradhapura","Thalawa","Endagala","393",1578,780,798
"7148175","Anuradhapura","Thalawa","Kelesiyambalewa","380",1390,670,720
"7148180","Anuradhapura","Thalawa","Galmaduwa","378",926,438,488
"7148185","Anuradhapura","Thalawa","Ihalagama","382",1189,570,619
"7148190","Anuradhapura","Thalawa","Keledivulwewa","379",1118,521,597
"7148195","Anuradhapura","Thalawa","Katiyawa Track 06","383",2064,999,1065
"7151005","Anuradhapura","Thirappane","Karuwalagaswewa","527",424,213,211
"7151010","Anuradhapura","Thirappane","Galkulama","526",672,352,320
"7151015","Anuradhapura","Thirappane","Gnanikkulama","528",745,375,370
"7151020","Anuradhapura","Thirappane","Perimiyankulama","529",392,181,211
"7151025","Anuradhapura","Thirappane","Wannamkulama","521",305,148,157
"7151030","Anuradhapura","Thirappane","Uttimaduwa","520",485,234,251
"7151035","Anuradhapura","Thirappane","Dematawewa","525",332,162,170
"7151040","Anuradhapura","Thirappane","Pairimaduwa","524",744,371,373
"7151045","Anuradhapura","Thirappane","Kuttikulama","530",875,409,466
"7151050","Anuradhapura","Thirappane","Puliyankulama","531",783,404,379
"7151055","Anuradhapura","Thirappane","Mawathawewa","522",443,218,225
"7151060","Anuradhapura","Thirappane","Periyakulama","523",417,206,211
"7151065","Anuradhapura","Thirappane","Ethungama South","552",827,395,432
"7151070","Anuradhapura","Thirappane","Meewellewa","553",985,484,501
"7151075","Anuradhapura","Thirappane","Ethungama North","551",944,465,479
"7151080","Anuradhapura","Thirappane","Aluth Punchikulama","534",782,372,410
"7151085","Anuradhapura","Thirappane","Wannammaduwa","549",787,388,399
"7151090","Anuradhapura","Thirappane","Thirappane Kadaweediya","532",754,379,375
"7151095","Anuradhapura","Thirappane","Thirappanegama","533",697,361,336
"7151100","Anuradhapura","Thirappane","Sembukulama","550",750,346,404
"7151105","Anuradhapura","Thirappane","Wellamudawa","539",672,320,352
"7151110","Anuradhapura","Thirappane","Selesthimaduwa","537",919,453,466
"7151115","Anuradhapura","Thirappane","Idigahawewa","547",435,217,218
"7151120","Anuradhapura","Thirappane","Paindikulama","554",680,338,342
"7151125","Anuradhapura","Thirappane","Walagambahuwa","562",484,231,253
"7151130","Anuradhapura","Thirappane","Mahakanumulla","540",385,176,209
"7151135","Anuradhapura","Thirappane","Alisthana","548",1071,546,525
"7151140","Anuradhapura","Thirappane","Dayagama","563",266,134,132
"7151145","Anuradhapura","Thirappane","Wanamal Uyana","561",1289,669,620
"7151150","Anuradhapura","Thirappane","Manakkulama","541",558,279,279
"7151155","Anuradhapura","Thirappane","Pethis Rambewa","542",659,318,341
"7151160","Anuradhapura","Thirappane","Kattamurichchana","546",790,393,397
"7151165","Anuradhapura","Thirappane","Kandupagama","556",518,261,257
"7151170","Anuradhapura","Thirappane","Labunoruwa","555",913,441,472
"7151175","Anuradhapura","Thirappane","Pahala Ambathale","557",291,153,138
"7151180","Anuradhapura","Thirappane","Ihala Ambathale","545",934,477,457
"7151185","Anuradhapura","Thirappane","Alagollewa","543",694,351,343
"7151190","Anuradhapura","Thirappane","Muriyakadawala","544",468,223,245
"7151195","Anuradhapura","Thirappane","Amunichchiya","558",469,232,237
"7151200","Anuradhapura","Thirappane","Sandapagama","559",620,304,316
"7151205","Anuradhapura","Thirappane","Uttupitiya","560",786,376,410
"7154005","Anuradhapura","Kekirawa","Navakkulama","605",957,449,508
"7154010","Anuradhapura","Kekirawa","Moragoda","606",806,382,424
"7154015","Anuradhapura","Kekirawa","Mahadivulwewa","608",579,322,257
"7154020","Anuradhapura","Kekirawa","Keeriyagaswewa","607",467,267,200
"7154025","Anuradhapura","Kekirawa","Ihala Puliyankulama","616",1378,650,728
"7154030","Anuradhapura","Kekirawa","Kelepuliyankulama","615",766,380,386
"7154035","Anuradhapura","Kekirawa","Maradankadawala","617",3066,1501,1565
"7154040","Anuradhapura","Kekirawa","Thoruwewa","614",548,259,289
"7154045","Anuradhapura","Kekirawa","Mamineeyawa","613",593,280,313
"7154050","Anuradhapura","Kekirawa","Maminiya Rambewa","611",1155,580,575
"7154055","Anuradhapura","Kekirawa","Ganewalpola","610",1531,759,772
"7154060","Anuradhapura","Kekirawa","Heenukkiriyawa","609",1040,493,547
"7154065","Anuradhapura","Kekirawa","Embulgaswewa","632",652,326,326
"7154070","Anuradhapura","Kekirawa","Olukarada","618",697,336,361
"7154075","Anuradhapura","Kekirawa","Kollankuttigama","612",1573,778,795
"7154080","Anuradhapura","Kekirawa","Mudaperumagama","619",776,392,384
"7154085","Anuradhapura","Kekirawa","Ihalagama","621",646,321,325
"7154090","Anuradhapura","Kekirawa","Shasthrawelliya","622",477,211,266
"7154095","Anuradhapura","Kekirawa","Railway Town","620",1069,532,537
"7154100","Anuradhapura","Kekirawa","Maradankadawala Road","627",1277,615,662
"7154105","Anuradhapura","Kekirawa","Maldenipura","631",1221,608,613
"7154110","Anuradhapura","Kekirawa","Mankadawala","630",616,292,324
"7154115","Anuradhapura","Kekirawa","Medawewa","633",602,274,328
"7154120","Anuradhapura","Kekirawa","Pothanegama","634",1727,844,883
"7154125","Anuradhapura","Kekirawa","Kuda Kekirawa","629",1526,744,782
"7154130","Anuradhapura","Kekirawa","Kekirawa Town","628",1356,830,526
"7154135","Anuradhapura","Kekirawa","Malawa","626",1462,718,744
"7154140","Anuradhapura","Kekirawa","Neekiniyawa","625",1183,581,602
"7154145","Anuradhapura","Kekirawa","Mailagaswewa","624",734,401,333
"7154150","Anuradhapura","Kekirawa","Karukkankulama","623",562,259,303
"7154155","Anuradhapura","Kekirawa","Olombewa","638",1937,898,1039
"7154160","Anuradhapura","Kekirawa","Maha Kekirawa","637",2783,1388,1395
"7154165","Anuradhapura","Kekirawa","Kumbukwewa","635",979,514,465
"7154170","Anuradhapura","Kekirawa","Rathmallewa","636",661,305,356
"7154175","Anuradhapura","Kekirawa","Medagama","640",693,351,342
"7154180","Anuradhapura","Kekirawa","Korasagalla","639",674,344,330
"7154185","Anuradhapura","Kekirawa","Unagollewa","643",838,392,446
"7154190","Anuradhapura","Kekirawa","Horapola","644",1349,667,682
"7154195","Anuradhapura","Kekirawa","Dambewatana","657",1220,609,611
"7154200","Anuradhapura","Kekirawa","Uduruwa","656",1063,500,563
"7154205","Anuradhapura","Kekirawa","Nidigama","645",1706,808,898
"7154210","Anuradhapura","Kekirawa","Maha Elagamuwa","641",1732,856,876
"7154215","Anuradhapura","Kekirawa","Pallehingura","642",667,336,331
"7154220","Anuradhapura","Kekirawa","Nelbegama","649",533,253,280
"7154225","Anuradhapura","Kekirawa","Murungahitikanda","647",1272,616,656
"7154230","Anuradhapura","Kekirawa","Baravila","646",450,207,243
"7154235","Anuradhapura","Kekirawa","Bandarapothana","655",1352,666,686
"7154240","Anuradhapura","Kekirawa","Kotagala","648",1067,544,523
"7154245","Anuradhapura","Kekirawa","Madatugama","650",1758,879,879
"7154250","Anuradhapura","Kekirawa","Dunumadalawa","654",1116,535,581
"7154255","Anuradhapura","Kekirawa","Kandalama West","653",1204,598,606
"7154260","Anuradhapura","Kekirawa","Kithulhitiyawa","652",1340,653,687
"7154265","Anuradhapura","Kekirawa","Kandalama East","651",1805,893,912
"7157005","Anuradhapura","Palugaswewa","Maithrigama","600",418,193,225
"7157010","Anuradhapura","Palugaswewa","Maha Rambawewa","599",664,321,343
"7157015","Anuradhapura","Palugaswewa","Madawala","598",965,450,515
"7157020","Anuradhapura","Palugaswewa","Eppawala","597",821,408,413
"7157025","Anuradhapura","Palugaswewa","Galapitagala","604",449,222,227
"7157030","Anuradhapura","Palugaswewa","Kumbukwewa","596",736,360,376
"7157035","Anuradhapura","Palugaswewa","Senadhiriyagama","602",811,395,416
"7157040","Anuradhapura","Palugaswewa","Horivila","603",1128,535,593
"7157045","Anuradhapura","Palugaswewa","Palugaswewa","601",1005,493,512
"7157050","Anuradhapura","Palugaswewa","Kuda Rambawewa","595",727,354,373
"7157055","Anuradhapura","Palugaswewa","Habarana","589",3466,1885,1581
"7157060","Anuradhapura","Palugaswewa","Demuththewa","594",432,220,212
"7157065","Anuradhapura","Palugaswewa","Kelewa","593",925,449,476
"7157070","Anuradhapura","Palugaswewa","Wayaulpatha","592",891,448,443
"7157075","Anuradhapura","Palugaswewa","Hiriwadunna","591",1016,505,511
"7157080","Anuradhapura","Palugaswewa","Kashyapagama","590",1128,564,564
"7160005","Anuradhapura","Ipalogama","Dikwewa - Senapura","500",1737,828,909
"7160010","Anuradhapura","Ipalogama","Galagedara Gama","512",311,150,161
"7160015","Anuradhapura","Ipalogama","Senapura Gama","504",613,306,307
"7160020","Anuradhapura","Ipalogama","Mahailuppallama","499",1323,637,686
"7160025","Anuradhapura","Ipalogama","Gonapathirawa","509",1640,756,884
"7160030","Anuradhapura","Ipalogama","Sangattewa","498",1605,785,820
"7160035","Anuradhapura","Ipalogama","Kadiyangalla","510",1470,712,758
"7160040","Anuradhapura","Ipalogama","Ipalogama","501",1272,725,547
"7160045","Anuradhapura","Ipalogama","Manewa","502",820,405,415
"7160050","Anuradhapura","Ipalogama","Heenukwe Gama","518",497,239,258
"7160055","Anuradhapura","Ipalogama","Dampelessa Gama","517",813,387,426
"7160060","Anuradhapura","Ipalogama","Ihala Kagama","519",734,345,389
"7160065","Anuradhapura","Ipalogama","Kunchikulama","514",4790,2081,2709
"7160070","Anuradhapura","Ipalogama","Hiripitiya Gama","515",1822,852,970
"7160075","Anuradhapura","Ipalogama","Aswedduma","506",819,402,417
"7160080","Anuradhapura","Ipalogama","Ganthiriya Gama","503",1149,549,600
"7160085","Anuradhapura","Ipalogama","Galwanguwa","507",1169,571,598
"7160090","Anuradhapura","Ipalogama","Wedinigama","511",966,460,506
"7160095","Anuradhapura","Ipalogama","Narangalle Gama","505",892,398,494
"7160100","Anuradhapura","Ipalogama","Kallanchiya Gama","508",1405,658,747
"7160105","Anuradhapura","Ipalogama","Aluth Dambewatana","513",476,218,258
"7160110","Anuradhapura","Ipalogama","Kagama 5 Ela","497",983,478,505
"7160115","Anuradhapura","Ipalogama","2 Ela - Kagama","496",732,337,395
"7160120","Anuradhapura","Ipalogama","Akkara 500","495",914,415,499
"7160125","Anuradhapura","Ipalogama","Amunuwetiya","492",1052,486,566
"7160130","Anuradhapura","Ipalogama","Puliyankulama","516",1698,846,852
"7160135","Anuradhapura","Ipalogama","Vijithapura","493",1248,636,612
"7160140","Anuradhapura","Ipalogama","Amanakkattuwa","494",265,124,141
"7160145","Anuradhapura","Ipalogama","Kalawewa","490",949,484,465
"7160150","Anuradhapura","Ipalogama","Kusalana Gama","491",1529,696,833
"7160155","Anuradhapura","Ipalogama","Palugaswewa Farm","489",1297,620,677
"7160160","Anuradhapura","Ipalogama","Walawwegama","488",1872,931,941
"7163005","Anuradhapura","Galnewa","Namalgamuwa","487A",1216,579,637
"7163010","Anuradhapura","Galnewa","Obadayagama","486",1332,653,679
"7163015","Anuradhapura","Galnewa","Otunupelandigama","484",1558,770,788
"7163020","Anuradhapura","Galnewa","Karuwalagaswewa","481",2079,1030,1049
"7163025","Anuradhapura","Galnewa","Usgala Halmillawewa","482",1227,605,622
"7163030","Anuradhapura","Galnewa","Helabodu Gama","478",1764,841,923
"7163035","Anuradhapura","Galnewa","Kattaragama","470",1173,545,628
"7163040","Anuradhapura","Galnewa","Bulnewa","479",1808,853,955
"7163045","Anuradhapura","Galnewa","Thorane Gama","480",1294,627,667
"7163050","Anuradhapura","Galnewa","Midellewa","483",1759,804,955
"7163055","Anuradhapura","Galnewa","Ihala Kalankuttiya","485",1447,700,747
"7163060","Anuradhapura","Galnewa","Pahala Kalankuttiya","487",1377,654,723
"7163065","Anuradhapura","Galnewa","Siyambalewa","468",796,393,403
"7163070","Anuradhapura","Galnewa","Lolugaswewa","469",1112,543,569
"7163075","Anuradhapura","Galnewa","Pitiye Yaya","471",1208,571,637
"7163080","Anuradhapura","Galnewa","Galnewa Gama","472",1110,552,558
"7163085","Anuradhapura","Galnewa","Galnewa Town","477",710,374,336
"7163090","Anuradhapura","Galnewa","Malbaligala","475",1647,760,887
"7163095","Anuradhapura","Galnewa","Hadungama","476",1105,532,573
"7163100","Anuradhapura","Galnewa","Musnawa","473",606,279,327
"7163105","Anuradhapura","Galnewa","Kala - Medawachchiya","466",1173,596,577
"7163110","Anuradhapura","Galnewa","Kumbukwewa","467",249,119,130
"7163115","Anuradhapura","Galnewa","Kallanchiya","465",618,288,330
"7163120","Anuradhapura","Galnewa","Negama","462",1282,572,710
"7163125","Anuradhapura","Galnewa","Verunkulama","461",1127,503,624
"7163130","Anuradhapura","Galnewa","Walaswewa","474",2060,1007,1053
"7163135","Anuradhapura","Galnewa","Kande Gama","459",554,271,283
"7163140","Anuradhapura","Galnewa","Kandule Gama","460",244,126,118
"7163145","Anuradhapura","Galnewa","Kandulugamuwa","464",530,265,265
"7163150","Anuradhapura","Galnewa","Siyambalangamuwa South","463",591,281,310
"7166005","Anuradhapura","Palagala","Nelliyagama","688",1112,557,555
"7166010","Anuradhapura","Palagala","Balaluwewa 2","687",946,439,507
"7166015","Anuradhapura","Palagala","Balaluwewa","686",779,367,412
"7166020","Anuradhapura","Palagala","Pahalagama","689",640,300,340
"7166025","Anuradhapura","Palagala","Karavilagala","690",398,191,207
"7166030","Anuradhapura","Palagala","Gam Sabha Halmilla Wewa","691",1180,574,606
"7166035","Anuradhapura","Palagala","Gonadeniyagama","692",959,458,501
"7166040","Anuradhapura","Palagala","Meewewa","678",431,237,194
"7166045","Anuradhapura","Palagala","Ambagaswewa","667",595,285,310
"7166050","Anuradhapura","Palagala","Wambatuwewa","666",665,318,347
"7166055","Anuradhapura","Palagala","Hinguruwewa","679",783,371,412
"7166060","Anuradhapura","Palagala","Kirindiwatta","677",826,372,454
"7166065","Anuradhapura","Palagala","Aluth Galkiriyagama","680",1173,557,616
"7166070","Anuradhapura","Palagala","Daniyagama","681",1139,551,588
"7166075","Anuradhapura","Palagala","Undurawa Halmilla Wewa","685",691,348,343
"7166080","Anuradhapura","Palagala","Katukeliyawa","683",1151,552,599
"7166085","Anuradhapura","Palagala","Aluth Kadadugama","684",1159,560,599
"7166090","Anuradhapura","Palagala","Ranawa","662",1611,793,818
"7166095","Anuradhapura","Palagala","Hinguruwelpitiya","663",1069,554,515
"7166100","Anuradhapura","Palagala","Anakatawewa","659",1571,796,775
"7166105","Anuradhapura","Palagala","Giranegama","658",2185,1098,1087
"7166110","Anuradhapura","Palagala","Dambulu Halmilla Wewa","661",1319,669,650
"7166115","Anuradhapura","Palagala","Narangaswewa","660",1183,588,595
"7166120","Anuradhapura","Palagala","Ulpathagama","682",1147,559,588
"7166125","Anuradhapura","Palagala","Ellawewa","675",971,480,491
"7166130","Anuradhapura","Palagala","Andiyagala","670",932,444,488
"7166135","Anuradhapura","Palagala","Maneruwa","665",693,332,361
"7166140","Anuradhapura","Palagala","Ipulwehera","664",840,401,439
"7166145","Anuradhapura","Palagala","Gambirigaswewa","671",634,307,327
"7166150","Anuradhapura","Palagala","Parawahagama","669",920,441,479
"7166155","Anuradhapura","Palagala","Kalugala","668",1172,606,566
"7166160","Anuradhapura","Palagala","Pelbendiyawa","674",674,316,358
"7166165","Anuradhapura","Palagala","Morotte Gama","676",907,438,469
"7166170","Anuradhapura","Palagala","Dembatagolla Gama","672",761,375,386
"7166175","Anuradhapura","Palagala","Budugehinna","673",786,386,400
"7203005","Polonnaruwa","Hingurakgoda","Sinhagama","31",1410,724,686
"7203010","Polonnaruwa","Hingurakgoda","Galoya","32",1468,743,725
"7203015","Polonnaruwa","Hingurakgoda","Rotawewa","34",1348,656,692
"7203020","Polonnaruwa","Hingurakgoda","Rathmale","33",844,407,437
"7203025","Polonnaruwa","Hingurakgoda","Paluwaddana","35",778,361,417
"7203030","Polonnaruwa","Hingurakgoda","Yodha Ela","63",1819,851,968
"7203035","Polonnaruwa","Hingurakgoda","Yatiyalpathana","61",1483,717,766
"7203040","Polonnaruwa","Hingurakgoda","Rankothgama","62",1254,610,644
"7203045","Polonnaruwa","Hingurakgoda","Siriketha","73",1058,514,544
"7203050","Polonnaruwa","Hingurakgoda","Kumaragama","72",963,475,488
"7203055","Polonnaruwa","Hingurakgoda","Samapura","80",1794,856,938
"7203060","Polonnaruwa","Hingurakgoda","Kimbulawala","68",1240,585,655
"7203065","Polonnaruwa","Hingurakgoda","Ulpathwewa","67",1187,579,608
"7203070","Polonnaruwa","Hingurakgoda","Minihirigama","60",923,475,448
"7203075","Polonnaruwa","Hingurakgoda","Moragaswewa","29",2202,1064,1138
"7203080","Polonnaruwa","Hingurakgoda","Mahasengama","30",863,443,420
"7203085","Polonnaruwa","Hingurakgoda","Bathgampattuwa","58",1504,726,778
"7203090","Polonnaruwa","Hingurakgoda","Samagipura","57",1888,929,959
"7203095","Polonnaruwa","Hingurakgoda","Minneriya","56",758,407,351
"7203100","Polonnaruwa","Hingurakgoda","Pasiyawewa","65",1238,617,621
"7203105","Polonnaruwa","Hingurakgoda","Akkara 70","64",1485,715,770
"7203110","Polonnaruwa","Hingurakgoda","R.B. 01","76",1770,823,947
"7203115","Polonnaruwa","Hingurakgoda","Pulathisigama","75",1049,505,544
"7203120","Polonnaruwa","Hingurakgoda","Ulkatupotha","77",2383,1145,1238
"7203125","Polonnaruwa","Hingurakgoda","Bopura","79",1498,741,757
"7203130","Polonnaruwa","Hingurakgoda","Jayapura","78",1130,561,569
"7203135","Polonnaruwa","Hingurakgoda","Hinguraka Bandaragama","71",1008,467,541
"7203140","Polonnaruwa","Hingurakgoda","Hinguraka","69",818,366,452
"7203145","Polonnaruwa","Hingurakgoda","Hathamuna","70",1457,720,737
"7203150","Polonnaruwa","Hingurakgoda","Hingurakgoda","74",776,441,335
"7203155","Polonnaruwa","Hingurakgoda","Bubula","66",828,414,414
"7203160","Polonnaruwa","Hingurakgoda","Raja Ela","38",1365,670,695
"7203165","Polonnaruwa","Hingurakgoda","Raja Ela Gama","37",1028,499,529
"7203170","Polonnaruwa","Hingurakgoda","Muwanpelessa","59",965,475,490
"7203175","Polonnaruwa","Hingurakgoda","C.P. Pura","54",1361,814,547
"7203180","Polonnaruwa","Hingurakgoda","Girithale","36",1030,497,533
"7203185","Polonnaruwa","Hingurakgoda","Girithale Puranagama","39",715,376,339
"7203190","Polonnaruwa","Hingurakgoda","Girithale Colony","40",1361,667,694
"7203195","Polonnaruwa","Hingurakgoda","Henkolawela","43",1117,559,558
"7203200","Polonnaruwa","Hingurakgoda","Jayanthipura","48",1496,714,782
"7203205","Polonnaruwa","Hingurakgoda","Unagalavehera West","51",1562,760,802
"7203210","Polonnaruwa","Hingurakgoda","Unagalavehera East","52",847,425,422
"7203215","Polonnaruwa","Hingurakgoda","Chandana Pokuna","53",1253,612,641
"7203220","Polonnaruwa","Hingurakgoda","Nagapokuna","49",963,476,487
"7203225","Polonnaruwa","Hingurakgoda","Track 12 Pedesa","50",1167,573,594
"7203230","Polonnaruwa","Hingurakgoda","Chethiyagirigama","47",873,420,453
"7203235","Polonnaruwa","Hingurakgoda","Weeragama","44",772,361,411
"7203240","Polonnaruwa","Hingurakgoda","Track 05 Pedesa","45",861,423,438
"7203245","Polonnaruwa","Hingurakgoda","Wijayaraja Wewa","42",1275,612,663
"7203250","Polonnaruwa","Hingurakgoda","Agbopura","41",1414,696,718
"7203255","Polonnaruwa","Hingurakgoda","Katukeliyawa","55",778,398,380
"7203260","Polonnaruwa","Hingurakgoda","Sudukanda - Nikawewa","46",845,431,414
"7203265","Polonnaruwa","Hingurakgoda","Thambalawewa","46A",1017,479,538
"7206005","Polonnaruwa","Medirigiriya","Wedikachchiya","97",1611,834,777
"7206010","Polonnaruwa","Medirigiriya","Jayathugama","105",1310,660,650
"7206015","Polonnaruwa","Medirigiriya","Ekamuthugama","104",1182,583,599
"7206020","Polonnaruwa","Medirigiriya","Meegaswewa","121",1695,862,833
"7206025","Polonnaruwa","Medirigiriya","Palliyagodella","122",579,295,284
"7206030","Polonnaruwa","Medirigiriya","Wadigawewa","120",1229,629,600
"7206035","Polonnaruwa","Medirigiriya","Senarathpura","106",2029,1000,1029
"7206040","Polonnaruwa","Medirigiriya","Etambaoya","98",1051,486,565
"7206045","Polonnaruwa","Medirigiriya","Kavuduluwewa (Ralapanawa)","92",2006,994,1012
"7206050","Polonnaruwa","Medirigiriya","Meniksorowwa","95",862,413,449
"7206055","Polonnaruwa","Medirigiriya","Bisobandara","113",1666,828,838
"7206060","Polonnaruwa","Medirigiriya","Thissapura","114",958,484,474
"7206065","Polonnaruwa","Medirigiriya","Abhayapuragama","94",1705,823,882
"7206070","Polonnaruwa","Medirigiriya","New Town","93",2243,1085,1158
"7206075","Polonnaruwa","Medirigiriya","Diggalpura","96",1470,705,765
"7206080","Polonnaruwa","Medirigiriya","Wedehapura","99",1108,500,608
"7206085","Polonnaruwa","Medirigiriya","Bisobandara Gama","100",1618,810,808
"7206090","Polonnaruwa","Medirigiriya","Ambagaswewa","103",2079,952,1127
"7206095","Polonnaruwa","Medirigiriya","Jayagampura","102",609,306,303
"7206100","Polonnaruwa","Medirigiriya","Nagarapura","101",1102,547,555
"7206105","Polonnaruwa","Medirigiriya","Kumudupura","107",971,526,445
"7206110","Polonnaruwa","Medirigiriya","Damsopura","110",1839,920,919
"7206115","Polonnaruwa","Medirigiriya","Aluthwewa","112",1344,672,672
"7206120","Polonnaruwa","Medirigiriya","Thalakolawewa","111",1495,741,754
"7206125","Polonnaruwa","Medirigiriya","Ihalagama","109",1867,889,978
"7206130","Polonnaruwa","Medirigiriya","Wijayapura","108",1006,479,527
"7206135","Polonnaruwa","Medirigiriya","Bisouyana","89",1495,706,789
"7206140","Polonnaruwa","Medirigiriya","Diyasenpura","88",1828,896,932
"7206145","Polonnaruwa","Medirigiriya","Gajabapura","86",1767,855,912
"7206150","Polonnaruwa","Medirigiriya","Kavudulugama","91",1040,476,564
"7206155","Polonnaruwa","Medirigiriya","Mandalagiriya","115",1291,653,638
"7206160","Polonnaruwa","Medirigiriya","Medirigiriya","87",2828,1453,1375
"7206165","Polonnaruwa","Medirigiriya","Viharagama","83",1852,909,943
"7206170","Polonnaruwa","Medirigiriya","Divulankadawala","84",1368,672,696
"7206175","Polonnaruwa","Medirigiriya","Nelumpokuna","82",1154,559,595
"7206180","Polonnaruwa","Medirigiriya","Thissa Amuna","116",1688,824,864
"7206185","Polonnaruwa","Medirigiriya","Kusumpokuna","118",1400,669,731
"7206190","Polonnaruwa","Medirigiriya","Wijayarajapura","119",948,470,478
"7206195","Polonnaruwa","Medirigiriya","Perakumpura","85",1418,670,748
"7206200","Polonnaruwa","Medirigiriya","Kahambiliyawa","90",1455,724,731
"7206205","Polonnaruwa","Medirigiriya","Akbarpura","123",588,298,290
"7206210","Polonnaruwa","Medirigiriya","Sansungama","125",1218,601,617
"7206215","Polonnaruwa","Medirigiriya","Veheragala","124",1481,734,747
"7206220","Polonnaruwa","Medirigiriya","Mahasenpura","117",1326,635,691
"7206225","Polonnaruwa","Medirigiriya","Yudhaganawa","81",2796,1345,1451
"7209005","Polonnaruwa","Lankapura","Weli Ela","149",1242,605,637
"7209010","Polonnaruwa","Lankapura","Maha Kirimetiya","150",919,449,470
"7209015","Polonnaruwa","Lankapura","Buddhayaya","151",1123,530,593
"7209020","Polonnaruwa","Lankapura","Sungavila","137",1021,484,537
"7209025","Polonnaruwa","Lankapura","Jayabima","138",486,246,240
"7209030","Polonnaruwa","Lankapura","Jayapura","136A",2227,1101,1126
"7209035","Polonnaruwa","Lankapura","Nelumpura","136",1369,635,734
"7209040","Polonnaruwa","Lankapura","Patunugama","139",1100,551,549
"7209045","Polonnaruwa","Lankapura","Munisirigama","152",1003,504,499
"7209050","Polonnaruwa","Lankapura","Pansalgodella","148",1270,617,653
"7209055","Polonnaruwa","Lankapura","Galamuna","147",699,339,360
"7209060","Polonnaruwa","Lankapura","Hingurakdamana","146",1121,550,571
"7209065","Polonnaruwa","Lankapura","Gemunupura","145",1612,769,843
"7209070","Polonnaruwa","Lankapura","Senanayakapura","144",1001,482,519
"7209075","Polonnaruwa","Lankapura","Debarella","143",1382,665,717
"7209080","Polonnaruwa","Lankapura","Somapura","141",1365,642,723
"7209085","Polonnaruwa","Lankapura","Abhayapura","140",1539,765,774
"7209090","Polonnaruwa","Lankapura","Sanghabodhi Gama","134",1127,579,548
"7209095","Polonnaruwa","Lankapura","Pulasthigama","135",1473,719,754
"7209100","Polonnaruwa","Lankapura","Kegalugama","142",1422,700,722
"7209105","Polonnaruwa","Lankapura","Thalpotha","126",1049,521,528
"7209110","Polonnaruwa","Lankapura","Bauddhartha Gama","127",1737,846,891
"7209115","Polonnaruwa","Lankapura","Lankapura","128",1372,671,701
"7209120","Polonnaruwa","Lankapura","Rifaipura","130",1727,805,922
"7209125","Polonnaruwa","Lankapura","Alhilalpura","133",2434,1139,1295
"7209130","Polonnaruwa","Lankapura","Thambala","132",2053,942,1111
"7209135","Polonnaruwa","Lankapura","Onegama Muslimgama","131",126,68,58
"7209140","Polonnaruwa","Lankapura","Weerapura","129",1453,697,756
"7210005","Polonnaruwa","Welikanda","Sinhapura","286",2900,1520,1380
"7210010","Polonnaruwa","Welikanda","Kandakaduwa","283",527,357,170
"7210015","Polonnaruwa","Welikanda","Katuwanvila West","267",919,436,483
"7210020","Polonnaruwa","Welikanda","Katuwanvila East","268",1559,748,811
"7210025","Polonnaruwa","Welikanda","Kudapokuna","284",701,354,347
"7210030","Polonnaruwa","Welikanda","Muthuwella","285",582,289,293
"7210035","Polonnaruwa","Welikanda","Mahindagama","282",5300,2729,2571
"7210040","Polonnaruwa","Welikanda","Mangulpokuna","279",1815,908,907
"7210045","Polonnaruwa","Welikanda","Ruhunuketha","276",551,272,279
"7210050","Polonnaruwa","Welikanda","Malvila","270",407,201,206
"7210055","Polonnaruwa","Welikanda","Senapura","266",1702,984,718
"7210060","Polonnaruwa","Welikanda","Muthugala","264",814,397,417
"7210065","Polonnaruwa","Welikanda","Alinchipothana","265",0,0,0
"7210070","Polonnaruwa","Welikanda","Madurangala","269",844,416,428
"7210075","Polonnaruwa","Welikanda","Malinda","271",470,233,237
"7210080","Polonnaruwa","Welikanda","Sandunpitiya","272",1353,679,674
"7210085","Polonnaruwa","Welikanda","Susirigama","277",1075,528,547
"7210090","Polonnaruwa","Welikanda","Monarathenna","280",724,369,355
"7210095","Polonnaruwa","Welikanda","Welikanda","278",1105,662,443
"7210100","Polonnaruwa","Welikanda","Kadawathmaduwa","281",892,440,452
"7210105","Polonnaruwa","Welikanda","Bo-Atta","275",697,360,337
"7210110","Polonnaruwa","Welikanda","Menikwela","274",857,430,427
"7210115","Polonnaruwa","Welikanda","Sevanapitiya","261",1106,568,538
"7210120","Polonnaruwa","Welikanda","Mahawewa","262",1494,763,731
"7210125","Polonnaruwa","Welikanda","Karapola","263",1405,671,734
"7210130","Polonnaruwa","Welikanda","Ginidamana","260",947,475,472
"7210135","Polonnaruwa","Welikanda","Borawewa","273",653,331,322
"7210140","Polonnaruwa","Welikanda","Nelumwewa","259",739,363,376
"7210145","Polonnaruwa","Welikanda","Rideepokuna","258",597,282,315
"7210150","Polonnaruwa","Welikanda","Aluthwewa","287",1035,520,515
"7212005","Polonnaruwa","Dimbulagala","Manampitiya","207",1911,1004,907
"7212010","Polonnaruwa","Dimbulagala","Manampitiya East","208",2143,1076,1067
"7212015","Polonnaruwa","Dimbulagala","Dalukana","210",1407,696,711
"7212020","Polonnaruwa","Dimbulagala","Kudawewa","209",1240,624,616
"7212025","Polonnaruwa","Dimbulagala","Medagama","256",1472,704,768
"7212030","Polonnaruwa","Dimbulagala","Jayapura","257",1277,642,635
"7212035","Polonnaruwa","Dimbulagala","Wijayabapura","254",2029,985,1044
"7212040","Polonnaruwa","Dimbulagala","Veheragama","253",1014,508,506
"7212045","Polonnaruwa","Dimbulagala","Millana","212",831,398,433
"7212050","Polonnaruwa","Dimbulagala","Dimbulagala","211",2012,1058,954
"7212055","Polonnaruwa","Dimbulagala","Yakkure","221",774,386,388
"7212060","Polonnaruwa","Dimbulagala","Damanewewa","225",953,484,469
"7212065","Polonnaruwa","Dimbulagala","Pihitiwewa","222",1094,568,526
"7212070","Polonnaruwa","Dimbulagala","Pahala Yakkure","223",1203,626,577
"7212075","Polonnaruwa","Dimbulagala","Maguldamana","214",1657,846,811
"7212080","Polonnaruwa","Dimbulagala","Pelatiyawa","213",1755,878,877
"7212085","Polonnaruwa","Dimbulagala","Mahaulpatha","251",753,383,370
"7212090","Polonnaruwa","Dimbulagala","Bogaswewa","252",1277,635,642
"7212095","Polonnaruwa","Dimbulagala","Rathmalthenna","247",1413,703,710
"7212100","Polonnaruwa","Dimbulagala","Track 05 Aralaganvila","248",1117,546,571
"7212105","Polonnaruwa","Dimbulagala","Gomathiyaya","255",797,399,398
"7212110","Polonnaruwa","Dimbulagala","Arunapura","241",555,277,278
"7212115","Polonnaruwa","Dimbulagala","Aralaganvila","245",1820,921,899
"7212120","Polonnaruwa","Dimbulagala","Aralaganvila West","246",2716,1334,1382
"7212125","Polonnaruwa","Dimbulagala","Weerana","250",949,489,460
"7212130","Polonnaruwa","Dimbulagala","Bimpokuna","249",1170,585,585
"7212135","Polonnaruwa","Dimbulagala","Pahala Ellewewa","215",1434,745,689
"7212140","Polonnaruwa","Dimbulagala","Kalukele","217",2317,1153,1164
"7212145","Polonnaruwa","Dimbulagala","Navagaha Ela","226",1003,504,499
"7212150","Polonnaruwa","Dimbulagala","Nuwaragala","224",1105,537,568
"7212155","Polonnaruwa","Dimbulagala","Bandanagala","219",1281,635,646
"7212160","Polonnaruwa","Dimbulagala","Ellewewa","216",2055,1042,1013
"7212165","Polonnaruwa","Dimbulagala","Ihala Ellewewa","218",1943,967,976
"7212170","Polonnaruwa","Dimbulagala","Mahadamana","220",1357,653,704
"7212175","Polonnaruwa","Dimbulagala","Pimburattewa West","238",1038,513,525
"7212180","Polonnaruwa","Dimbulagala","Divuldamana","242",1564,762,802
"7212185","Polonnaruwa","Dimbulagala","Nidanwala","244",686,348,338
"7212190","Polonnaruwa","Dimbulagala","Ihalawewa","243",1317,625,692
"7212195","Polonnaruwa","Dimbulagala","Pimburattewa East","236",1631,806,825
"7212200","Polonnaruwa","Dimbulagala","Aluthoya","237",1642,785,857
"7212205","Polonnaruwa","Dimbulagala","Veheragala","234",1125,565,560
"7212210","Polonnaruwa","Dimbulagala","Warapitiya","235",2565,1341,1224
"7212215","Polonnaruwa","Dimbulagala","Gal Eliya","233",841,422,419
"7212220","Polonnaruwa","Dimbulagala","Weeralanda","232",700,362,338
"7212225","Polonnaruwa","Dimbulagala","Sandagalathenna","231",2046,1019,1027
"7212230","Polonnaruwa","Dimbulagala","Ulpathwewa","229",767,386,381
"7212235","Polonnaruwa","Dimbulagala","Alawakumbura","239",2151,1128,1023
"7212240","Polonnaruwa","Dimbulagala","Kandegama","240",1567,819,748
"7212245","Polonnaruwa","Dimbulagala","Kanichchagala","227",873,441,432
"7212250","Polonnaruwa","Dimbulagala","Kekulawela","228",1254,616,638
"7212255","Polonnaruwa","Dimbulagala","Maldeniya","230",649,331,318
"7212260","Polonnaruwa","Dimbulagala","Mewathpura","294",1846,908,938
"7212265","Polonnaruwa","Dimbulagala","Rankethgama","297",1958,980,978
"7212270","Polonnaruwa","Dimbulagala","Mudungama","298",2160,1053,1107
"7212275","Polonnaruwa","Dimbulagala","Siripura","299",2239,1110,1129
"7212280","Polonnaruwa","Dimbulagala","Selasumgama","300",1208,592,616
"7215005","Polonnaruwa","Thamankaduwa","Shanthi Pura","206",1453,710,743
"7215010","Polonnaruwa","Thamankaduwa","Sinha Pura","204",1100,528,572
"7215015","Polonnaruwa","Thamankaduwa","Wijayabahu Pura","203",949,441,508
"7215020","Polonnaruwa","Thamankaduwa","Unagalavehera South","205",939,479,460
"7215025","Polonnaruwa","Thamankaduwa","Laksha Uyana","198",1856,900,956
"7215030","Polonnaruwa","Thamankaduwa","Sevagama","200",1627,799,828
"7215035","Polonnaruwa","Thamankaduwa","Wewethenna","201",900,428,472
"7215040","Polonnaruwa","Thamankaduwa","Monarathenna","202",1198,588,610
"7215045","Polonnaruwa","Thamankaduwa","Damana Gemunupura","191",1017,519,498
"7215050","Polonnaruwa","Thamankaduwa","Kalinga Ela","190",1520,733,787
"7215055","Polonnaruwa","Thamankaduwa","Onegama","195",905,449,456
"7215060","Polonnaruwa","Thamankaduwa","Sinharajapura","194",1128,562,566
"7215065","Polonnaruwa","Thamankaduwa","Pudur","193",585,275,310
"7215070","Polonnaruwa","Thamankaduwa","Medamaluwa","197",1124,562,562
"7215075","Polonnaruwa","Thamankaduwa","Wijayaraja Pura","196",1046,513,533
"7215080","Polonnaruwa","Thamankaduwa","Palugasdamana 03 Ela","175",1003,515,488
"7215085","Polonnaruwa","Thamankaduwa","Palugasdamana 02 Ela","174",1558,777,781
"7215090","Polonnaruwa","Thamankaduwa","Palugasdamana 01 Ela","173",930,455,475
"7215095","Polonnaruwa","Thamankaduwa","Palugasdamana South","177",1104,540,564
"7215100","Polonnaruwa","Thamankaduwa","Palugasdamana North","176",849,441,408
"7215105","Polonnaruwa","Thamankaduwa","Nishshankamallapura","199",1998,951,1047
"7215110","Polonnaruwa","Thamankaduwa","Ethumalpitiya","155",1799,907,892
"7215115","Polonnaruwa","Thamankaduwa","Nikawewa","156",1250,632,618
"7215120","Polonnaruwa","Thamankaduwa","Kadawala Wewa","158",1590,771,819
"7215125","Polonnaruwa","Thamankaduwa","Samudragama","154",1435,704,731
"7215130","Polonnaruwa","Thamankaduwa","Sirisangabo Pedesa","155A",2349,1150,1199
"7215135","Polonnaruwa","Thamankaduwa","Bendiwewa","153",1173,651,522
"7215140","Polonnaruwa","Thamankaduwa","Galthambarawa","178",835,404,431
"7215145","Polonnaruwa","Thamankaduwa","Kuruppu Junction","179",1205,588,617
"7215150","Polonnaruwa","Thamankaduwa","Mahasen Pedesa","180",1148,569,579
"7215155","Polonnaruwa","Thamankaduwa","Kaduruwela West","183",1357,770,587
"7215160","Polonnaruwa","Thamankaduwa","Kaduruwela East","186",1703,906,797
"7215165","Polonnaruwa","Thamankaduwa","Divulana","192",996,469,527
"7215170","Polonnaruwa","Thamankaduwa","Gallella","187",1856,917,939
"7215175","Polonnaruwa","Thamankaduwa","Manikkampattiya","181",1755,825,930
"7215180","Polonnaruwa","Thamankaduwa","Gallella West","188",1175,610,565
"7215185","Polonnaruwa","Thamankaduwa","Nelumvila","182",1528,746,782
"7215190","Polonnaruwa","Thamankaduwa","Kaduruwela South","184",5118,2438,2680
"7215195","Polonnaruwa","Thamankaduwa","Perakum Pedesa","185",1643,791,852
"7215200","Polonnaruwa","Thamankaduwa","Weera Pedesa","162",2364,1123,1241
"7215205","Polonnaruwa","Thamankaduwa","Pulathisi Pedesa","163",1477,733,744
"7215210","Polonnaruwa","Thamankaduwa","Polonnaruwa Town","172",2600,1283,1317
"7215215","Polonnaruwa","Thamankaduwa","Thopawewa","171",1470,744,726
"7215220","Polonnaruwa","Thamankaduwa","Sinha Udagama","157",2005,984,1021
"7215225","Polonnaruwa","Thamankaduwa","Pothgul Pedesa","167",2122,1090,1032
"7215230","Polonnaruwa","Thamankaduwa","Udawela","168",2077,1137,940
"7215235","Polonnaruwa","Thamankaduwa","Ganangolla","161",2472,1184,1288
"7215240","Polonnaruwa","Thamankaduwa","Nishshankamalla Pedesa","170",1782,835,947
"7215245","Polonnaruwa","Thamankaduwa","Mahaweli Pedesa","169",1482,705,777
"7215250","Polonnaruwa","Thamankaduwa","Kotaleeya","189",1330,571,759
"7215255","Polonnaruwa","Thamankaduwa","Aluth Wewa East","159",844,416,428
"7215260","Polonnaruwa","Thamankaduwa","Aluth Wewa West","160",856,413,443
"7215265","Polonnaruwa","Thamankaduwa","Parakrama Samudraya","164",901,442,459
"7215270","Polonnaruwa","Thamankaduwa","Ambanganga","165",1962,977,985
"7215275","Polonnaruwa","Thamankaduwa","Kalahagala","166",1978,983,995
"7218005","Polonnaruwa","Elahera","Ihakuluwewa","27",1780,882,898
"7218010","Polonnaruwa","Elahera","Katukeliyawa","28",1641,804,837
"7218015","Polonnaruwa","Elahera","Diyabeduma","26",3176,1570,1606
"7218020","Polonnaruwa","Elahera","Konduruwawa","25",1517,761,756
"7218025","Polonnaruwa","Elahera","Attanakadawala West","20",726,356,370
"7218030","Polonnaruwa","Elahera","Radavigeoya","23",1301,643,658
"7218035","Polonnaruwa","Elahera","Madudamana","22",1454,697,757
"7218040","Polonnaruwa","Elahera","Attanakadawala North","19",1832,903,929
"7218045","Polonnaruwa","Elahera","Attanakadawala South","18",1033,497,536
"7218050","Polonnaruwa","Elahera","Ikiriwewa","21",2245,1098,1147
"7218055","Polonnaruwa","Elahera","Kahatagahapitiya","24",1841,917,924
"7218060","Polonnaruwa","Elahera","Nikapitiya","16",1882,902,980
"7218065","Polonnaruwa","Elahera","Sarubima","17",1601,804,797
"7218070","Polonnaruwa","Elahera","Segala","15",1692,836,856
"7218075","Polonnaruwa","Elahera","Kottapitiya South","10",1404,673,731
"7218080","Polonnaruwa","Elahera","Somils","14",712,347,365
"7218085","Polonnaruwa","Elahera","Gangeyaya","13",1191,588,603
"7218090","Polonnaruwa","Elahera","Kottapitiya North","11",909,463,446
"7218095","Polonnaruwa","Elahera","Damanayaya","8",1920,925,995
"7218100","Polonnaruwa","Elahera","Elahera","3",2336,1182,1154
"7218105","Polonnaruwa","Elahera","Heeratiya","5",703,343,360
"7218110","Polonnaruwa","Elahera","Bakamoona","7",2136,1061,1075
"7218115","Polonnaruwa","Elahera","Sirikanduruyaya","12",775,353,422
"7218120","Polonnaruwa","Elahera","Atharagallewa","2",2336,1126,1210
"7218125","Polonnaruwa","Elahera","Maluweyaya","9",2436,1216,1220
"7218130","Polonnaruwa","Elahera","Orubendi Siyambalawa","4",1463,695,768
"7218135","Polonnaruwa","Elahera","Kumara Ella","6",842,404,438
"7218140","Polonnaruwa","Elahera","Kirioya","1",1031,546,485
"4103005","Jaffna","Island North (Kayts)","Analaitivu North","J/37",840,418,422
"4103010","Jaffna","Island North (Kayts)","Analaitivu South","J/38",941,460,481
"4103015","Jaffna","Island North (Kayts)","Eluvaitivu","J/39",555,264,291
"4103020","Jaffna","Island North (Kayts)","Paruthiyadaippu","J/50",578,259,319
"4103025","Jaffna","Island North (Kayts)","Kayts","J/49",559,294,265
"4103030","Jaffna","Island North (Kayts)","Karampon","J/51",932,442,490
"4103035","Jaffna","Island North (Kayts)","Karampon East","J/52",463,218,245
"4103040","Jaffna","Island North (Kayts)","Naranthanai North West","J/56",1065,493,572
"4103045","Jaffna","Island North (Kayts)","Naranthanai North","J/55",327,155,172
"4103050","Jaffna","Island North (Kayts)","Naranthanai","J/57",564,265,299
"4103055","Jaffna","Island North (Kayts)","Naranthanai South","J/58",614,270,344
"4103060","Jaffna","Island North (Kayts)","Karampon South East","J/53",246,95,151
"4103065","Jaffna","Island North (Kayts)","Karampon West","J/54",791,397,394
"4103070","Jaffna","Island North (Kayts)","Puliyankoodal","J/60",1108,516,592
"4103075","Jaffna","Island North (Kayts)","Suruvil","J/59",293,137,156
"4104005","Jaffna","Karainagar","Karainagar North","J/46",611,276,335
"4104010","Jaffna","Karainagar","Karainagar North East","J/47",1604,746,858
"4104015","Jaffna","Karainagar","Karainagar East","J/42",1466,683,783
"4104020","Jaffna","Karainagar","Karainagar Centre","J/48",1416,635,781
"4104025","Jaffna","Karainagar","Karainagar North West","J/41",334,139,195
"4104030","Jaffna","Karainagar","Karainagar West","J/40",1447,672,775
"4104035","Jaffna","Karainagar","Karainagar South East","J/43",406,182,224
"4104040","Jaffna","Karainagar","Karainagar South","J/44",1250,568,682
"4104045","Jaffna","Karainagar","Karainagar South West","J/45",1042,478,564
"4106005","Jaffna","Valikamam West (Chankanai)","Vedducoddai East","J/157",1655,735,920
"4106010","Jaffna","Valikamam West (Chankanai)","Vedducoddai North","J/158",1341,600,741
"4106015","Jaffna","Valikamam West (Chankanai)","Sangarathai","J/159",1851,864,987
"4106020","Jaffna","Valikamam West (Chankanai)","Arali West","J/160",1245,599,646
"4106025","Jaffna","Valikamam West (Chankanai)","Arali Centre","J/161",1968,942,1026
"4106030","Jaffna","Valikamam West (Chankanai)","Arali South","J/162",2340,1112,1228
"4106035","Jaffna","Valikamam West (Chankanai)","Arali East","J/163",2067,966,1101
"4106040","Jaffna","Valikamam West (Chankanai)","Arali North","J/164",1852,868,984
"4106045","Jaffna","Valikamam West (Chankanai)","Vedducoddai South","J/165",2860,1357,1503
"4106050","Jaffna","Valikamam West (Chankanai)","Vedducoddai South West (North)","J/166",1430,698,732
"4106055","Jaffna","Valikamam West (Chankanai)","Vedducoddai  West","J/167",1365,617,748
"4106060","Jaffna","Valikamam West (Chankanai)","Tholpuram East","J/168",1243,576,667
"4106065","Jaffna","Valikamam West (Chankanai)","Tholpuram  West","J/169",2397,1135,1262
"4106070","Jaffna","Valikamam West (Chankanai)","Ponnalai","J/170",1166,540,626
"4106075","Jaffna","Valikamam West (Chankanai)","Moolai","J/171",3178,1536,1642
"4106080","Jaffna","Valikamam West (Chankanai)","Chulipuram West","J/172",2122,978,1144
"4106085","Jaffna","Valikamam West (Chankanai)","Chulipuram  Centre","J/173",1660,765,895
"4106090","Jaffna","Valikamam West (Chankanai)","Chulipuram  East","J/174",2747,1295,1452
"4106095","Jaffna","Valikamam West (Chankanai)","Pannakam","J/175",1602,766,836
"4106100","Jaffna","Valikamam West (Chankanai)","Paníippulam","J/176",1293,561,732
"4106105","Jaffna","Valikamam West (Chankanai)","Siththankerni","J/177",1370,654,716
"4106110","Jaffna","Valikamam West (Chankanai)","Chankanai East","J/178",1596,750,846
"4106115","Jaffna","Valikamam West (Chankanai)","Chankanai West","J/179",1901,892,1009
"4106120","Jaffna","Valikamam West (Chankanai)","Chankanai South","J/180",1958,965,993
"4106125","Jaffna","Valikamam West (Chankanai)","Chankanai Centre","J/181",2231,1023,1208
"4109005","Jaffna","Valikamam South-West (Sandilipay)","Suthumalai North","J/129",1706,787,919
"4109010","Jaffna","Valikamam South-West (Sandilipay)","Suthumalai South","J/130",2067,961,1106
"4109015","Jaffna","Valikamam South-West (Sandilipay)","Savatkaddu","J/131",1713,839,874
"4109020","Jaffna","Valikamam South-West (Sandilipay)","Uyarappulam","J/132",3466,1603,1863
"4109025","Jaffna","Valikamam South-West (Sandilipay)","Anaikoddai","J/133",3810,1799,2011
"4109030","Jaffna","Valikamam South-West (Sandilipay)","Navali North","J/134",2652,1218,1434
"4109035","Jaffna","Valikamam South-West (Sandilipay)","Navali East","J/135",1491,682,809
"4109040","Jaffna","Valikamam South-West (Sandilipay)","Navali South","J/136",1645,811,834
"4109045","Jaffna","Valikamam South-West (Sandilipay)","Manipay North","J/137",1343,621,722
"4109050","Jaffna","Valikamam South-West (Sandilipay)","Manipay East","J/138",2183,1028,1155
"4109055","Jaffna","Valikamam South-West (Sandilipay)","Manipay South","J/139",1693,784,909
"4109060","Jaffna","Valikamam South-West (Sandilipay)","Manipay West","J/140",2370,1153,1217
"4109065","Jaffna","Valikamam South-West (Sandilipay)","Sandilipay North","J/141",1977,916,1061
"4109070","Jaffna","Valikamam South-West (Sandilipay)","Sandilipay Centre","J/142",2066,985,1081
"4109075","Jaffna","Valikamam South-West (Sandilipay)","Sandilipay West","J/143",1274,591,683
"4109080","Jaffna","Valikamam South-West (Sandilipay)","Masiapiddy","J/144",1801,826,975
"4109085","Jaffna","Valikamam South-West (Sandilipay)","Vadaliadaippu","J/145",1778,807,971
"4109090","Jaffna","Valikamam South-West (Sandilipay)","Pandatheruppu","J/146",2635,1224,1411
"4109095","Jaffna","Valikamam South-West (Sandilipay)","Piranpattai","J/147",1788,837,951
"4109100","Jaffna","Valikamam South-West (Sandilipay)","Sillalai North","J/148",1984,968,1016
"4109105","Jaffna","Valikamam South-West (Sandilipay)","Sillalai South","J/149",824,376,448
"4109110","Jaffna","Valikamam South-West (Sandilipay)","Mathagal East","J/150",2568,1251,1317
"4109115","Jaffna","Valikamam South-West (Sandilipay)","Mathagal South","J/151",1076,487,589
"4109120","Jaffna","Valikamam South-West (Sandilipay)","Mathagal West","J/152",773,376,397
"4109125","Jaffna","Valikamam South-West (Sandilipay)","Periyavillan","J/153",1603,752,851
"4109135","Jaffna","Valikamam South-West (Sandilipay)","Illavalai","J/155",2097,1019,1078
"4109140","Jaffna","Valikamam South-West (Sandilipay)","Mullanai","J/156",634,245,389
"4112005","Jaffna","Valikamam North","Mallakam South","212",2199,1059,1140
"4112010","Jaffna","Valikamam North","Mallakam Centre","213",2142,1027,1115
"4112015","Jaffna","Valikamam North","Mallakam North","214",2493,1156,1337
"4112020","Jaffna","Valikamam North","Alaveddy North","215",1506,703,803
"4112025","Jaffna","Valikamam North","Alaveddy Centre","216",1244,564,680
"4112030","Jaffna","Valikamam North","Alaveddy East","217",1746,834,912
"4112035","Jaffna","Valikamam North","Ganeswaram","218",1141,555,586
"4112040","Jaffna","Valikamam North","Alaveddy South","219",2020,993,1027
"4112045","Jaffna","Valikamam North","Alaveddy West","220",2134,1006,1128
"4112050","Jaffna","Valikamam North","Ilavalai North","221",966,458,508
"4112055","Jaffna","Valikamam North","Ilavalai North West","222",1521,721,800
"4112060","Jaffna","Valikamam North","Vithahapuram","223",487,227,260
"4112065","Jaffna","Valikamam North","Pannalai","224",925,436,489
"4112070","Jaffna","Valikamam North","Kollankalady","225",849,371,478
"4112075","Jaffna","Valikamam North","Naguleswaram","226",388,185,203
"4112080","Jaffna","Valikamam North","Tellippalai East","227",1491,716,775
"4112085","Jaffna","Valikamam North","Tellippalai","228",518,241,277
"4112090","Jaffna","Valikamam North","Thurkkapuram","229",1732,749,983
"4112095","Jaffna","Valikamam North","Thanthai Chelvapuram","230",818,392,426
"4112100","Jaffna","Valikamam North","Maviddapuram","231",47,16,31
"4112105","Jaffna","Valikamam North","Maviddapuram South","232",104,62,42
"4112110","Jaffna","Valikamam North","Kankesanthurai West","233",0,0,0
"4112115","Jaffna","Valikamam North","Kankesanthurai Centre","234",325,304,21
"4112120","Jaffna","Valikamam North","Kankesanthurai South","235",0,0,0
"4112125","Jaffna","Valikamam North","Palai Veemankamam North","236",12,5,7
"4112130","Jaffna","Valikamam North","Palai Veemankamam South","237",31,14,17
"4112135","Jaffna","Valikamam North","Kadduvan","238",132,60,72
"4112140","Jaffna","Valikamam North","Kadduvan West","239",827,387,440
"4112145","Jaffna","Valikamam North","Thenmylai","240",0,0,0
"4112150","Jaffna","Valikamam North","Varuthalaivilan","241",0,0,0
"4112155","Jaffna","Valikamam North","Kurumpasiddy","242",0,0,0
"4112160","Jaffna","Valikamam North","Kurumpasiddy East","243",160,79,81
"4112165","Jaffna","Valikamam North","Vayavilan East","244",1398,674,724
"4112170","Jaffna","Valikamam North","Vayavilan West","245",117,58,59
"4112175","Jaffna","Valikamam North","Myliddy North","246",0,0,0
"4112180","Jaffna","Valikamam North","Thyiddy East","247",0,0,0
"4112185","Jaffna","Valikamam North","Myliddyththurai South","248",0,0,0
"4112190","Jaffna","Valikamam North","Thyiddy North","249",0,0,0
"4112195","Jaffna","Valikamam North","Thyiddy South","250",0,0,0
"4112200","Jaffna","Valikamam North","Myliddyththurai North","251",0,0,0
"4112205","Jaffna","Valikamam North","Palaly South","252",0,0,0
"4112210","Jaffna","Valikamam North","Palaly East","253",0,0,0
"4112215","Jaffna","Valikamam North","Palaly North","254",0,0,0
"4112220","Jaffna","Valikamam North","Palaly North West","255",0,0,0
"4112225","Jaffna","Valikamam North","Palaly West","256",45,45,0
"4115005","Jaffna","Valikamam South (Uduvil)","Uduvil South West","J/182",1479,686,793
"4115010","Jaffna","Valikamam South (Uduvil)","Uduvil South  East","J/183",2008,941,1067
"4115015","Jaffna","Valikamam South (Uduvil)","Uduvil Centre","J/184",2089,974,1115
"4115020","Jaffna","Valikamam South (Uduvil)","Uduvil Centre North","J/185",2931,1279,1652
"4115025","Jaffna","Valikamam South (Uduvil)","Uduvil North","J/186",2005,938,1067
"4115030","Jaffna","Valikamam South (Uduvil)","Sanguvely","J/187",2759,1285,1474
"4115035","Jaffna","Valikamam South (Uduvil)","Inuvil South West","J/188",1664,793,871
"4115040","Jaffna","Valikamam South (Uduvil)","Inuvil East","J/189",814,357,457
"4115045","Jaffna","Valikamam South (Uduvil)","Inuvil North  East","J/190",2359,1046,1313
"4115050","Jaffna","Valikamam South (Uduvil)","Inuvil West","J/191",1298,624,674
"4115055","Jaffna","Valikamam South (Uduvil)","Thavady South","J/192",2215,1038,1177
"4115060","Jaffna","Valikamam South (Uduvil)","Thavady East","J/193",1458,680,778
"4115065","Jaffna","Valikamam South (Uduvil)","Thavady North","J/194",1705,822,883
"4115070","Jaffna","Valikamam South (Uduvil)","Chunnakam Town North","J/195",1227,581,646
"4115075","Jaffna","Valikamam South (Uduvil)","Chunnakam Town  South","J/196",3687,1733,1954
"4115080","Jaffna","Valikamam South (Uduvil)","Chunnakam Town  East","J/197",1586,770,816
"4115085","Jaffna","Valikamam South (Uduvil)","Chunnakam Town  Centre","J/198",1722,797,925
"4115090","Jaffna","Valikamam South (Uduvil)","Chunnakam Town  West","J/199",1650,760,890
"4115095","Jaffna","Valikamam South (Uduvil)","Kantharodai","J/200",1661,745,916
"4115100","Jaffna","Valikamam South (Uduvil)","Erlalai West","J/201",1453,675,778
"4115105","Jaffna","Valikamam South (Uduvil)","Erlalai South West","J/202",1603,743,860
"4115110","Jaffna","Valikamam South (Uduvil)","Erlalai South","J/203",3360,1608,1752
"4115115","Jaffna","Valikamam South (Uduvil)","Erlalai East","J/204",1322,602,720
"4115120","Jaffna","Valikamam South (Uduvil)","Erlalai North","J/205",1566,712,854
"4115125","Jaffna","Valikamam South (Uduvil)","Erlalai Centre","J/206",1155,520,635
"4115130","Jaffna","Valikamam South (Uduvil)","Punnalaikadduvan South","J/207",1094,512,582
"4115135","Jaffna","Valikamam South (Uduvil)","Punnalaikadduvan  North","J/208",1001,459,542
"4115140","Jaffna","Valikamam South (Uduvil)","Evenai","J/209",1677,798,879
"4115145","Jaffna","Valikamam South (Uduvil)","Kuppilan South","J/210",1815,851,964
"4115150","Jaffna","Valikamam South (Uduvil)","Kuppilan  North","J/211",653,316,337
"4118005","Jaffna","Valikamam East (Kopay)","Irupalai South","J/257",2552,1196,1356
"4118010","Jaffna","Valikamam East (Kopay)","Irupalai  East","J/258",2178,1053,1125
"4118015","Jaffna","Valikamam East (Kopay)","Kalviyankadu","J/259",2190,1042,1148
"4118020","Jaffna","Valikamam East (Kopay)","Kopay South","J/260",3825,1792,2033
"4118025","Jaffna","Valikamam East (Kopay)","Kopay Centre","J/261",3728,1660,2068
"4118030","Jaffna","Valikamam East (Kopay)","Kopay North","J/262",2598,1276,1322
"4118035","Jaffna","Valikamam East (Kopay)","Urumpirai West","J/263",2643,1247,1396
"4118040","Jaffna","Valikamam East (Kopay)","Urumpirai North","J/264",2397,1099,1298
"4118045","Jaffna","Valikamam East (Kopay)","Urumpirai South","J/265",4678,2240,2438
"4118050","Jaffna","Valikamam East (Kopay)","Urumpirai East","J/266",2641,1229,1412
"4118055","Jaffna","Valikamam East (Kopay)","Urelu","J/267",3295,1576,1719
"4118060","Jaffna","Valikamam East (Kopay)","Neervely South","J/268",2156,1000,1156
"4118065","Jaffna","Valikamam East (Kopay)","Neervely North","J/269",2546,1155,1391
"4118070","Jaffna","Valikamam East (Kopay)","Neervely West","J/270",1159,516,643
"4118075","Jaffna","Valikamam East (Kopay)","Sirupiddy East","J/271",1845,847,998
"4118080","Jaffna","Valikamam East (Kopay)","Sirupiddy West","J/272",2088,975,1113
"4118085","Jaffna","Valikamam East (Kopay)","Puttur West","J/273",3173,1554,1619
"4118090","Jaffna","Valikamam East (Kopay)","Puttur North","J/274",1603,766,837
"4118095","Jaffna","Valikamam East (Kopay)","Nawatkiri","J/275",1335,612,723
"4118100","Jaffna","Valikamam East (Kopay)","Avarangal East","J/276",1256,614,642
"4118105","Jaffna","Valikamam East (Kopay)","Avarangal West","J/277",2414,1126,1288
"4118110","Jaffna","Valikamam East (Kopay)","Puttur East","J/278",3556,1675,1881
"4118115","Jaffna","Valikamam East (Kopay)","Atchelu","J/279",3241,1546,1695
"4118120","Jaffna","Valikamam East (Kopay)","Vatharavattai","J/280",1035,512,523
"4118125","Jaffna","Valikamam East (Kopay)","Pathameny","J/281",2342,1151,1191
"4118130","Jaffna","Valikamam East (Kopay)","Thampalai-Kathiripay","J/282",1874,850,1024
"4118135","Jaffna","Valikamam East (Kopay)","Iddaikkadu","J/283",833,404,429
"4118140","Jaffna","Valikamam East (Kopay)","Valalai","J/284",860,436,424
"4118145","Jaffna","Valikamam East (Kopay)","Atchuvely North","J/285",2037,959,1078
"4118150","Jaffna","Valikamam East (Kopay)","Atchuvely South","J/286",2798,1297,1501
"4118155","Jaffna","Valikamam East (Kopay)","Atchuvely West","J/287",2349,1005,1344
"4121005","Jaffna","Vadamaradchi South-West","Karanavai South","J/348",1736,805,931
"4121010","Jaffna","Vadamaradchi South-West","Karanavai West","J/349",2034,977,1057
"4121015","Jaffna","Vadamaradchi South-West","Karanavai","J/350",1624,760,864
"4121020","Jaffna","Vadamaradchi South-West","Karanavai East","J/351",1348,633,715
"4121025","Jaffna","Vadamaradchi South-West","Udupiddy","J/352",1460,687,773
"4121030","Jaffna","Vadamaradchi South-West","Udupiddy North","J/353",1929,878,1051
"4121035","Jaffna","Vadamaradchi South-West","Udupiddy South","J/354",1027,455,572
"4121040","Jaffna","Vadamaradchi South-West","Valvetty","J/355",997,442,555
"4121045","Jaffna","Vadamaradchi South-West","Valvetty Centre","J/356",1275,586,689
"4121050","Jaffna","Vadamaradchi South-West","Samarabahu","J/357",1472,676,796
"4121055","Jaffna","Vadamaradchi South-West","Imayanan","J/358",1901,898,1003
"4121060","Jaffna","Vadamaradchi South-West","Imayanan East","J/359",2213,987,1226
"4121065","Jaffna","Vadamaradchi South-West","Karanavai North","J/360",1669,791,878
"4121070","Jaffna","Vadamaradchi South-West","Karanavai North West","J/361",1581,741,840
"4121075","Jaffna","Vadamaradchi South-West","Karanavai Centre","J/362",1255,568,687
"4121080","Jaffna","Vadamaradchi South-West","Karaveddy West","J/363",1696,787,909
"4121085","Jaffna","Vadamaradchi South-West","Karaveddy North","J/364",1026,473,553
"4121090","Jaffna","Vadamaradchi South-West","Karaveddy  South","J/365",751,319,432
"4121095","Jaffna","Vadamaradchi South-West","Maththoni","J/366",837,387,450
"4121100","Jaffna","Vadamaradchi South-West","Karaveddy Centre","J/367",1305,606,699
"4121105","Jaffna","Vadamaradchi South-West","Karaveddy East","J/368",1321,602,719
"4121110","Jaffna","Vadamaradchi South-West","Kaddaively","J/369",1176,541,635
"4121115","Jaffna","Vadamaradchi South-West","Thunnalai South","J/370",1387,656,731
"4121120","Jaffna","Vadamaradchi South-West","Thunnalai East","J/371",1240,568,672
"4121125","Jaffna","Vadamaradchi South-West","Thunnalai","J/372",678,314,364
"4121130","Jaffna","Vadamaradchi South-West","Thunnalai Centre","J/373",635,289,346
"4121135","Jaffna","Vadamaradchi South-West","Thunnalai West","J/374",1205,551,654
"4121140","Jaffna","Vadamaradchi South-West","Nelliaddy North","J/375",1146,548,598
"4121145","Jaffna","Vadamaradchi South-West","Nelliaddy","J/376",1072,502,570
"4121150","Jaffna","Vadamaradchi South-West","Nelliaddy East","J/377",1379,606,773
"4121155","Jaffna","Vadamaradchi South-West","Alvai","J/378",1484,732,752
"4121160","Jaffna","Vadamaradchi South-West","Alvai South","J/379",1401,664,737
"4121165","Jaffna","Vadamaradchi South-West","Alvai East","J/380",1521,743,778
"4121170","Jaffna","Vadamaradchi South-West","Aththai","J/381",746,344,402
"4121175","Jaffna","Vadamaradchi South-West","Kapputhu","J/382",203,94,109
"4124005","Jaffna","Vadamaradchi East","Manalkadu","418",954,462,492
"4124010","Jaffna","Vadamaradchi East","Kudathanai","419",1290,617,673
"4124015","Jaffna","Vadamaradchi East","Kudathanai Karaiyoor","420",632,315,317
"4124020","Jaffna","Vadamaradchi East","Potpathi","421",473,234,239
"4124025","Jaffna","Vadamaradchi East","Ampan","422",642,308,334
"4124030","Jaffna","Vadamaradchi East","Nagarkovil East","423",0,0,0
"4124035","Jaffna","Vadamaradchi East","Nagarkovil West","424",340,175,165
"4124040","Jaffna","Vadamaradchi East","Nagarkovil South","425",85,47,38
"4124045","Jaffna","Vadamaradchi East","Chempiyanpattu North","426",950,462,488
"4124050","Jaffna","Vadamaradchi East","Chempiyanpattu South","427",505,234,271
"4124055","Jaffna","Vadamaradchi East","Maruthankarny","428",919,461,458
"4124060","Jaffna","Vadamaradchi East","Vathirayan","429",874,435,439
"4124065","Jaffna","Vadamaradchi East","Uduthurai","430",1526,739,787
"4124070","Jaffna","Vadamaradchi East","Aliyavalai","431",1135,532,603
"4124075","Jaffna","Vadamaradchi East","Vetilaikerny","432",766,387,379
"4124080","Jaffna","Vadamaradchi East","Mulliyan","433",1188,597,591
"4124085","Jaffna","Vadamaradchi East","Pokkaruppu","434",487,248,239
"4124090","Jaffna","Vadamaradchi East","Chundikulam","435",0,0,0
"4127005","Jaffna","Vadamaradchi North (Pointpedro)","Thondamanaru South","J/383",721,357,364
"4127010","Jaffna","Vadamaradchi North (Pointpedro)","Thondamanaru North","J/384",838,384,454
"4127015","Jaffna","Vadamaradchi North (Pointpedro)","Kerudavil South","J/385",2203,1061,1142
"4127020","Jaffna","Vadamaradchi North (Pointpedro)","Kerudavil North","J/386",673,320,353
"4127025","Jaffna","Vadamaradchi North (Pointpedro)","Kerudavil East","J/387",467,234,233
"4127030","Jaffna","Vadamaradchi North (Pointpedro)","Valvettithurai North West","J/388",983,476,507
"4127035","Jaffna","Vadamaradchi North (Pointpedro)","Valvettithurai North Centre","J/389",476,221,255
"4127040","Jaffna","Vadamaradchi North (Pointpedro)","Valvettithurai North East","J/390",582,264,318
"4127045","Jaffna","Vadamaradchi North (Pointpedro)","Valvettithurai South West","J/391",883,446,437
"4127050","Jaffna","Vadamaradchi North (Pointpedro)","Valvettithurai South East","J/392",685,334,351
"4127055","Jaffna","Vadamaradchi North (Pointpedro)","Polikandy West","J/393",1889,884,1005
"4127060","Jaffna","Vadamaradchi North (Pointpedro)","Polikandy East","J/394",2155,996,1159
"4127065","Jaffna","Vadamaradchi North (Pointpedro)","Polikandy South","J/395",790,383,407
"4127070","Jaffna","Vadamaradchi North (Pointpedro)","Alvai West","J/396",1300,597,703
"4127075","Jaffna","Vadamaradchi North (Pointpedro)","Alvai North West","J/397",2088,942,1146
"4127080","Jaffna","Vadamaradchi North (Pointpedro)","Alvai North Centre","J/398",1888,890,998
"4127085","Jaffna","Vadamaradchi North (Pointpedro)","Viyaparimoolai","J/399",1404,649,755
"4127090","Jaffna","Vadamaradchi North (Pointpedro)","Alvai North","J/400",2030,954,1076
"4127095","Jaffna","Vadamaradchi North (Pointpedro)","Point Pedro","J/401",2083,1053,1030
"4127100","Jaffna","Vadamaradchi North (Pointpedro)","Point Pedro South","J/402",1373,640,733
"4127105","Jaffna","Vadamaradchi North (Pointpedro)","Point Pedro East","J/403",2956,1375,1581
"4127110","Jaffna","Vadamaradchi North (Pointpedro)","Thumpalai","J/404",1935,880,1055
"4127115","Jaffna","Vadamaradchi North (Pointpedro)","Thumpalai East","J/405",1303,632,671
"4127120","Jaffna","Vadamaradchi North (Pointpedro)","Katkovalam","J/406",2432,1141,1291
"4127125","Jaffna","Vadamaradchi North (Pointpedro)","Puloly North","J/407",1796,798,998
"4127130","Jaffna","Vadamaradchi North (Pointpedro)","Puloly North East","J/408",1043,471,572
"4127135","Jaffna","Vadamaradchi North (Pointpedro)","Puloly Centre","J/409",1602,735,867
"4127140","Jaffna","Vadamaradchi North (Pointpedro)","Puloly West","J/410",1367,662,705
"4127145","Jaffna","Vadamaradchi North (Pointpedro)","Puloly South West","J/411",1874,875,999
"4127150","Jaffna","Vadamaradchi North (Pointpedro)","Puloly North West","J/412",1398,664,734
"4127155","Jaffna","Vadamaradchi North (Pointpedro)","Puloly East","J/413",1518,727,791
"4127160","Jaffna","Vadamaradchi North (Pointpedro)","Puloly South","J/414",853,370,483
"4127165","Jaffna","Vadamaradchi North (Pointpedro)","Manthikai","J/415",536,244,292
"4127170","Jaffna","Vadamaradchi North (Pointpedro)","Vallipuram","J/416",596,284,312
"4127175","Jaffna","Vadamaradchi North (Pointpedro)","Thunnalai North","J/417",845,382,463
"4130005","Jaffna","Thenmaradchi (Chavakachcheri)","Kaithady North","J/288",538,263,275
"4130010","Jaffna","Thenmaradchi (Chavakachcheri)","Kaithady East","J/289",1585,756,829
"4130015","Jaffna","Thenmaradchi (Chavakachcheri)","Kaithady Centre","J/290",925,437,488
"4130020","Jaffna","Thenmaradchi (Chavakachcheri)","Kaithady South","J/291",1661,775,886
"4130025","Jaffna","Thenmaradchi (Chavakachcheri)","Kaithady South East","J/292",711,327,384
"4130030","Jaffna","Thenmaradchi (Chavakachcheri)","Kaithady West","J/293",1212,556,656
"4130035","Jaffna","Thenmaradchi (Chavakachcheri)","Navatkuli West","J/294",2157,1038,1119
"4130040","Jaffna","Thenmaradchi (Chavakachcheri)","Navatkuli East","J/295",1112,506,606
"4130045","Jaffna","Thenmaradchi (Chavakachcheri)","Kovilakandy","J/296",585,292,293
"4130050","Jaffna","Thenmaradchi (Chavakachcheri)","Kaithady Navatkuli","J/297",878,446,432
"4130055","Jaffna","Thenmaradchi (Chavakachcheri)","Maravanpulo","J/298",960,466,494
"4130060","Jaffna","Thenmaradchi (Chavakachcheri)","Thanankilappu","J/299",358,168,190
"4130065","Jaffna","Thenmaradchi (Chavakachcheri)","Chavakachcheri Town","J/300",981,444,537
"4130070","Jaffna","Thenmaradchi (Chavakachcheri)","Kovilkudyiruppu","J/301",2335,1123,1212
"4130075","Jaffna","Thenmaradchi (Chavakachcheri)","Sangathanai","J/302",1706,764,942
"4130080","Jaffna","Thenmaradchi (Chavakachcheri)","Chavakachcheri North","J/303",914,418,496
"4130085","Jaffna","Thenmaradchi (Chavakachcheri)","Manduvil","J/304",1080,477,603
"4130090","Jaffna","Thenmaradchi (Chavakachcheri)","Kalvayal","J/305",1831,880,951
"4130095","Jaffna","Thenmaradchi (Chavakachcheri)","Nunavil East","J/306",1145,562,583
"4130100","Jaffna","Thenmaradchi (Chavakachcheri)","Nunavil Centre","J/307",651,314,337
"4130105","Jaffna","Thenmaradchi (Chavakachcheri)","Nunavil West","J/308",1802,835,967
"4130110","Jaffna","Thenmaradchi (Chavakachcheri)","Kaithady Nunavil","J/309",706,333,373
"4130115","Jaffna","Thenmaradchi (Chavakachcheri)","Thenmadduvil","J/310",882,385,497
"4130120","Jaffna","Thenmaradchi (Chavakachcheri)","Madduvil Nunavil","J/311",620,303,317
"4130125","Jaffna","Thenmaradchi (Chavakachcheri)","Madduvil Centre","J/312",1108,543,565
"4130130","Jaffna","Thenmaradchi (Chavakachcheri)","Madduvil North","J/313",1072,501,571
"4130135","Jaffna","Thenmaradchi (Chavakachcheri)","Madduvil East","J/314",922,425,497
"4130140","Jaffna","Thenmaradchi (Chavakachcheri)","Chandrapuram","J/315",1555,739,816
"4130145","Jaffna","Thenmaradchi (Chavakachcheri)","Sarasalai South","J/316",1359,629,730
"4130150","Jaffna","Thenmaradchi (Chavakachcheri)","Sarasalai North","J/317",739,345,394
"4130160","Jaffna","Thenmaradchi (Chavakachcheri)","Meesalai West","J/319",1845,873,972
"4130165","Jaffna","Thenmaradchi (Chavakachcheri)","Ramavil","J/320",1127,513,614
"4130170","Jaffna","Thenmaradchi (Chavakachcheri)","Meesalai North","J/321",1505,701,804
"4130175","Jaffna","Thenmaradchi (Chavakachcheri)","Allarai","J/322",1310,620,690
"4130180","Jaffna","Thenmaradchi (Chavakachcheri)","Vellampokkady","J/323",671,310,361
"4130185","Jaffna","Thenmaradchi (Chavakachcheri)","Kachchai","J/324",1573,766,807
"4130190","Jaffna","Thenmaradchi (Chavakachcheri)","Palavi","J/325",1018,487,531
"4130195","Jaffna","Thenmaradchi (Chavakachcheri)","Kodikamam North","J/326",1257,597,660
"4130200","Jaffna","Thenmaradchi (Chavakachcheri)","Kodikamam Centre","J/327",1689,801,888
"4130205","Jaffna","Thenmaradchi (Chavakachcheri)","Kodikamam South","J/328",1504,704,800
"4130210","Jaffna","Thenmaradchi (Chavakachcheri)","Usan","J/329",867,419,448
"4130215","Jaffna","Thenmaradchi (Chavakachcheri)","Karampaham","J/330",315,157,158
"4130220","Jaffna","Thenmaradchi (Chavakachcheri)","Vidaththalpalai","J/331",541,267,274
"4130225","Jaffna","Thenmaradchi (Chavakachcheri)","Ketpeli","J/332",1394,667,727
"4130230","Jaffna","Thenmaradchi (Chavakachcheri)","Eluthumadduval South","J/333",262,148,114
"4130235","Jaffna","Thenmaradchi (Chavakachcheri)","Eluthumadduval North","J/334",680,325,355
"4130240","Jaffna","Thenmaradchi (Chavakachcheri)","Mirusuvil North","J/335",1105,529,576
"4130245","Jaffna","Thenmaradchi (Chavakachcheri)","Mirusuvil South","J/336",646,290,356
"4130250","Jaffna","Thenmaradchi (Chavakachcheri)","Kudamiyan","J/337",770,368,402
"4130255","Jaffna","Thenmaradchi (Chavakachcheri)","Navatkadu","J/338",648,290,358
"4130260","Jaffna","Thenmaradchi (Chavakachcheri)","Varani North","J/339",1017,495,522
"4130265","Jaffna","Thenmaradchi (Chavakachcheri)","Maaseri","J/340",348,169,179
"4130270","Jaffna","Thenmaradchi (Chavakachcheri)","Iddaikurichchi","J/341",1085,510,575
"4130275","Jaffna","Thenmaradchi (Chavakachcheri)","Karampaikurichchi","J/342",1177,546,631
"4130280","Jaffna","Thenmaradchi (Chavakachcheri)","Varani-Iyattalai","J/343",1123,505,618
"4130285","Jaffna","Thenmaradchi (Chavakachcheri)","Thavalai- Iyattalai","J/344",987,453,534
"4130290","Jaffna","Thenmaradchi (Chavakachcheri)","Manthuvil East","J/345",1225,564,661
"4130295","Jaffna","Thenmaradchi (Chavakachcheri)","Manthuvil West","J/346",705,311,394
"4130300","Jaffna","Thenmaradchi (Chavakachcheri)","Manthuvil North","J/347",381,165,216
"4133005","Jaffna","Nallur","Ariyalai South West","J/89",1471,715,756
"4133010","Jaffna","Nallur","Ariyalai  East","J/90",1098,517,581
"4133015","Jaffna","Nallur","Ariyalai North West","J/91",1831,897,934
"4133020","Jaffna","Nallur","Ariyalai West (Centre)","J/92",1582,732,850
"4133025","Jaffna","Nallur","Ariyalai S. W. (East)","J/93",1105,507,598
"4133030","Jaffna","Nallur","Ariyalai Centre North","J/94",879,408,471
"4133035","Jaffna","Nallur","Ariyalai Centre","J/95",1649,781,868
"4133040","Jaffna","Nallur","Ariyalai Centre South","J/96",1135,538,597
"4133045","Jaffna","Nallur","Iyanar Kovilady","J/97",1743,806,937
"4133050","Jaffna","Nallur","Vannarponnai N.W. (North)","J/98",2012,948,1064
"4133055","Jaffna","Nallur","Vannarponnai N.W. (West)","J/99",2647,1244,1403
"4133060","Jaffna","Nallur","Vannarponnai N.E. (North)","J/100",2260,1046,1214
"4133070","Jaffna","Nallur","Kantharmadam North West","J/102",1794,797,997
"4133075","Jaffna","Nallur","Kantharmadam North East","J/103",2263,1023,1240
"4133080","Jaffna","Nallur","Kantharmadam South West","J/104",1161,540,621
"4133085","Jaffna","Nallur","Kantharmadam South East","J/105",1153,534,619
"4133090","Jaffna","Nallur","Nallur North","J/106",1768,820,948
"4133095","Jaffna","Nallur","Nallur Irajathani","J/107",591,260,331
"4133100","Jaffna","Nallur","Nallur South","J/108",1595,703,892
"4133105","Jaffna","Nallur","Sangiliyan Thoppu","J/109",3611,1693,1918
"4133110","Jaffna","Nallur","Thirunelvely West","J/110",2628,1206,1422
"4133115","Jaffna","Nallur","Thirunelvely Centre South","J/111",837,387,450
"4133120","Jaffna","Nallur","Thirunelvely South East","J/112",1202,564,638
"4133125","Jaffna","Nallur","Thirunelvely North East","J/113",1662,769,893
"4133130","Jaffna","Nallur","Thirunelvely Centre North","J/114",3556,1693,1863
"4133135","Jaffna","Nallur","Kondavil North West","J/115",1951,913,1038
"4133140","Jaffna","Nallur","Kondavil South West","J/116",1905,889,1016
"4133145","Jaffna","Nallur","Kondavil Centre  West","J/117",1029,468,561
"4133150","Jaffna","Nallur","Kondavil Centre  East","J/118",2050,951,1099
"4133155","Jaffna","Nallur","Kondavil North East","J/119",2156,1002,1154
"4133160","Jaffna","Nallur","Kondavil South East","J/120",1589,757,832
"4133165","Jaffna","Nallur","Kokuvil North East","J/121",1774,857,917
"4133170","Jaffna","Nallur","Kokuvil  East","J/122",2628,1064,1564
"4133175","Jaffna","Nallur","Kokuvil South East","J/123",1430,662,768
"4133180","Jaffna","Nallur","Kokuvil North West","J/124",838,402,436
"4133185","Jaffna","Nallur","Kokuvil  West","J/125",1369,639,730
"4133190","Jaffna","Nallur","Kokuvil Centre East","J/126",1747,806,941
"4133195","Jaffna","Nallur","Kokuvil South  West","J/127",1420,653,767
"4133200","Jaffna","Nallur","Kokuvil Centre (West)","J/128",1522,710,812
"4136005","Jaffna","Jaffna","Nedunkulam","J/61",722,357,365
"4136010","Jaffna","Jaffna","Columbuthurai East","J/62",2909,1447,1462
"4136015","Jaffna","Jaffna","Columbuthurai West","J/63",522,250,272
"4136020","Jaffna","Jaffna","Passaiyoor East","J/64",1262,609,653
"4136025","Jaffna","Jaffna","Passaiyoor West","J/65",1178,523,655
"4136030","Jaffna","Jaffna","Eachchamoddai","J/66",2823,1280,1543
"4136035","Jaffna","Jaffna","Thirunagar","J/67",1630,802,828
"4136040","Jaffna","Jaffna","Reclamation East","J/68",4108,1938,2170
"4136045","Jaffna","Jaffna","Reclamation West","J/69",3546,1705,1841
"4136050","Jaffna","Jaffna","Gurunagar East","J/70",1974,840,1134
"4136055","Jaffna","Jaffna","Gurunagar West","J/71",1546,729,817
"4136060","Jaffna","Jaffna","Small Bazaar","J/72",874,431,443
"4136065","Jaffna","Jaffna","Jaffna Town West","J/73",2142,1008,1134
"4136070","Jaffna","Jaffna","Jaffna Town East","J/74",1988,896,1092
"4136075","Jaffna","Jaffna","Chundikuli South","J/75",1915,932,983
"4136080","Jaffna","Jaffna","Chundikuli North","J/76",1703,850,853
"4136085","Jaffna","Jaffna","Maruthady","J/77",1531,682,849
"4136090","Jaffna","Jaffna","Attiaddy","J/78",1911,870,1041
"4136095","Jaffna","Jaffna","Sirambiady","J/79",1153,535,618
"4136100","Jaffna","Jaffna","Grand Bazaar","J/80",1372,600,772
"4136105","Jaffna","Jaffna","Fort","J/81",2040,984,1056
"4136110","Jaffna","Jaffna","Vannarpannai","J/82",1654,760,894
"4136115","Jaffna","Jaffna","Koddady","J/83",1685,816,869
"4136120","Jaffna","Jaffna","Navanthurai South","J/84",1888,907,981
"4136125","Jaffna","Jaffna","Navanthurai North","J/85",2356,1134,1222
"4136130","Jaffna","Jaffna","Moor Street South","J/86",1272,645,627
"4136135","Jaffna","Jaffna","Moor Street North","J/87",1538,772,766
"4136140","Jaffna","Jaffna","New Moor Street","J/88",1249,614,635
"4139005","Jaffna","Island South (Velanai)","Mandaitivu East","J/7",251,123,128
"4139010","Jaffna","Island South (Velanai)","Mandaitivu West","J/8",472,179,293
"4139015","Jaffna","Island South (Velanai)","Mandaitivu South","J/9",801,386,415
"4139020","Jaffna","Island South (Velanai)","Allaipiddy","J/10",1721,813,908
"4139025","Jaffna","Island South (Velanai)","Mankumban","J/11",582,275,307
"4139030","Jaffna","Island South (Velanai)","Velanai North","J/12",376,174,202
"4139035","Jaffna","Island South (Velanai)","Velanai North East","J/13",487,236,251
"4139040","Jaffna","Island South (Velanai)","Velanai East","J/14",1036,507,529
"4139045","Jaffna","Island South (Velanai)","Velanai South East","J/15",341,155,186
"4139050","Jaffna","Island South (Velanai)","Velanai East Centre","J/16",539,264,275
"4139055","Jaffna","Island South (Velanai)","Velanai South","J/17",1147,539,608
"4139060","Jaffna","Island South (Velanai)","Velanai West Centre","J/18",351,185,166
"4139065","Jaffna","Island South (Velanai)","Velanai West","J/19",918,467,451
"4139070","Jaffna","Island South (Velanai)","Saravanai East","J/20",359,168,191
"4139075","Jaffna","Island South (Velanai)","Saravanai West","J/21",553,260,293
"4139080","Jaffna","Island South (Velanai)","Pungudutivu North East","J/22",202,89,113
"4139085","Jaffna","Island South (Velanai)","Pungudutivu East","J/23",285,146,139
"4139090","Jaffna","Island South (Velanai)","Pungudutivu South East","J/24",73,35,38
"4139095","Jaffna","Island South (Velanai)","Pungudutivu East South","J/25",398,197,201
"4139100","Jaffna","Island South (Velanai)","Pungudutivu South","J/26",979,491,488
"4139105","Jaffna","Island South (Velanai)","Pungudutivu North","J/27",319,146,173
"4139110","Jaffna","Island South (Velanai)","Pungudutivu Centre North","J/28",562,269,293
"4139115","Jaffna","Island South (Velanai)","Pungudutivu South West","J/29",199,88,111
"4139120","Jaffna","Island South (Velanai)","Pungudutivu Centre West","J/30",235,109,126
"4139125","Jaffna","Island South (Velanai)","Pungudutivu Centre East","J/31",270,124,146
"4139130","Jaffna","Island South (Velanai)","Pungudutivu North West","J/32",197,105,92
"4139135","Jaffna","Island South (Velanai)","Pungudutivu West","J/33",428,207,221
"4139140","Jaffna","Island South (Velanai)","Nainativu North","J/34",936,427,509
"4139145","Jaffna","Island South (Velanai)","Nainativu Centre","J/35",661,299,362
"4139150","Jaffna","Island South (Velanai)","Nainativu South","J/36",1064,499,565
"4142005","Jaffna","Delft","Delft West","J/01",680,340,340
"4142010","Jaffna","Delft","Delft South","J/02",428,208,220
"4142015","Jaffna","Delft","Delft Centre West","J/03",898,431,467
"4142020","Jaffna","Delft","Delft Centre","J/04",703,323,380
"4142025","Jaffna","Delft","Delft Centre East","J/05",576,278,298
"4142030","Jaffna","Delft","Delft East","J/06",539,278,261
"4203005","Mannar","Mannar Town","Talaimannar North","MN/48",968,491,477
"4203010","Mannar","Mannar Town","Talaimannar Pier West","MN/50",88,47,41
"4203015","Mannar","Mannar Town","Talaimannar Pier East","MN/51",1288,616,672
"4203020","Mannar","Mannar Town","Talaimannar","MN/52",754,422,332
"4203025","Mannar","Mannar Town","Talaimannar South","MN/49",522,249,273
"4203030","Mannar","Mannar Town","Kaddukarankudiyiruppu","MN/53",315,151,164
"4203035","Mannar","Mannar Town","Thullukudiyiruppu","MN/54",1155,542,613
"4203040","Mannar","Mannar Town","Pesalai South","MN/56",2486,1205,1281
"4203045","Mannar","Mannar Town","Pesalai North","MN/57",1198,600,598
"4203050","Mannar","Mannar Town","Pesalai West","MN/55",1150,575,575
"4203055","Mannar","Mannar Town","Siruthoppu","MN/58",1798,892,906
"4203060","Mannar","Mannar Town","Periyakarisal","MN/59",852,398,454
"4203065","Mannar","Mannar Town","Olaithoduwai","MN/60",638,321,317
"4203070","Mannar","Mannar Town","Puthukudiyiruppu","MN/61",1776,908,868
"4203075","Mannar","Mannar Town","Erukkalampiddy West","MN/63",617,328,289
"4203080","Mannar","Mannar Town","Erukkalampiddy North","MN/64",417,207,210
"4203085","Mannar","Mannar Town","Erukkalampiddy East","MN/65",753,366,387
"4203090","Mannar","Mannar Town","Erukkalampiddy South","MN/66",368,189,179
"4203095","Mannar","Mannar Town","Erukkalampiddy Centre","MN/67",513,254,259
"4203100","Mannar","Mannar Town","Pallimunai East","MN/84",1526,743,783
"4203105","Mannar","Mannar Town","Moor Street","MN/81",2180,1127,1053
"4203110","Mannar","Mannar Town","Emil Nagar","MN/74",2114,1044,1070
"4203115","Mannar","Mannar Town","Tharapuram East","MN/69",334,153,181
"4203120","Mannar","Mannar Town","Tharapuram West","MN/68",736,369,367
"4203125","Mannar","Mannar Town","Thoddaveli","MN/62",1834,885,949
"4203130","Mannar","Mannar Town","Thalvupadu","MN/70",2353,1201,1152
"4203135","Mannar","Mannar Town","Pattithoddam","MN/71",1486,721,765
"4203140","Mannar","Mannar Town","Eluthur","MN/72",3407,1645,1762
"4203145","Mannar","Mannar Town","South Bar","MN/73",2005,1100,905
"4203150","Mannar","Mannar Town","Savatkaddu","MN/75",1834,898,936
"4203155","Mannar","Mannar Town","Sinnakadai","MN/78",1386,633,753
"4203160","Mannar","Mannar Town","Uppukkulam North","MN/82",2064,931,1133
"4203165","Mannar","Mannar Town","Pallimunai West","MN/85",1504,814,690
"4203170","Mannar","Mannar Town","Uppukkulam South","MN/83",977,488,489
"4203175","Mannar","Mannar Town","Periyakadai","MN/80",677,353,324
"4203180","Mannar","Mannar Town","Pettah","MN/79",941,582,359
"4203185","Mannar","Mannar Town","Panankaddukoddu West","MN/76",1526,738,788
"4203190","Mannar","Mannar Town","Panankaddukoddu  East","MN/77",790,356,434
"4203195","Mannar","Mannar Town","Periyanavatkulam","MN/87",15,12,3
"4203200","Mannar","Mannar Town","Thiriketheeswaram","MN/86",442,224,218
"4203205","Mannar","Mannar Town","Nagathalvu","MN/88",186,105,81
"4203210","Mannar","Mannar Town","Neelasenai","MN/89",63,31,32
"4203215","Mannar","Mannar Town","Mathoddam","MN/93",322,156,166
"4203220","Mannar","Mannar Town","Kallikaddaikkadu","MN/90",393,193,200
"4203225","Mannar","Mannar Town","Vannamoddai","MN/94",23,10,13
"4203230","Mannar","Mannar Town","Uyilankulam","MN/92",433,231,202
"4203235","Mannar","Mannar Town","Puthukkamam","MN/91",849,413,436
"4203240","Mannar","Mannar Town","Uyirtharayankulam","MN/95",317,180,137
"4203245","Mannar","Mannar Town","Parappankandal","MN/96",705,354,351
"4206005","Mannar","Manthai West","Thevanpiddy","02",848,431,417
"4206010","Mannar","Manthai West","Vellankulam","01",551,287,264
"4206015","Mannar","Manthai West","Pali Aru","03",1219,659,560
"4206020","Mannar","Manthai West","Anthoniyarpuram","05",629,311,318
"4206025","Mannar","Manthai West","Illupaikadavai","04",606,334,272
"4206030","Mannar","Manthai West","Kalliyadi","06",216,116,100
"4206035","Mannar","Manthai West","Aththimoddai","08",55,33,22
"4206040","Mannar","Manthai West","Koorai","07",202,98,104
"4206045","Mannar","Manthai West","Periyamadhu East","17",246,119,127
"4206050","Mannar","Manthai West","Periyamadhu West","16",193,104,89
"4206055","Mannar","Manthai West","Kayanagar","15",534,265,269
"4206060","Mannar","Manthai West","Pallamadhu","14",555,297,258
"4206065","Mannar","Manthai West","Kovilkulam","09",261,134,127
"4206070","Mannar","Manthai West","Vidathaltheevu North","11",271,136,135
"4206075","Mannar","Manthai West","Vidathaltheevu West","10",439,218,221
"4206080","Mannar","Manthai West","Vidathaltheevu Centre","12",51,33,18
"4206085","Mannar","Manthai West","Vidathaltheevu East","13",192,132,60
"4206090","Mannar","Manthai West","Papamoddai","18",291,143,148
"4206095","Mannar","Manthai West","Parapukadanthan West","35",198,101,97
"4206100","Mannar","Manthai West","Parapukadanthan East","36",73,39,34
"4206105","Mannar","Manthai West","Kannady","28",599,293,306
"4206110","Mannar","Manthai West","Minnukkan","20",181,90,91
"4206115","Mannar","Manthai West","Maligaithidal","21",331,155,176
"4206120","Mannar","Manthai West","Veddayarmurrippu","19",235,116,119
"4206125","Mannar","Manthai West","Adampan","22",420,228,192
"4206130","Mannar","Manthai West","Nedunkandal","24",379,193,186
"4206135","Mannar","Manthai West","Karunkandal Vannakulam","30",404,213,191
"4206140","Mannar","Manthai West","Alkaddiveli","29",669,323,346
"4206145","Mannar","Manthai West","Andankulam","27",261,134,127
"4206150","Mannar","Manthai West","Karunkandal","26",291,133,158
"4206155","Mannar","Manthai West","Sornapuri","25",660,321,339
"4206160","Mannar","Manthai West","Palikuli","23",441,197,244
"4206165","Mannar","Manthai West","Kaththankulam","31",543,271,272
"4206170","Mannar","Manthai West","Vaddakandal","32",599,283,316
"4206175","Mannar","Manthai West","Palaiyadiputhukulam","34",339,164,175
"4206180","Mannar","Manthai West","Palaiperumalkaddu","33",789,413,376
"4209005","Mannar","Madhu","Palampiddy","40",760,382,378
"4209010","Mannar","Madhu","Keerisuddan","41",131,65,66
"4209015","Mannar","Madhu","Parasankulam","44",489,244,245
"4209020","Mannar","Madhu","Vilathikulam","43",252,140,112
"4209025","Mannar","Madhu","Kakkayankulam East","46",264,135,129
"4209030","Mannar","Madhu","Kalmadu","47",289,147,142
"4209035","Mannar","Madhu","Kakkayankulam West","45",230,134,96
"4209040","Mannar","Madhu","Iranai-Ilupaikulam","42",938,470,468
"4209045","Mannar","Madhu","Periya-Pandivirichchan East","39",693,377,316
"4209050","Mannar","Madhu","Periya-Pandivirichchan West","38",492,240,252
"4209055","Mannar","Madhu","Madhu","37",423,206,217
"4209060","Mannar","Madhu","Maluvarayarkaddayadampan","128",1527,768,759
"4209065","Mannar","Madhu","Poomalarnthan","130",277,179,98
"4209070","Mannar","Madhu","Thekkam","131",34,17,17
"4209075","Mannar","Madhu","Pannavedduvan","129",179,103,76
"4209080","Mannar","Madhu","Periyamurippu","133",220,113,107
"4209085","Mannar","Madhu","Matha Kiramam","132",513,253,260
"4212005","Mannar","Nanaddan","Vankalai North","MN/97",789,401,388
"4212010","Mannar","Nanaddan","Vankalai West","MN/98",710,328,382
"4212015","Mannar","Nanaddan","Vankalai East","MN/99",1450,689,761
"4212020","Mannar","Nanaddan","Thomaspuri","MN/100",1001,512,489
"4212025","Mannar","Nanaddan","Naruvilikkulam","MN/101",877,442,435
"4212030","Mannar","Nanaddan","Vanchiankulam","MN/102",511,248,263
"4212035","Mannar","Nanaddan","Ilahadipiddy","MN/111",499,251,248
"4212040","Mannar","Nanaddan","Ilanthamoddai","MN/112",205,105,100
"4212045","Mannar","Nanaddan","Periyakaddaikadu","MN/110",495,241,254
"4212050","Mannar","Nanaddan","Aththikkuli","MN/116",388,203,185
"4212055","Mannar","Nanaddan","Kanchithalvu","MN/115",48,30,18
"4212060","Mannar","Nanaddan","Chemmantheevu","MN/117",468,227,241
"4212065","Mannar","Nanaddan","Murunkan","MN/118",1378,775,603
"4212070","Mannar","Nanaddan","Cheddiyar Mahankaddai Adampan","MN/126",209,106,103
"4212075","Mannar","Nanaddan","Iraddaikkulam","MN/125",167,115,52
"4212080","Mannar","Nanaddan","Chundikkuli","MN/119",339,171,168
"4212085","Mannar","Nanaddan","Puttirarkandan","MN/113",422,201,221
"4212090","Mannar","Nanaddan","Razoolputhuveli","MN/114",236,113,123
"4212095","Mannar","Nanaddan","Nanaddan","MN/107",394,183,211
"4212100","Mannar","Nanaddan","Umanagari","MN/103",397,192,205
"4212105","Mannar","Nanaddan","Achchankulam","MN/104",512,266,246
"4212110","Mannar","Nanaddan","Moddaikadai","MN/106",429,205,224
"4212115","Mannar","Nanaddan","Rasamadhu","MN/105",500,248,252
"4212120","Mannar","Nanaddan","Pallankoddai","MN/108",424,214,210
"4212125","Mannar","Nanaddan","Valkaipattankandal","MN/109",1761,868,893
"4212130","Mannar","Nanaddan","Pontheevukandal","MN/121",448,226,222
"4212135","Mannar","Nanaddan","Kalimoddai Puliyankulam","MN/122",374,180,194
"4212140","Mannar","Nanaddan","Pariharikandal","MN/123",777,372,405
"4212145","Mannar","Nanaddan","Sirukkandal","MN/120",533,262,271
"4212150","Mannar","Nanaddan","Katkidanthakulam","MN/124",813,392,421
"4212155","Mannar","Nanaddan","Issaimalaithalvu","MN/127",337,189,148
"4215005","Mannar","Musalai","Arippu West","MN/134",1049,545,504
"4215010","Mannar","Musalai","Arippu East","MN/135",709,357,352
"4215015","Mannar","Musalai","Methanveli","MN/136",127,63,64
"4215020","Mannar","Musalai","Poonochchikulam","MN/138",368,198,170
"4215025","Mannar","Musalai","Pandaraveli","MN/137",439,225,214
"4215030","Mannar","Musalai","Sinnapullachchi Potkerni","MN/142",254,120,134
"4215035","Mannar","Musalai","Periyapullachchi Potkerni","MN/141",145,82,63
"4215040","Mannar","Musalai","Veppankulam","MN/140",358,191,167
"4215045","Mannar","Musalai","Maruthamadhu","MN/139",506,253,253
"4215050","Mannar","Musalai","Ahathimurippu","MN/143",513,252,261
"4215055","Mannar","Musalai","Puthuveli","MN/146",143,76,67
"4215060","Mannar","Musalai","Severiyarpuram","MN/145",659,330,329
"4215065","Mannar","Musalai","Chilavathurai","MN/144",395,236,159
"4215070","Mannar","Musalai","Kollankulam","MN/147",946,485,461
"4215075","Mannar","Musalai","Kondachchi","MN/149",516,256,260
"4215080","Mannar","Musalai","Kokkupadayan","MN/148",393,199,194
"4215085","Mannar","Musalai","Palaikuli","MN/152",229,116,113
"4215090","Mannar","Musalai","Karadikkuli","MN/150",287,141,146
"4215095","Mannar","Musalai","Mullikkulam","MN/153",32,7,25
"4215100","Mannar","Musalai","Marichchukkaddi","MN/151",51,25,26
"4303005","Vavuniya","Vavuniya North","Unchalkaddy","221",47,20,27
"4303010","Vavuniya","Vavuniya North","Vedivaithakallu","221A",26,15,11
"4303015","Vavuniya","Vavuniya North","Maruthoddai","221B",132,64,68
"4303020","Vavuniya","Vavuniya North","Paddikudiyiruppu","221C",413,193,220
"4303025","Vavuniya","Vavuniya North","Katkulam","221D",529,254,275
"4303030","Vavuniya","Vavuniya North","Nedunkerny South","222",853,475,378
"4303035","Vavuniya","Vavuniya North","Nedunkerny North","222A",527,280,247
"4303040","Vavuniya","Vavuniya North","Olumadu","222B",908,457,451
"4303045","Vavuniya","Vavuniya North","Mamadu","222C",569,289,280
"4303050","Vavuniya","Vavuniya North","Kulavisuddan","222D",524,245,279
"4303055","Vavuniya","Vavuniya North","Marailuppai","222E",498,232,266
"4303060","Vavuniya","Vavuniya North","Paranthan","223",793,426,367
"4303065","Vavuniya","Vavuniya North","Anandar Pulliyankulam","223A",181,101,80
"4303070","Vavuniya","Vavuniya North","Sinnadampan","223B",547,271,276
"4303075","Vavuniya","Vavuniya North","Nainamadu","223C",651,320,331
"4303080","Vavuniya","Vavuniya North","Puliyankulam South","224",953,557,396
"4303085","Vavuniya","Vavuniya North","Puliyankulam North","224A",780,382,398
"4303090","Vavuniya","Vavuniya North","Kanagarayankulam South","225",1341,761,580
"4303095","Vavuniya","Vavuniya North","Kanagarayankulam North","225A",765,374,391
"4303100","Vavuniya","Vavuniya North","Mannakulam","225B",541,271,270
"4306005","Vavuniya","Vavuniya South","Periya Ulukkulama","C209",875,409,466
"4306010","Vavuniya","Vavuniya South","Poomaduwa","C209A",86,46,40
"4306015","Vavuniya","Vavuniya South","Rankethgama","C209B",101,49,52
"4306020","Vavuniya","Vavuniya South","Maradanmaduwa","C209C",733,349,384
"4306025","Vavuniya","Vavuniya South","Pavakkulam South Bank, Track 07","C209D",168,91,77
"4306030","Vavuniya","Vavuniya South","Awaranthulawa","C209E",129,60,69
"4306035","Vavuniya","Vavuniya South","Acres 20,40,60","C209F",445,212,233
"4306040","Vavuniya","Vavuniya South","Acres 400","C209G",869,389,480
"4306045","Vavuniya","Vavuniya South","Madukanda","C212",1260,652,608
"4306050","Vavuniya","Vavuniya South","Eramperiyakulama","C212A",809,400,409
"4306055","Vavuniya","Vavuniya South","Alagalla","C212B",565,286,279
"4306060","Vavuniya","Vavuniya South","Avusathapitiya","C212C",1146,541,605
"4306065","Vavuniya","Vavuniya South","Kalukunnammaduwa","C212D",800,402,398
"4306070","Vavuniya","Vavuniya South","Nedunkulam","C212E",827,421,406
"4306075","Vavuniya","Vavuniya South","Mahamylankulama","C212F",848,421,427
"4306080","Vavuniya","Vavuniya South","Mamaduwa","C213",656,328,328
"4306085","Vavuniya","Vavuniya South","Mahakachchikodiya","C213A",801,380,421
"4306090","Vavuniya","Vavuniya South","Pudubulankulama","C213B",844,427,417
"4306095","Vavuniya","Vavuniya South","Pirappanmaduwa","C213C",372,199,173
"4306100","Vavuniya","Vavuniya South","Agbopura","C213D",784,386,398
"4309005","Vavuniya","Vavuniya","Palamoddai","219A",1005,483,522
"4309010","Vavuniya","Vavuniya","Maruthamadhu","219",547,278,269
"4309015","Vavuniya","Vavuniya","Panrikkeithakulam","220C",434,218,216
"4309020","Vavuniya","Vavuniya","Arumuhathanputhukulam","220E",227,113,114
"4309025","Vavuniya","Vavuniya","Semamadhu","220A",313,165,148
"4309030","Vavuniya","Vavuniya","Maligai","220B",300,172,128
"4309035","Vavuniya","Vavuniya","Mahilankulam","220F",316,164,152
"4309040","Vavuniya","Vavuniya","Maruthankulam","220",653,333,320
"4309045","Vavuniya","Vavuniya","Ilamaruthankulam","220G",150,82,68
"4309050","Vavuniya","Vavuniya","Kallikulam","215C",73,40,33
"4309055","Vavuniya","Vavuniya","Nochchimoddai","215",1210,614,596
"4309060","Vavuniya","Vavuniya","Paranaddakal","216A",806,418,388
"4309065","Vavuniya","Vavuniya","Puthukkulam","216",864,419,445
"4309070","Vavuniya","Vavuniya","Marekkarampalai","218C",4417,2120,2297
"4309075","Vavuniya","Vavuniya","Thandikulam","214A",3925,1854,2071
"4309080","Vavuniya","Vavuniya","Maharambaikulam","215A",6229,2957,3272
"4309090","Vavuniya","Vavuniya","Nelukkulam","218",5527,2669,2858
"4309100","Vavuniya","Vavuniya","Vavuniya Town","214",4674,2705,1969
"4309105","Vavuniya","Vavuniya","Omanthai","220D",1105,630,475
"4309110","Vavuniya","Vavuniya","Salambaikkulam","217C",1008,501,507
"4309115","Vavuniya","Vavuniya","Sasthirikoolankulam","218D",3145,1550,1595
"4309120","Vavuniya","Vavuniya","Echchankulam","218E",4735,2377,2358
"4309125","Vavuniya","Vavuniya","Kalmadu","218B",1893,924,969
"4309130","Vavuniya","Vavuniya","Poovarasankulam","217A",1924,921,1003
"4309135","Vavuniya","Vavuniya","Sekkadipulavu","217B",2856,1334,1522
"4309150","Vavuniya","Vavuniya","Koomankulam","218F",4597,2227,2370
"4309155","Vavuniya","Vavuniya","Kovilkulam","244C",2300,1100,1200
"4309160","Vavuniya","Vavuniya","Velikulam","244D",2269,1094,1175
"4309165","Vavuniya","Vavuniya","Moonrumurippu","214G",2031,952,1079
"4309170","Vavuniya","Vavuniya","Kandapuram","218G",3437,1651,1786
"4309175","Vavuniya","Vavuniya","Thonikal","214F",9313,4621,4692
"4309180","Vavuniya","Vavuniya","Samalankulam","244B",3630,1844,1786
"4309185","Vavuniya","Vavuniya","Asikulam","244",6051,2917,3134
"4309190","Vavuniya","Vavuniya","Rambaikulam","244A",3530,1577,1953
"4309195","Vavuniya","Vavuniya","Vairavapuliyankulam","214D",5021,2302,2719
"4309200","Vavuniya","Vavuniya","Pandarikkulam","214E",6469,2980,3489
"4309205","Vavuniya","Vavuniya","Vavuniya Town North","214C",5246,2397,2849
"4309210","Vavuniya","Vavuniya","Velankulam","217D",829,406,423
"4312005","Vavuniya","Vengalacheddikulam","Andiyapuliyankulam","207",9747,4771,4976
"4312010","Vavuniya","Vengalacheddikulam","Periyathampanai","207A",424,213,211
"4312015","Vavuniya","Vengalacheddikulam","Periyakaddu","207B",596,337,259
"4312020","Vavuniya","Vengalacheddikulam","Kannaddy","207C",192,99,93
"4312025","Vavuniya","Vengalacheddikulam","Piramanalankulam","207D",344,164,180
"4312030","Vavuniya","Vengalacheddikulam","Sooduventhapulavu","208",2290,1209,1081
"4312035","Vavuniya","Vengalacheddikulam","Kurukkalputhukkulam","208A",1007,492,515
"4312040","Vavuniya","Vengalacheddikulam","Kanthasamy Nagar","208B",1134,566,568
"4312045","Vavuniya","Vengalacheddikulam","Unit 5.  & 6 Pavatkulam","208C",875,393,482
"4312050","Vavuniya","Vengalacheddikulam","Unit 4. Pavatkulam","208D",677,333,344
"4312055","Vavuniya","Vengalacheddikulam","Unit 2. Pavatkulam","208E",1336,670,666
"4312060","Vavuniya","Vengalacheddikulam","Muthaliyarkulam","210",1638,780,858
"4312065","Vavuniya","Vengalacheddikulam","Sinnasippikulam","210A",2377,1382,995
"4312070","Vavuniya","Vengalacheddikulam","Neriyakulam","210B",2316,1177,1139
"4312075","Vavuniya","Vengalacheddikulam","Periyapuliyalankulam","211",2173,1056,1117
"4312080","Vavuniya","Vengalacheddikulam","Cheddikulam","211A",701,431,270
"4312085","Vavuniya","Vengalacheddikulam","Mugaththankulam","211B",781,383,398
"4312090","Vavuniya","Vengalacheddikulam","Unit 9. & 10 Pavatkulam","211C",335,155,180
"4312095","Vavuniya","Vengalacheddikulam","Kiristhavakulam","211D",289,164,125
"4312100","Vavuniya","Vengalacheddikulam","Kangankulam","211E",654,326,328
"4403005","Mullaitivu","Thunukkai","Alankulam","MU/26",433,210,223
"4403010","Mullaitivu","Thunukkai","Amaithipuram","MU/24",315,148,167
"4403015","Mullaitivu","Thunukkai","Ambalaperumalkulam","MU/25",281,149,132
"4403020","Mullaitivu","Thunukkai","Aninchiyankulam","MU/31",1519,730,789
"4403025","Mullaitivu","Thunukkai","Barathinagar","MU/30",520,268,252
"4403030","Mullaitivu","Thunukkai","Iyankankulam","MU/34",662,359,303
"4403035","Mullaitivu","Thunukkai","Kalvilan","MU/17",527,256,271
"4403040","Mullaitivu","Thunukkai","Koddaikaddiyakulam","MU/35",359,179,180
"4403045","Mullaitivu","Thunukkai","Mallavi","MU/20",796,375,421
"4403050","Mullaitivu","Thunukkai","Palayamurikandy","MU/33",123,58,65
"4403055","Mullaitivu","Thunukkai","Pugalenthinagar","MU/29",419,195,224
"4403060","Mullaitivu","Thunukkai","Puththuvedduvan","MU/23",192,97,95
"4403065","Mullaitivu","Thunukkai","Thenniyankulam","MU/32",389,188,201
"4403070","Mullaitivu","Thunukkai","Therankandal","MU/27",763,372,391
"4403075","Mullaitivu","Thunukkai","Thirunagar","MU/22",453,228,225
"4403080","Mullaitivu","Thunukkai","Thunukkai","MU/16",449,234,215
"4403085","Mullaitivu","Thunukkai","Uyilankulam","MU/18",214,109,105
"4403090","Mullaitivu","Thunukkai","Yogapuram Centre","MU/21",578,326,252
"4403095","Mullaitivu","Thunukkai","Yogapuram East","MU/28",351,183,168
"4403100","Mullaitivu","Thunukkai","Yogapuram West","MU/19",356,180,176
"4406005","Mullaitivu","Manthai East","Ampalpuram","MU/002",669,324,345
"4406010","Mullaitivu","Manthai East","Karumpulliyan","MU/007",435,225,210
"4406015","Mullaitivu","Manthai East","Kollavilankulam","MU/003",440,214,226
"4406020","Mullaitivu","Manthai East","Moonrumurippu","MU/011",552,279,273
"4406025","Mullaitivu","Manthai East","Naddankandal","MU/012",396,189,207
"4406030","Mullaitivu","Manthai East","Oddaruththakulam","MU/004",636,381,255
"4406035","Mullaitivu","Manthai East","Palinagar","MU/006",1081,531,550
"4406040","Mullaitivu","Manthai East","Pandiyankulam","MU/009",731,378,353
"4406045","Mullaitivu","Manthai East","Ponnagar/Kuttymulai","MU/014",124,60,64
"4406050","Mullaitivu","Manthai East","Poovarasankulam","MU/008",424,205,219
"4406055","Mullaitivu","Manthai East","Selvapuram","MU/010",649,327,322
"4406060","Mullaitivu","Manthai East","Siraddikulam","MU/015",161,90,71
"4406065","Mullaitivu","Manthai East","Sivapuram","MU/005",185,105,80
"4406070","Mullaitivu","Manthai East","Vannivilankulam","MU/001",305,150,155
"4406075","Mullaitivu","Manthai East","Vinayagapuram","MU/013",329,176,153
"4409005","Mullaitivu","Puthukudiyiruppu","Anandapuram","MU/40",2,2,0
"4409010","Mullaitivu","Puthukudiyiruppu","Iranaippalai","MU/43",1120,548,572
"4409015","Mullaitivu","Puthukudiyiruppu","Kombavil","MU/42",3778,1815,1963
"4409020","Mullaitivu","Puthukudiyiruppu","Mallikaithivu","MU/39",0,0,0
"4409025","Mullaitivu","Puthukudiyiruppu","Manikkapuram","MU/51",1090,532,558
"4409030","Mullaitivu","Puthukudiyiruppu","Mannakandal","MU/54",767,382,385
"4409035","Mullaitivu","Puthukudiyiruppu","Manthuvil","MU/38",0,0,0
"4409050","Mullaitivu","Puthukudiyiruppu","Sivanagar","MU/37",0,0,0
"4409055","Mullaitivu","Puthukudiyiruppu","Suthanthirapuram","MU/48",2345,1173,1172
"4409060","Mullaitivu","Puthukudiyiruppu","Theravil","MU/52",1135,553,582
"4409065","Mullaitivu","Puthukudiyiruppu","Thevipuram","MU/44",2291,1069,1222
"4409070","Mullaitivu","Puthukudiyiruppu","Udaiyarkaddu North","MU/46",1953,944,1009
"4409075","Mullaitivu","Puthukudiyiruppu","Udayarkaddu South","MU/47",2995,1430,1565
"4409080","Mullaitivu","Puthukudiyiruppu","Vallipunam","MU/45",1527,749,778
"4409085","Mullaitivu","Puthukudiyiruppu","Valluvarpuram","MU/53",970,501,469
"4409090","Mullaitivu","Puthukudiyiruppu","Visuvamadu East","MU/50",1255,633,622
"4409095","Mullaitivu","Puthukudiyiruppu","Visuvamadu West","MU/49",1981,906,1075
"4412005","Mullaitivu","Oddusuddan","Ampakamam","MU/72",378,175,203
"4412010","Mullaitivu","Oddusuddan","Ganeshapuram","MU/64",167,77,90
"4412015","Mullaitivu","Oddusuddan","Indupuram","MU/76",992,472,520
"4412025","Mullaitivu","Oddusuddan","Karuvelankandal","MU/66",371,220,151
"4412030","Mullaitivu","Oddusuddan","Katchilaimadu","MU/59",886,429,457
"4412035","Mullaitivu","Oddusuddan","Kathaliyarsamlankulam","MU/62",784,398,386
"4412040","Mullaitivu","Oddusuddan","Koolamurippu","MU/68",441,226,215
"4412045","Mullaitivu","Oddusuddan","Manavalanpaddamurippu","MU/69",429,204,225
"4412050","Mullaitivu","Oddusuddan","Mankulam","MU/73",1651,907,744
"4412060","Mullaitivu","Oddusuddan","Muthuvinayaga Puram","MU/60",882,449,433
"4412065","Mullaitivu","Oddusuddan","Oddusuddan","MU/61",1013,507,506
"4412070","Mullaitivu","Oddusuddan","Olumadu","MU/71",689,440,249
"4412075","Mullaitivu","Oddusuddan","Othiyamalai","MU/123",88,46,42
"4412080","Mullaitivu","Oddusuddan","Palampasi","MU/127",961,480,481
"4412085","Mullaitivu","Oddusuddan","Pandaravanni","MU/58",451,226,225
"4412090","Mullaitivu","Oddusuddan","Panikkankulam","MU/74",428,228,200
"4412095","Mullaitivu","Oddusuddan","Peraru","MU/57",321,174,147
"4412100","Mullaitivu","Oddusuddan","Periyaithimadu","MU/126",212,105,107
"4412105","Mullaitivu","Oddusuddan","Periyakulam","MU/124",31,18,13
"4412110","Mullaitivu","Oddusuddan","Puliyankulam","MU/67",314,150,164
"4412115","Mullaitivu","Oddusuddan","Thachchadampan","MU/70",472,225,247
"4412120","Mullaitivu","Oddusuddan","Thanduvan","MU/125",298,138,160
"4412125","Mullaitivu","Oddusuddan","Thaddayarmalai","MU/63",699,387,312
"4412130","Mullaitivu","Oddusuddan","Thirumurukandi","MU/75",656,325,331
"4412135","Mullaitivu","Oddusuddan","Vithyapuram","MU/65",691,334,357
"4415005","Mullaitivu","Maritimepattu","Alampil North","MU/86",652,417,235
"4415010","Mullaitivu","Maritimepattu","Alampil South","MU/87",1037,569,468
"4415015","Mullaitivu","Maritimepattu","Ampalavanpokkanai","MU/100",0,0,0
"4415030","Mullaitivu","Maritimepattu","Chilawattai","MU/88",1333,621,712
"4415035","Mullaitivu","Maritimepattu","Chilawattai South","MU/89",434,238,196
"4415040","Mullaitivu","Maritimepattu","Keekkirapuram","MU/115",608,316,292
"4415045","Mullaitivu","Maritimepattu","Kallappadu North","MU/91",458,223,235
"4415050","Mullaitivu","Maritimepattu","Kallappadu South","MU/90",1259,629,630
"4415055","Mullaitivu","Maritimepattu","Kanukerny East","MU/116",466,231,235
"4415060","Mullaitivu","Maritimepattu","Kanukerny West","MU/117",605,299,306
"4415065","Mullaitivu","Maritimepattu","Karunaddukerny","MU/79",552,282,270
"4415070","Mullaitivu","Maritimepattu","Keppapulavu","MU/102",327,168,159
"4415075","Mullaitivu","Maritimepattu","Kokkilai East","MU/78",421,221,200
"4415080","Mullaitivu","Maritimepattu","Kokkilai West","MU/77",563,309,254
"4415085","Mullaitivu","Maritimepattu","Kokuthoduvai Centre","MU/82",103,57,46
"4415090","Mullaitivu","Maritimepattu","Kokuthoduvai North","MU/81",102,56,46
"4415095","Mullaitivu","Maritimepattu","Kokuthoduvai South","MU/80",106,56,50
"4415100","Mullaitivu","Maritimepattu","Kovilkudiyiruppu","MU/95",237,123,114
"4415105","Mullaitivu","Maritimepattu","Kumarapuram","MU/118",940,479,461
"4415110","Mullaitivu","Maritimepattu","Kumulamunai Centre","MU/122",638,318,320
"4415115","Mullaitivu","Maritimepattu","Kumulamunai East","MU/121",659,305,354
"4415120","Mullaitivu","Maritimepattu","Kumulamunai West","MU/119",446,210,236
"4415125","Mullaitivu","Maritimepattu","Mamoolai","MU110",1081,541,540
"4415130","Mullaitivu","Maritimepattu","Manalkudiyiruppu","MU/96",285,152,133
"4415135","Mullaitivu","Maritimepattu","Mathavalasingankulam","MU/111",608,296,312
"4415140","Mullaitivu","Maritimepattu","Mullaitivu South","MU/93",665,307,358
"4415145","Mullaitivu","Maritimepattu","Mullaitivu Town","MU/97",258,165,93
"4415150","Mullaitivu","Maritimepattu","Mullivaikkal East","MU/98",628,307,321
"4415155","Mullaitivu","Maritimepattu","Mullivaikkal West","MU/99",0,0,0
"4415160","Mullaitivu","Maritimepattu","Mulliyawalai Centre","MU/106",382,188,194
"4415165","Mullaitivu","Maritimepattu","Mulliyawalai East","MU/108",1319,656,663
"4415170","Mullaitivu","Maritimepattu","Mulliyawalai North","MU/104",984,469,515
"4415175","Mullaitivu","Maritimepattu","Mulliyawalai South","MU/107",426,202,224
"4415180","Mullaitivu","Maritimepattu","Mulliyawalai West","MU/103",1536,746,790
"4415185","Mullaitivu","Maritimepattu","Neeravippiddy East","MU/113",645,325,320
"4415190","Mullaitivu","Maritimepattu","Neeravippiddy West","MU/114",499,256,243
"4415195","Mullaitivu","Maritimepattu","Putharikuda","MU/105",633,287,346
"4415200","Mullaitivu","Maritimepattu","Selvapuram","MU/94",1465,748,717
"4415205","Mullaitivu","Maritimepattu","Thannimurippu","MU/120",266,128,138
"4415210","Mullaitivu","Maritimepattu","Thanneerudru  East","MU/112",167,79,88
"4415215","Mullaitivu","Maritimepattu","Thanneerudru West","MU/109",771,396,375
"4415220","Mullaitivu","Maritimepattu","Uppumaveli","MU/85",1413,777,636
"4415225","Mullaitivu","Maritimepattu","Vannankulam","MU/92",370,178,192
"4415230","Mullaitivu","Maritimepattu","Vattappalai","MU/101",1451,704,747
"4418005","Mullaitivu","Welioya","Gajabapura","09",277,137,140
"4418010","Mullaitivu","Welioya","Kalayanapura","02",556,277,279
"4418015","Mullaitivu","Welioya","Ehetugaswewa","03",1335,629,706
"4418020","Mullaitivu","Welioya","Kiriibbanwewa","06",891,421,470
"4418025","Mullaitivu","Welioya","Janakapura","05",613,306,307
"4418030","Mullaitivu","Welioya","Nawagajabapura","01",225,114,111
"4418035","Mullaitivu","Welioya","Nikawewa left","08",1129,576,553
"4418040","Mullaitivu","Welioya","Ethawetunawewa","04",968,471,497
"4418045","Mullaitivu","Welioya","NIkawewa South","07",910,456,454
"4503005","Kilinochchi","Pachchilaipalli","Allipallai","KN/89",250,120,130
"4503010","Kilinochchi","Pachchilaipalli","Arasarkerni","KN/91",368,167,201
"4503015","Kilinochchi","Pachchilaipalli","Ittavil","KN/92",0,0,0
"4503020","Kilinochchi","Pachchilaipalli","Iyakkachchi","KN/79",562,271,291
"4503025","Kilinochchi","Pachchilaipalli","Kachcharveli","KN/90",274,123,151
"4503030","Kilinochchi","Pachchilaipalli","Kilaly","KN/95",434,215,219
"4503035","Kilinochchi","Pachchilaipalli","Kovilvayal","KN/78",582,293,289
"4503040","Kilinochchi","Pachchilaipalli","Masar","KN/81",420,207,213
"4503045","Kilinochchi","Pachchilaipalli","Muhamalai","KN/93",0,0,0
"4503050","Kilinochchi","Pachchilaipalli","Muhavil","KN/80",511,239,272
"4503055","Kilinochchi","Pachchilaipalli","Mullaiyadi","KN/85",783,470,313
"4503060","Kilinochchi","Pachchilaipalli","Pallai Town","KN/87",635,342,293
"4503065","Kilinochchi","Pachchilaipalli","Pulopallai","KN/84",716,333,383
"4503070","Kilinochchi","Pachchilaipalli","Pulopallai West","KN/88",428,197,231
"4503075","Kilinochchi","Pachchilaipalli","Soranpattu","KN/82",737,379,358
"4503080","Kilinochchi","Pachchilaipalli","Thampakamam","KN/86",1101,546,555
"4503085","Kilinochchi","Pachchilaipalli","Tharmakerny","KN/83",729,348,381
"4503090","Kilinochchi","Pachchilaipalli","Vempodukerny","KN/94",0,0,0
"4506005","Kilinochchi","Kandavalai","Elephant Pass","KN/46",0,0,0
"4506010","Kilinochchi","Kandavalai","Kalmadunagar","KN/53",2404,1210,1194
"4506015","Kilinochchi","Kandavalai","Kandawalai","KN/51",1029,506,523
"4506020","Kilinochchi","Kandavalai","Korakkankaddu","KN/48",1395,682,713
"4506025","Kilinochchi","Kandavalai","Kumarapuram","KN/43",1145,558,587
"4506030","Kilinochchi","Kandavalai","Murasumoddai","KN/50",687,325,362
"4506035","Kilinochchi","Kandavalai","Paranthan Town","KN/44",2283,1116,1167
"4506040","Kilinochchi","Kandavalai","Periyakulam","KN/52",1215,581,634
"4506045","Kilinochchi","Kandavalai","Piramanthalaru","KN/58",2073,1013,1060
"4506050","Kilinochchi","Kandavalai","Puliyampokkanai","KN/56",1133,553,580
"4506055","Kilinochchi","Kandavalai","Punnaineeravi","KN/57",5575,2718,2857
"4506060","Kilinochchi","Kandavalai","Thadduvankoddy","KN/47",300,163,137
"4506065","Kilinochchi","Kandavalai","Tharmapuram East","KN/55",1578,755,823
"4506070","Kilinochchi","Kandavalai","Tharmapuram West","KN/54",957,464,493
"4506075","Kilinochchi","Kandavalai","Umaiyalpuram","KN/45",739,347,392
"4506080","Kilinochchi","Kandavalai","Uriyan","KN/49",681,326,355
"4509005","Kilinochchi","Karachchi","Akkarayankulam","KN/5",1951,959,992
"4509010","Kilinochchi","Karachchi","Ambalkulam","KN/14",2193,1053,1140
"4509015","Kilinochchi","Karachchi","Ambalnagar","KN/19",2619,1286,1333
"4509020","Kilinochchi","Karachchi","Anaivilunthankulam","KN/2",1048,514,534
"4509025","Kilinochchi","Karachchi","Anandapuram","KN/16",1834,914,920
"4509030","Kilinochchi","Karachchi","Civic Centre","KN/39",763,379,384
"4509035","Kilinochchi","Karachchi","Jeyanthinagar","KN/30",1915,901,1014
"4509040","Kilinochchi","Karachchi","Kanagambigaikulam","KN/18",1185,568,617
"4509045","Kilinochchi","Karachchi","Kanagapuram","KN/26",877,429,448
"4509050","Kilinochchi","Karachchi","Kaneshapuram","KN/29",586,277,309
"4509055","Kilinochchi","Karachchi","Kannagaipuram","KN/03",961,474,487
"4509060","Kilinochchi","Karachchi","Kilinochchi Town","KN/23",1600,955,645
"4509065","Kilinochchi","Karachchi","Konavil","KN/06",3031,1528,1503
"4509070","Kilinochchi","Karachchi","Krishnapuram","KN/11",2220,1078,1142
"4509075","Kilinochchi","Karachchi","Malaiyalapuram","KN/09",1622,748,874
"4509080","Kilinochchi","Karachchi","Maruthanagar","KN/24",1249,610,639
"4509085","Kilinochchi","Karachchi","Mavadyamman","KN/42",1450,699,751
"4509090","Kilinochchi","Karachchi","Mayavanoor","KN/40",2352,1108,1244
"4509095","Kilinochchi","Karachchi","Pannakandy","KN/25",833,411,422
"4509100","Kilinochchi","Karachchi","Barathypuram","KN/8",2306,1093,1213
"4509105","Kilinochchi","Karachchi","Periya Paranthan","KN/31",1076,523,553
"4509110","Kilinochchi","Karachchi","Ponnagar","KN/07",1107,526,581
"4509115","Kilinochchi","Karachchi","Puthumurippu","KN/37",1395,698,697
"4509120","Kilinochchi","Karachchi","Ramanathapuram","KN/41",2087,985,1102
"4509125","Kilinochchi","Karachchi","Rathinapuram","KN/22",1015,489,526
"4509130","Kilinochchi","Karachchi","Selvanagar","KN/15",2217,1111,1106
"4509135","Kilinochchi","Karachchi","Sivanagar","KN/35",994,504,490
"4509140","Kilinochchi","Karachchi","Skandapuram","KN/04",2105,1040,1065
"4509145","Kilinochchi","Karachchi","Thirunagar North","KN/28",1109,525,584
"4509150","Kilinochchi","Karachchi","Thirunagar South","KN/27",723,350,373
"4509155","Kilinochchi","Karachchi","Thiruvaiaru","KN/20",860,418,442
"4509160","Kilinochchi","Karachchi","Thiruvaiaru West","KN/21",579,309,270
"4509165","Kilinochchi","Karachchi","Thondamannagar","KN/17",730,360,370
"4509170","Kilinochchi","Karachchi","Urithirapuram East","KN/33",1184,544,640
"4509175","Kilinochchi","Karachchi","Urithirapuram North","KN/32",1357,679,678
"4509180","Kilinochchi","Karachchi","Urithirapuram West","KN/34",1039,488,551
"4509185","Kilinochchi","Karachchi","Uthayanagar East","KN/12",1759,911,848
"4509190","Kilinochchi","Karachchi","Uthayanagar West","KN/13",1950,955,995
"4509195","Kilinochchi","Karachchi","Uttupulam","KN/36",1290,639,651
"4509200","Kilinochchi","Karachchi","Vaddakachchi","KN/38",1577,771,806
"4509205","Kilinochchi","Karachchi","Vannerikulam","KN/01",1262,605,657
"4509210","Kilinochchi","Karachchi","Vivekanandanagar","KN/10",1474,715,759
"4512005","Kilinochchi","Poonakary","Alankerni","KN/60",240,123,117
"4512010","Kilinochchi","Poonakary","Cheddiakurichchi","KN/62",455,223,232
"4512015","Kilinochchi","Poonakary","Gnanimadam","KN/63",595,278,317
"4512020","Kilinochchi","Poonakary","Iranaitivu","KN/77",0,0,0
"4512025","Kilinochchi","Poonakary","Jayapuram North","KN/69",667,350,317
"4512030","Kilinochchi","Poonakary","Jayapuram South","KN/70",569,275,294
"4512035","Kilinochchi","Poonakary","Kariyalainagapaduvan","KN/71",1756,870,886
"4512040","Kilinochchi","Poonakary","Kiranchi","KN/75",1568,762,806
"4512045","Kilinochchi","Poonakary","Kollakuruchchi","KN/61",829,391,438
"4512050","Kilinochchi","Poonakary","Kowtharimunai","KN/68",336,174,162
"4512055","Kilinochchi","Poonakary","Madduvilnadu East","KN/64",461,231,230
"4512060","Kilinochchi","Poonakary","Madduvilnadu West","KN/66",741,389,352
"4512065","Kilinochchi","Poonakary","Mulankavil","KN/73",3410,1692,1718
"4512070","Kilinochchi","Poonakary","Nachchikkuda","KN/74",1836,926,910
"4512075","Kilinochchi","Poonakary","Nallur","KN/59",1699,862,837
"4512080","Kilinochchi","Poonakary","Pallavarayankaddu","KN/72",987,484,503
"4512085","Kilinochchi","Poonakary","Pallikuda","KN/65",2162,1063,1099
"4512090","Kilinochchi","Poonakary","Paramankirai","KN/67",486,240,246
"4512095","Kilinochchi","Poonakary","Ponnaveli","KN/76",1505,754,751
"6103005","Kurunegala","Giribawa","Jayanthipura","7",819,395,424
"6103010","Kurunegala","Giribawa","Bambare","10",1094,559,535
"6103015","Kurunegala","Giribawa","Sandagala Palatha","8",1003,502,501
"6103020","Kurunegala","Giribawa","Perakumpura","11",1422,693,729
"6103025","Kurunegala","Giribawa","Solepura","20",1149,558,591
"6103030","Kurunegala","Giribawa","Halmillagala","12",838,389,449
"6103035","Kurunegala","Giribawa","Thimbiripokuna","13",843,416,427
"6103040","Kurunegala","Giribawa","Serasumgala","15",629,306,323
"6103045","Kurunegala","Giribawa","Kokmaduwa","27",597,305,292
"6103050","Kurunegala","Giribawa","Orugala","16",987,480,507
"6103055","Kurunegala","Giribawa","Mahasenpura","14",812,386,426
"6103060","Kurunegala","Giribawa","Weerapokuna","17",976,481,495
"6103065","Kurunegala","Giribawa","Hasthirajapura","19",1191,574,617
"6103070","Kurunegala","Giribawa","Thammitagama","21",490,250,240
"6103075","Kurunegala","Giribawa","Damsopura","18",1019,473,546
"6103080","Kurunegala","Giribawa","Solewewa","6",1784,851,933
"6103085","Kurunegala","Giribawa","Pathane Wewa","9",936,442,494
"6103090","Kurunegala","Giribawa","Abhayapura","3",604,300,304
"6103095","Kurunegala","Giribawa","Sangabopura","5",906,424,482
"6103100","Kurunegala","Giribawa","Gurulupitigama","2",1323,602,721
"6103105","Kurunegala","Giribawa","Warawewa","4",1107,548,559
"6103110","Kurunegala","Giribawa","Pothana","22",787,376,411
"6103115","Kurunegala","Giribawa","Pahala Giribawa","23",705,347,358
"6103120","Kurunegala","Giribawa","Ihala Giribawa","26",877,414,463
"6103125","Kurunegala","Giribawa","Weragala","24",337,173,164
"6103130","Kurunegala","Giribawa","Ihala Maradankadawala","25",500,244,256
"6103135","Kurunegala","Giribawa","Hettiarachchigama","1",880,437,443
"6103140","Kurunegala","Giribawa","Gampola","33",407,199,208
"6103145","Kurunegala","Giribawa","Aliyawetunawewa","32",1191,559,632
"6103150","Kurunegala","Giribawa","Thambutta","28",702,336,366
"6103155","Kurunegala","Giribawa","Thammennawa","29",405,200,205
"6103160","Kurunegala","Giribawa","Mailewa","30",649,296,353
"6103165","Kurunegala","Giribawa","Madige","31",1380,686,694
"6103170","Kurunegala","Giribawa","Wannikudawewa","35",1024,484,540
"6103175","Kurunegala","Giribawa","Sangappalaya","34",1039,495,544
"6106005","Kurunegala","Galgamuwa","Medagama","87",1439,722,717
"6106010","Kurunegala","Galgamuwa","Walagambapura","96",797,400,397
"6106015","Kurunegala","Galgamuwa","Gemunupura","94",516,253,263
"6106020","Kurunegala","Galgamuwa","Ethiniwetunugala","95",849,429,420
"6106025","Kurunegala","Galgamuwa","Thissapura","93",722,335,387
"6106030","Kurunegala","Galgamuwa","Medagama East","88",714,356,358
"6106035","Kurunegala","Galgamuwa","Senarathgama","89",748,359,389
"6106040","Kurunegala","Galgamuwa","Kumbukwewa","83",549,273,276
"6106045","Kurunegala","Galgamuwa","Mahagalkadawala","82",1100,521,579
"6106050","Kurunegala","Galgamuwa","Usgala Siyambalangamuwa","92",762,367,395
"6106055","Kurunegala","Galgamuwa","Kepela","98",929,469,460
"6106060","Kurunegala","Galgamuwa","Bandaragama","97",1277,627,650
"6106065","Kurunegala","Galgamuwa","Ganangamuwa","99",1448,673,775
"6106070","Kurunegala","Galgamuwa","Padavigama","91",1519,736,783
"6106075","Kurunegala","Galgamuwa","Meegalewa","90",2231,1106,1125
"6106080","Kurunegala","Galgamuwa","Lassanagama","81",732,374,358
"6106085","Kurunegala","Galgamuwa","Track 4 Usgala","80",544,268,276
"6106090","Kurunegala","Galgamuwa","Jayalanda","79",998,478,520
"6106095","Kurunegala","Galgamuwa","Padipanchawa","76",808,384,424
"6106100","Kurunegala","Galgamuwa","Buduruwakanda","86",1183,546,637
"6106105","Kurunegala","Galgamuwa","Kallanchiya","85",573,294,279
"6106110","Kurunegala","Galgamuwa","Molewa","84",652,322,330
"6106115","Kurunegala","Galgamuwa","Nochchiya","48",661,326,335
"6106120","Kurunegala","Galgamuwa","Kohombankulama","49",1228,597,631
"6106125","Kurunegala","Galgamuwa","Ihala Nanneriya","39",782,369,413
"6106130","Kurunegala","Galgamuwa","Ihalagama","46",824,389,435
"6106135","Kurunegala","Galgamuwa","Ihala Palukandewa","54",1030,483,547
"6106140","Kurunegala","Galgamuwa","Pahala Palukandewa","55",1262,612,650
"6106145","Kurunegala","Galgamuwa","Monnankulama","56",1563,752,811
"6106150","Kurunegala","Galgamuwa","Divullewa","58",1152,550,602
"6106155","Kurunegala","Galgamuwa","Kurundankulama","59",969,500,469
"6106160","Kurunegala","Galgamuwa","Kelegama","77",613,307,306
"6106165","Kurunegala","Galgamuwa","Siyambalewa","78",712,345,367
"6106170","Kurunegala","Galgamuwa","Walaswewa","63",709,357,352
"6106175","Kurunegala","Galgamuwa","Porottukadawala","64",462,210,252
"6106180","Kurunegala","Galgamuwa","Bulnewa","62",1057,512,545
"6106185","Kurunegala","Galgamuwa","Ulpathagama","61",790,387,403
"6106190","Kurunegala","Galgamuwa","Kokwewa","65",778,377,401
"6106195","Kurunegala","Galgamuwa","Mahagalgamuwa","60",1451,714,737
"6106200","Kurunegala","Galgamuwa","Galgamuwa Town","57",1227,649,578
"6106205","Kurunegala","Galgamuwa","Aluthherathgama","51",728,339,389
"6106210","Kurunegala","Galgamuwa","Mottapettewa","52",614,295,319
"6106215","Kurunegala","Galgamuwa","Karuwalagaswewa","53",895,426,469
"6106220","Kurunegala","Galgamuwa","Jayabima","47",906,444,462
"6106225","Kurunegala","Galgamuwa","Palugolla","50",477,239,238
"6106230","Kurunegala","Galgamuwa","Mahananneriya North","36",759,363,396
"6106235","Kurunegala","Galgamuwa","Mahananneriya South","37",563,264,299
"6106240","Kurunegala","Galgamuwa","Wewaranawetiya","38",763,373,390
"6106245","Kurunegala","Galgamuwa","Nallachchiya","40",780,371,409
"6106250","Kurunegala","Galgamuwa","Madawachchiya","43",472,226,246
"6106255","Kurunegala","Galgamuwa","Peddogama","41",527,260,267
"6106260","Kurunegala","Galgamuwa","Katuwewa","42",705,358,347
"6106265","Kurunegala","Galgamuwa","Thorawa","44",836,401,435
"6106270","Kurunegala","Galgamuwa","Nahettikulama","45",880,417,463
"6106275","Kurunegala","Galgamuwa","Wadugama","71",1131,531,600
"6106280","Kurunegala","Galgamuwa","Konwewa","68",819,407,412
"6106285","Kurunegala","Galgamuwa","Kattakaduwa","70",1091,527,564
"6106290","Kurunegala","Galgamuwa","Ganedivulwewa","69",721,356,365
"6106295","Kurunegala","Galgamuwa","Wegedara","66",578,289,289
"6106300","Kurunegala","Galgamuwa","Madadombe","67",623,289,334
"6106305","Kurunegala","Galgamuwa","Kurundewa","72",858,435,423
"6106310","Kurunegala","Galgamuwa","Palukadawala","73",992,475,517
"6109005","Kurunegala","Ehetuwewa","Medinnoruwa","102",922,485,437
"6109010","Kurunegala","Ehetuwewa","Mahaweli Thenna","101",943,450,493
"6109015","Kurunegala","Ehetuwewa","Andarawewa","100",779,386,393
"6109020","Kurunegala","Ehetuwewa","Bongama","104",808,406,402
"6109025","Kurunegala","Ehetuwewa","Katugampalagama","105",1075,545,530
"6109030","Kurunegala","Ehetuwewa","Maha Kathnoruwa","107",426,220,206
"6109035","Kurunegala","Ehetuwewa","Weliyawa","103",736,364,372
"6109040","Kurunegala","Ehetuwewa","Makulewa","113",540,273,267
"6109045","Kurunegala","Ehetuwewa","Vikadenigama","112",570,278,292
"6109050","Kurunegala","Ehetuwewa","Kathnoruwa","108",732,355,377
"6109055","Kurunegala","Ehetuwewa","Wedinigama","106",656,333,323
"6109060","Kurunegala","Ehetuwewa","Pothanegama","109",656,312,344
"6109065","Kurunegala","Ehetuwewa","Mudiyannegama","110",720,362,358
"6109070","Kurunegala","Ehetuwewa","Divulgane","111",520,240,280
"6109075","Kurunegala","Ehetuwewa","Ihala Digana","115",770,369,401
"6109080","Kurunegala","Ehetuwewa","Nithalawa","114",478,240,238
"6109085","Kurunegala","Ehetuwewa","Galapitadigana","117",691,343,348
"6109090","Kurunegala","Ehetuwewa","Ethinimole","118",751,356,395
"6109095","Kurunegala","Ehetuwewa","Rathnadivulwewa","119",920,433,487
"6109100","Kurunegala","Ehetuwewa","Nithogama","116",749,358,391
"6109105","Kurunegala","Ehetuwewa","Hiddewa","120",1061,498,563
"6109110","Kurunegala","Ehetuwewa","Kaduruwewa","122",594,276,318
"6109115","Kurunegala","Ehetuwewa","Ihala Embogama","124",773,348,425
"6109120","Kurunegala","Ehetuwewa","Maha Embogama","123",594,271,323
"6109125","Kurunegala","Ehetuwewa","Ehetuwewa","121",899,463,436
"6109130","Kurunegala","Ehetuwewa","Nakolagane","130",665,303,362
"6109135","Kurunegala","Ehetuwewa","Veheragodayaya","75",617,304,313
"6109140","Kurunegala","Ehetuwewa","Yaddessawa","74",688,344,344
"6109145","Kurunegala","Ehetuwewa","Atharagalla","132",770,357,413
"6109150","Kurunegala","Ehetuwewa","Gurugoda","131",1024,527,497
"6109155","Kurunegala","Ehetuwewa","Eriyawa","129",986,495,491
"6109160","Kurunegala","Ehetuwewa","Hunugallewa","128",833,414,419
"6109165","Kurunegala","Ehetuwewa","Thimbiriyawa","127",561,276,285
"6109170","Kurunegala","Ehetuwewa","Walathwewa","125",532,255,277
"6109175","Kurunegala","Ehetuwewa","Nabadewa","126",742,340,402
"6112005","Kurunegala","Ambanpola","Kasikote West","183",815,413,402
"6112010","Kurunegala","Ambanpola","Kasikote East","182",639,318,321
"6112015","Kurunegala","Ambanpola","Belungala","184",1040,488,552
"6112020","Kurunegala","Ambanpola","Abakolawewa North","186",561,286,275
"6112025","Kurunegala","Ambanpola","Amunugama","185",1123,551,572
"6112030","Kurunegala","Ambanpola","Ambanpola North","189",1574,771,803
"6112035","Kurunegala","Ambanpola","Nelumpathwewa","181",951,477,474
"6112040","Kurunegala","Ambanpola","Maha Divulwewa","177",563,295,268
"6112045","Kurunegala","Ambanpola","Ranoruwa","176",503,241,262
"6112050","Kurunegala","Ambanpola","Uda Divulwewa","178",687,332,355
"6112055","Kurunegala","Ambanpola","Ellabadagama","179",967,450,517
"6112060","Kurunegala","Ambanpola","Ambanpola South","190",1011,457,554
"6112065","Kurunegala","Ambanpola","Kirimetiyawa","188",1054,522,532
"6112070","Kurunegala","Ambanpola","Abakolawewa South","187",488,218,270
"6112075","Kurunegala","Ambanpola","Serugoda","155",700,339,361
"6112080","Kurunegala","Ambanpola","Mediyawa","154",976,447,529
"6112085","Kurunegala","Ambanpola","Dethawa","192",715,350,365
"6112090","Kurunegala","Ambanpola","Udangawa","191",1116,534,582
"6112095","Kurunegala","Ambanpola","Waragammana","180",704,320,384
"6112100","Kurunegala","Ambanpola","Borawewa","174",583,279,304
"6112105","Kurunegala","Ambanpola","Bakmeewewa","175",588,273,315
"6112110","Kurunegala","Ambanpola","Walaliya","171",733,360,373
"6112115","Kurunegala","Ambanpola","Palapathwala","173",573,279,294
"6112120","Kurunegala","Ambanpola","Kettapahuwa","163",1176,550,626
"6112125","Kurunegala","Ambanpola","Rolawa","193",746,371,375
"6112130","Kurunegala","Ambanpola","Udagama","162",965,473,492
"6112135","Kurunegala","Ambanpola","Nekathi Kumbukwewa","172",650,306,344
"6112140","Kurunegala","Ambanpola","Waduressa","170",677,320,357
"6115005","Kurunegala","Kotavehera","Palugolla Track 10 A","229",899,418,481
"6115010","Kurunegala","Kotavehera","Palugolla Track 10 B","230",670,331,339
"6115015","Kurunegala","Kotavehera","Palu Uswewa","231",711,338,373
"6115020","Kurunegala","Kotavehera","Kumbukwewa","258",922,457,465
"6115025","Kurunegala","Kotavehera","Digannewa","257",551,278,273
"6115030","Kurunegala","Kotavehera","Kelegama","255",678,319,359
"6115035","Kurunegala","Kotavehera","Digannewatta","256",488,230,258
"6115040","Kurunegala","Kotavehera","Maha Mithawa","259",827,396,431
"6115045","Kurunegala","Kotavehera","Aluthgama","254",612,278,334
"6115050","Kurunegala","Kotavehera","Divullepitiya","244",686,319,367
"6115055","Kurunegala","Kotavehera","Meewellewa","233",631,298,333
"6115060","Kurunegala","Kotavehera","Galkadawala","232",786,384,402
"6115065","Kurunegala","Kotavehera","Elagammillawa","237",913,423,490
"6115070","Kurunegala","Kotavehera","Yakadapatha","236",803,391,412
"6115075","Kurunegala","Kotavehera","Kudarawaliya","251",758,359,399
"6115080","Kurunegala","Kotavehera","Moragolla","252",720,351,369
"6115085","Kurunegala","Kotavehera","Kuda Mithawa","261",405,182,223
"6115090","Kurunegala","Kotavehera","Dehennegama","260",665,333,332
"6115095","Kurunegala","Kotavehera","Ihala Weeradadana","266",640,286,354
"6115100","Kurunegala","Kotavehera","Monnekulama","265",568,245,323
"6115105","Kurunegala","Kotavehera","Kotavehera","253",1191,614,577
"6115110","Kurunegala","Kotavehera","Maha Kirinda A","245",556,259,297
"6115115","Kurunegala","Kotavehera","Maha Kirinda B","246",658,295,363
"6115120","Kurunegala","Kotavehera","Girilla","234",593,277,316
"6115125","Kurunegala","Kotavehera","Hidogama","235",574,268,306
"6115130","Kurunegala","Kotavehera","Sirisethagama","241",470,244,226
"6115135","Kurunegala","Kotavehera","Nawana","238",505,234,271
"6115140","Kurunegala","Kotavehera","Nagala","239",1179,567,612
"6115145","Kurunegala","Kotavehera","Ithewa","243",696,332,364
"6115150","Kurunegala","Kotavehera","Dodamgollegama","242",482,233,249
"6115155","Kurunegala","Kotavehera","Hulawa","240",426,201,225
"6118005","Kurunegala","Rasnayakapura","Koralayagama","270",447,220,227
"6118010","Kurunegala","Rasnayakapura","Malpanawa","269",492,232,260
"6118015","Kurunegala","Rasnayakapura","Abokkagama","263",953,463,490
"6118020","Kurunegala","Rasnayakapura","Kanuketiya","264",842,463,379
"6118025","Kurunegala","Rasnayakapura","Ambale","250",578,292,286
"6118030","Kurunegala","Rasnayakapura","Udunowa","249",527,251,276
"6118035","Kurunegala","Rasnayakapura","Galpanawa","262",537,255,282
"6118040","Kurunegala","Rasnayakapura","Halambe","268",302,160,142
"6118045","Kurunegala","Rasnayakapura","Ottukulama","279",769,382,387
"6118050","Kurunegala","Rasnayakapura","Leekolapitiya","267",660,307,353
"6118055","Kurunegala","Rasnayakapura","Agara Uda","248",279,131,148
"6118060","Kurunegala","Rasnayakapura","Udahenegama","303",797,418,379
"6118065","Kurunegala","Rasnayakapura","Rambewa","285",772,395,377
"6118070","Kurunegala","Rasnayakapura","Thalakolawewa","247",900,433,467
"6118075","Kurunegala","Rasnayakapura","Kanagullewa","277",1108,529,579
"6118080","Kurunegala","Rasnayakapura","Rasnayakapura","276",1615,806,809
"6118085","Kurunegala","Rasnayakapura","Kallanchiya","278",555,264,291
"6118090","Kurunegala","Rasnayakapura","Kuruvikulama","271",518,236,282
"6118095","Kurunegala","Rasnayakapura","Nammuwawa","291",1939,913,1026
"6118100","Kurunegala","Rasnayakapura","Niraliyadda","292",706,340,366
"6118105","Kurunegala","Rasnayakapura","Ambagammana","282",440,197,243
"6118110","Kurunegala","Rasnayakapura","Unagolla","280",903,434,469
"6118115","Kurunegala","Rasnayakapura","Kongaswalayagama","281",916,452,464
"6118120","Kurunegala","Rasnayakapura","Divullewa","290",820,403,417
"6118125","Kurunegala","Rasnayakapura","Kadigawa Track 1","273",764,362,402
"6118130","Kurunegala","Rasnayakapura","Kadigawa Track 3","272",943,428,515
"6118135","Kurunegala","Rasnayakapura","Subhasinghapura","275",1022,499,523
"6118140","Kurunegala","Rasnayakapura","Magurankadawala","274",789,383,406
"6121005","Kurunegala","Nikaweratiya","Thumbulla","302",1008,477,531
"6121010","Kurunegala","Nikaweratiya","Waduressa","308",540,268,272
"6121015","Kurunegala","Nikaweratiya","Olupeliyawa","307",736,346,390
"6121020","Kurunegala","Nikaweratiya","Kandegedara","309",1005,497,508
"6121025","Kurunegala","Nikaweratiya","Hulugalla","310",868,384,484
"6121030","Kurunegala","Nikaweratiya","Mawathagama","324",580,286,294
"6121035","Kurunegala","Nikaweratiya","Pinnapolegama","325",933,448,485
"6121040","Kurunegala","Nikaweratiya","Hulogedara","321",880,411,469
"6121045","Kurunegala","Nikaweratiya","Bogollagama","323",928,460,468
"6121050","Kurunegala","Nikaweratiya","Dalukgolla","312",950,456,494
"6121055","Kurunegala","Nikaweratiya","Ihakolagama","314",1215,581,634
"6121060","Kurunegala","Nikaweratiya","Karakole","313",982,472,510
"6121065","Kurunegala","Nikaweratiya","Hewenpelessa","299",1352,642,710
"6121070","Kurunegala","Nikaweratiya","Kivulegama","300",672,315,357
"6121075","Kurunegala","Nikaweratiya","Nabadewa","301",963,457,506
"6121080","Kurunegala","Nikaweratiya","Diyagama","298",724,342,382
"6121085","Kurunegala","Nikaweratiya","Hathigammana","305",972,454,518
"6121090","Kurunegala","Nikaweratiya","Kaluwennewa","286",588,292,296
"6121095","Kurunegala","Nikaweratiya","Heelogama","283",802,394,408
"6121100","Kurunegala","Nikaweratiya","Kebellewa","284",1028,504,524
"6121105","Kurunegala","Nikaweratiya","Budumuttawa","306",1478,707,771
"6121110","Kurunegala","Nikaweratiya","Galapitiyagama","304",1360,643,717
"6121115","Kurunegala","Nikaweratiya","Nikaweratiya North","293",1909,993,916
"6121120","Kurunegala","Nikaweratiya","Thimbiriyawa","315",871,402,469
"6121125","Kurunegala","Nikaweratiya","Galagedara","311",988,481,507
"6121130","Kurunegala","Nikaweratiya","Randenigama","322",896,405,491
"6121135","Kurunegala","Nikaweratiya","Divullegoda","329",934,475,459
"6121140","Kurunegala","Nikaweratiya","Siyambalewa","326",749,378,371
"6121145","Kurunegala","Nikaweratiya","Wasiwewa","328",575,290,285
"6121150","Kurunegala","Nikaweratiya","Kirindigalla","327",1060,524,536
"6121155","Kurunegala","Nikaweratiya","Othota Divullewa","317",1164,559,605
"6121160","Kurunegala","Nikaweratiya","Halmillewa","316",1034,506,528
"6121165","Kurunegala","Nikaweratiya","Katagamuwa","319",651,310,341
"6121170","Kurunegala","Nikaweratiya","Kumbukwewa","318",906,442,464
"6121175","Kurunegala","Nikaweratiya","Elawaka","320",875,405,470
"6121180","Kurunegala","Nikaweratiya","Magallegama","296",1340,654,686
"6121185","Kurunegala","Nikaweratiya","Millagoda","297",1531,704,827
"6121190","Kurunegala","Nikaweratiya","Nikaweratiya South","294",1516,702,814
"6121195","Kurunegala","Nikaweratiya","Viharagama","295",891,440,451
"6121200","Kurunegala","Nikaweratiya","Danduwawa","287",563,289,274
"6121205","Kurunegala","Nikaweratiya","Pahala Galapitiyagama","289",755,351,404
"6121210","Kurunegala","Nikaweratiya","Tharanagolla","288",680,339,341
"6124005","Kurunegala","Maho","Kohombakadawala","140",605,301,304
"6124010","Kurunegala","Maho","Ihalagama","138",957,436,521
"6124015","Kurunegala","Maho","Pahalagama","139",385,185,200
"6124020","Kurunegala","Maho","Moragaswewa","133",703,346,357
"6124025","Kurunegala","Maho","Konwewa","134",667,310,357
"6124030","Kurunegala","Maho","Yaddigama","136",847,412,435
"6124035","Kurunegala","Maho","Bamunugama","137",794,391,403
"6124040","Kurunegala","Maho","Kirimetiyawa","142",945,466,479
"6124045","Kurunegala","Maho","Bakmeegahawatta","141",771,379,392
"6124050","Kurunegala","Maho","Karuwalagahawatta","143",795,380,415
"6124055","Kurunegala","Maho","Makaduwawa","152",781,385,396
"6124060","Kurunegala","Maho","Thumbullegama","153",774,354,420
"6124065","Kurunegala","Maho","Hithokadawala","194",968,446,522
"6124070","Kurunegala","Maho","Thambare","195",905,435,470
"6124075","Kurunegala","Maho","Liyanagama","160",1081,539,542
"6124080","Kurunegala","Maho","Uduweriya","161",664,320,344
"6124085","Kurunegala","Maho","Maningamuwa","169",648,315,333
"6124090","Kurunegala","Maho","Ipalogama","167",879,433,446
"6124095","Kurunegala","Maho","Thammitagama","168",638,301,337
"6124100","Kurunegala","Maho","Daladagama","196",1218,645,573
"6124105","Kurunegala","Maho","Ullalapola","159",961,477,484
"6124110","Kurunegala","Maho","Atawarala","157",1102,526,576
"6124115","Kurunegala","Maho","Digana","158",815,394,421
"6124120","Kurunegala","Maho","Moonamalegama","156",930,458,472
"6124125","Kurunegala","Maho","Madurugama","150",1044,497,547
"6124130","Kurunegala","Maho","Mahawa West","149",1009,493,516
"6124135","Kurunegala","Maho","Mahawa East","148",723,346,377
"6124140","Kurunegala","Maho","Nettipalagama","146",1037,504,533
"6124145","Kurunegala","Maho","Divullewa","145",1152,546,606
"6124150","Kurunegala","Maho","Pailigama","144",985,474,511
"6124155","Kurunegala","Maho","Kattambuwawa","135",1088,513,575
"6124160","Kurunegala","Maho","Deheneggama","222",596,272,324
"6124165","Kurunegala","Maho","Karambe","223",1167,559,608
"6124170","Kurunegala","Maho","Kandubadagama","219",589,259,330
"6124175","Kurunegala","Maho","Embogama","211",720,342,378
"6124180","Kurunegala","Maho","Thalambuwa","210",679,306,373
"6124185","Kurunegala","Maho","Kumbukwewa","147",715,360,355
"6124190","Kurunegala","Maho","Kekunawa","151",1132,619,513
"6124195","Kurunegala","Maho","Rekogama","207",1062,475,587
"6124200","Kurunegala","Maho","Imbulgodayagama","198",757,363,394
"6124205","Kurunegala","Maho","Vilawa","197",902,413,489
"6124210","Kurunegala","Maho","Kumbukwewa","165",670,324,346
"6124215","Kurunegala","Maho","Konwewa","166",704,338,366
"6124220","Kurunegala","Maho","Heenuggala","164",615,291,324
"6124225","Kurunegala","Maho","Kumbukwewa","203",764,356,408
"6124230","Kurunegala","Maho","Balalla","199",881,437,444
"6124235","Kurunegala","Maho","Pahala Balalla","200",897,422,475
"6124240","Kurunegala","Maho","Thisnampalagama","208",967,444,523
"6124245","Kurunegala","Maho","Heenukwewa","212",816,387,429
"6124250","Kurunegala","Maho","Gallewa","209",1019,509,510
"6124255","Kurunegala","Maho","Galewewa","221",847,404,443
"6124260","Kurunegala","Maho","Kadambawa","220",989,474,515
"6124265","Kurunegala","Maho","Metiyakgama","224",715,328,387
"6124270","Kurunegala","Maho","Medagama","225",798,369,429
"6124275","Kurunegala","Maho","Gala Ambagaswewa","226",765,355,410
"6124280","Kurunegala","Maho","Rathmale","227",841,404,437
"6124285","Kurunegala","Maho","Dampitigama","228",616,311,305
"6124290","Kurunegala","Maho","Nagollagama","214",834,394,440
"6124295","Kurunegala","Maho","Thalagalla","213",1011,516,495
"6124300","Kurunegala","Maho","Panwewa","202",1130,547,583
"6124305","Kurunegala","Maho","Balagollagama","201",538,272,266
"6124310","Kurunegala","Maho","Ambagaswewa","204",692,329,363
"6124315","Kurunegala","Maho","Gajaneggama","205",1285,630,655
"6124320","Kurunegala","Maho","Pothuwewa","206",794,386,408
"6124325","Kurunegala","Maho","Katuwannawa","216",786,354,432
"6124330","Kurunegala","Maho","Walpaluwa","217",707,356,351
"6124335","Kurunegala","Maho","Palugaswewa","215",846,401,445
"6124340","Kurunegala","Maho","Mirihanpitigama","218",768,386,382
"6127005","Kurunegala","Polpithigama","Kumbukkadawala","333",1156,577,579
"6127010","Kurunegala","Polpithigama","Thaladapitiya","332",995,489,506
"6127015","Kurunegala","Polpithigama","Thalawa","331",867,416,451
"6127020","Kurunegala","Polpithigama","Siyambalangamuwa","330",725,365,360
"6127025","Kurunegala","Polpithigama","Bulnewa","338",895,452,443
"6127030","Kurunegala","Polpithigama","Kambuwatawana","334",989,489,500
"6127035","Kurunegala","Polpithigama","Galgiriyawa","335",689,329,360
"6127040","Kurunegala","Polpithigama","Pohorawatta","336",889,438,451
"6127045","Kurunegala","Polpithigama","Moragollagama","337",783,372,411
"6127050","Kurunegala","Polpithigama","Galahitiyagama","341",568,261,307
"6127055","Kurunegala","Polpithigama","Nikawewa","340",517,241,276
"6127060","Kurunegala","Polpithigama","Ihala Thimbiriyawa","344",912,440,472
"6127065","Kurunegala","Polpithigama","Mamunugama","345",613,298,315
"6127070","Kurunegala","Polpithigama","Pathirennegama","346",878,415,463
"6127075","Kurunegala","Polpithigama","Saliyagama","343",806,372,434
"6127080","Kurunegala","Polpithigama","Serugasyaya","339",482,228,254
"6127085","Kurunegala","Polpithigama","Herathgama","342",628,311,317
"6127090","Kurunegala","Polpithigama","Dambe","349",542,273,269
"6127095","Kurunegala","Polpithigama","Kiribamunegama","348",844,416,428
"6127100","Kurunegala","Polpithigama","Madagalla","347",714,341,373
"6127105","Kurunegala","Polpithigama","Galagedaragama","357",681,329,352
"6127110","Kurunegala","Polpithigama","Hathigamuwa","356",645,316,329
"6127115","Kurunegala","Polpithigama","Amunakole","355",884,412,472
"6127120","Kurunegala","Polpithigama","Kumbukulawa","353",1400,697,703
"6127125","Kurunegala","Polpithigama","Pallekele","351",1626,789,837
"6127130","Kurunegala","Polpithigama","Pothuvila","350",1871,943,928
"6127135","Kurunegala","Polpithigama","Rekevula","399",719,370,349
"6127140","Kurunegala","Polpithigama","Bogolla","352",686,334,352
"6127145","Kurunegala","Polpithigama","Polpithigama","354",1698,858,840
"6127150","Kurunegala","Polpithigama","Mal Asna","360",784,368,416
"6127155","Kurunegala","Polpithigama","Meegaswewa","359",701,348,353
"6127160","Kurunegala","Polpithigama","Niyandawanaya","358",627,301,326
"6127165","Kurunegala","Polpithigama","Hathpokuna","361",1005,472,533
"6127170","Kurunegala","Polpithigama","Thalpathwewa","362",1028,462,566
"6127175","Kurunegala","Polpithigama","Koruwawa","365",1167,559,608
"6127180","Kurunegala","Polpithigama","Galtenwewa","366",1400,672,728
"6127185","Kurunegala","Polpithigama","Balagolla","368",858,414,444
"6127190","Kurunegala","Polpithigama","Siyambalawewa","396",771,367,404
"6127195","Kurunegala","Polpithigama","Thalakolawewa","397",821,393,428
"6127200","Kurunegala","Polpithigama","Elagamuwa","398",863,407,456
"6127205","Kurunegala","Polpithigama","Halmillawewa","401",1619,816,803
"6127210","Kurunegala","Polpithigama","Imihaminegama","407",615,293,322
"6127215","Kurunegala","Polpithigama","Angulgamuwa","406",1038,461,577
"6127220","Kurunegala","Polpithigama","Nikawehera","400",2487,1226,1261
"6127225","Kurunegala","Polpithigama","Kosgaha Ela","393",715,341,374
"6127230","Kurunegala","Polpithigama","Hakwatunawa","395",821,378,443
"6127235","Kurunegala","Polpithigama","Rawa Ela","369",866,397,469
"6127240","Kurunegala","Polpithigama","Dagama","370",904,435,469
"6127245","Kurunegala","Polpithigama","Indigolla","367",579,297,282
"6127250","Kurunegala","Polpithigama","Dembatagala","364",1040,512,528
"6127255","Kurunegala","Polpithigama","Galketiyagama","363",750,382,368
"6127260","Kurunegala","Polpithigama","Bakmeewewa","380",832,401,431
"6127265","Kurunegala","Polpithigama","Welangolla","377",467,230,237
"6127270","Kurunegala","Polpithigama","Wanduressa","375",585,282,303
"6127275","Kurunegala","Polpithigama","Maeliya North","371",1354,671,683
"6127280","Kurunegala","Polpithigama","Agare","373",836,426,410
"6127285","Kurunegala","Polpithigama","Makulpotha","394",592,286,306
"6127290","Kurunegala","Polpithigama","Thalwehera","392",766,391,375
"6127295","Kurunegala","Polpithigama","Welipitiya","402",1336,644,692
"6127300","Kurunegala","Polpithigama","Morotta","403",774,383,391
"6127305","Kurunegala","Polpithigama","Keralankadawala","404",1143,543,600
"6127310","Kurunegala","Polpithigama","Polgahangoda","405",1040,542,498
"6127315","Kurunegala","Polpithigama","Paragaha Ela","411",538,258,280
"6127320","Kurunegala","Polpithigama","Medakanda","410",873,428,445
"6127325","Kurunegala","Polpithigama","Madahapola","409",1299,645,654
"6127330","Kurunegala","Polpithigama","Uthuruwella","390",944,472,472
"6127335","Kurunegala","Polpithigama","Rambe","374",1386,661,725
"6127340","Kurunegala","Polpithigama","Maeliya South","372",1325,628,697
"6127345","Kurunegala","Polpithigama","Dekaduwala","386",686,329,357
"6127350","Kurunegala","Polpithigama","Kalugalla","376",1261,613,648
"6127355","Kurunegala","Polpithigama","Ihala Thelambiyawa","378",944,443,501
"6127360","Kurunegala","Polpithigama","Ambagaswewa","379",816,409,407
"6127365","Kurunegala","Polpithigama","Thalamalgama","381",551,267,284
"6127370","Kurunegala","Polpithigama","Kalawana","382",1098,522,576
"6127375","Kurunegala","Polpithigama","Welidalla","383",790,390,400
"6127380","Kurunegala","Polpithigama","Ponnilawa","385",465,224,241
"6127385","Kurunegala","Polpithigama","Thambuwa","387",1425,697,728
"6127390","Kurunegala","Polpithigama","Henawa","391",767,365,402
"6127395","Kurunegala","Polpithigama","Baddegama","408",1356,651,705
"6127400","Kurunegala","Polpithigama","Hangamuwa","389",843,430,413
"6127405","Kurunegala","Polpithigama","Doraweruwa","388",1110,512,598
"6127410","Kurunegala","Polpithigama","Deegama","384",776,386,390
"6130005","Kurunegala","Ibbagamuwa","Welgala","424",1148,572,576
"6130010","Kurunegala","Ibbagamuwa","Kimbulwana Oya","423",972,471,501
"6130015","Kurunegala","Ibbagamuwa","Nelliya","427",683,310,373
"6130020","Kurunegala","Ibbagamuwa","Diddeniya","419",1109,536,573
"6130025","Kurunegala","Ibbagamuwa","Polkatuwa","420",1504,743,761
"6130030","Kurunegala","Ibbagamuwa","Diggalawatta","418",1054,492,562
"6130035","Kurunegala","Ibbagamuwa","Gurussa","416",994,466,528
"6130040","Kurunegala","Ibbagamuwa","Omaragolla","415",1155,548,607
"6130045","Kurunegala","Ibbagamuwa","Panliyadda","414",1848,900,948
"6130050","Kurunegala","Ibbagamuwa","Nabeta","413",1751,826,925
"6130055","Kurunegala","Ibbagamuwa","Ussawa","417",1258,607,651
"6130060","Kurunegala","Ibbagamuwa","Neerammulla","421",1326,624,702
"6130065","Kurunegala","Ibbagamuwa","Dewagiriya","422",964,463,501
"6130070","Kurunegala","Ibbagamuwa","Katupotha","426",639,315,324
"6130075","Kurunegala","Ibbagamuwa","Unit 3","425",1454,674,780
"6130080","Kurunegala","Ibbagamuwa","Hipawwa","439A",804,364,440
"6130085","Kurunegala","Ibbagamuwa","Thammita","438",1245,581,664
"6130090","Kurunegala","Ibbagamuwa","Thihawa","435",1251,598,653
"6130095","Kurunegala","Ibbagamuwa","Ganegoda","436",1298,617,681
"6130100","Kurunegala","Ibbagamuwa","Lenawa","494",819,400,419
"6130105","Kurunegala","Ibbagamuwa","Bandipola","499",934,431,503
"6130110","Kurunegala","Ibbagamuwa","Pitipahamuna","501",903,432,471
"6130115","Kurunegala","Ibbagamuwa","Medamulla","502",570,269,301
"6130120","Kurunegala","Ibbagamuwa","Diyathure","412",1241,615,626
"6130125","Kurunegala","Ibbagamuwa","Megodadiyathure","507",297,159,138
"6130130","Kurunegala","Ibbagamuwa","Ragedara","506",1712,842,870
"6130135","Kurunegala","Ibbagamuwa","Kendawala","504",1931,942,989
"6130140","Kurunegala","Ibbagamuwa","Mahagama","505",691,335,356
"6130145","Kurunegala","Ibbagamuwa","Puswellegama","503",478,236,242
"6130150","Kurunegala","Ibbagamuwa","Karandagolla","500",1573,743,830
"6130155","Kurunegala","Ibbagamuwa","Kahatawela","498",1086,510,576
"6130160","Kurunegala","Ibbagamuwa","Neketta","495",805,384,421
"6130165","Kurunegala","Ibbagamuwa","Godarathmale","437",387,200,187
"6130170","Kurunegala","Ibbagamuwa","Pudukkulama","493",661,317,344
"6130175","Kurunegala","Ibbagamuwa","Manapaya","439",495,249,246
"6130180","Kurunegala","Ibbagamuwa","Doluwa","489",711,339,372
"6130185","Kurunegala","Ibbagamuwa","Wewalagama","491",965,463,502
"6130190","Kurunegala","Ibbagamuwa","Deeyawa","490",795,360,435
"6130195","Kurunegala","Ibbagamuwa","Aragama","492",894,425,469
"6130200","Kurunegala","Ibbagamuwa","Nindapella","488",712,319,393
"6130205","Kurunegala","Ibbagamuwa","Ihala Gokarella","487",1043,478,565
"6130210","Kurunegala","Ibbagamuwa","Medagampola","496",866,409,457
"6130215","Kurunegala","Ibbagamuwa","Kandegedara","484",769,359,410
"6130220","Kurunegala","Ibbagamuwa","Ambanpola","497",1434,727,707
"6130225","Kurunegala","Ibbagamuwa","Meddeketiya","486",661,308,353
"6130230","Kurunegala","Ibbagamuwa","Siyambalawehera","485",1614,758,856
"6130235","Kurunegala","Ibbagamuwa","Daramitipola","482",760,372,388
"6130240","Kurunegala","Ibbagamuwa","Hiddana","483",621,296,325
"6130245","Kurunegala","Ibbagamuwa","Godagama","481",656,312,344
"6130250","Kurunegala","Ibbagamuwa","Kiribamuna","480",888,407,481
"6130255","Kurunegala","Ibbagamuwa","Periyakadu Nelawa","515",1352,630,722
"6130260","Kurunegala","Ibbagamuwa","Peddawa","475",1079,513,566
"6130265","Kurunegala","Ibbagamuwa","Muruthawa","516",1095,526,569
"6130270","Kurunegala","Ibbagamuwa","Kandulawa","479",1764,814,950
"6130275","Kurunegala","Ibbagamuwa","Ipalawa","514",1866,872,994
"6130280","Kurunegala","Ibbagamuwa","Polgolla","508",1223,550,673
"6130285","Kurunegala","Ibbagamuwa","Udathammita","509",954,465,489
"6130290","Kurunegala","Ibbagamuwa","Medagedara","510",1214,577,637
"6130295","Kurunegala","Ibbagamuwa","Thalgodapitiya","511",1829,874,955
"6130300","Kurunegala","Ibbagamuwa","Ibbagamuwa","513",1473,717,756
"6130305","Kurunegala","Ibbagamuwa","Dehelgamuwa","517",1474,703,771
"6130310","Kurunegala","Ibbagamuwa","Mahamookalanyaya","477",1075,510,565
"6130315","Kurunegala","Ibbagamuwa","Bogamuwa","476",774,383,391
"6130320","Kurunegala","Ibbagamuwa","Hangamuwa","478",1097,515,582
"6130325","Kurunegala","Ibbagamuwa","Wadupola","519",861,402,459
"6130330","Kurunegala","Ibbagamuwa","Pannala","520",1677,831,846
"6130335","Kurunegala","Ibbagamuwa","Udawela","518",2457,1184,1273
"6130340","Kurunegala","Ibbagamuwa","Kirindigalla","512",1412,684,728
"6130345","Kurunegala","Ibbagamuwa","Henegedara","525",1388,671,717
"6130350","Kurunegala","Ibbagamuwa","Madigedethilianga","526",1667,766,901
"6130355","Kurunegala","Ibbagamuwa","Galketigama","521",1616,772,844
"6130360","Kurunegala","Ibbagamuwa","Bakmeegolla","522",2039,898,1141
"6130365","Kurunegala","Ibbagamuwa","Kumbalanga","523",1922,940,982
"6130370","Kurunegala","Ibbagamuwa","Nembilikumbura","524",1572,733,839
"6133005","Kurunegala","Ganewatta","Digankonwewa","458",731,367,364
"6133010","Kurunegala","Ganewatta","Weragala","457",691,332,359
"6133015","Kurunegala","Ganewatta","Thimbiriwewa","459",745,363,382
"6133020","Kurunegala","Ganewatta","Kekulawala","451",528,259,269
"6133025","Kurunegala","Ganewatta","Divulwewa","450",650,338,312
"6133030","Kurunegala","Ganewatta","Pothuwagonna","449",806,399,407
"6133035","Kurunegala","Ganewatta","Kuda Uyangalla","454",756,371,385
"6133040","Kurunegala","Ganewatta","Uyangalla","455",976,464,512
"6133045","Kurunegala","Ganewatta","Kalatuwagama","456",969,509,460
"6133050","Kurunegala","Ganewatta","Aluthgama","453",840,427,413
"6133055","Kurunegala","Ganewatta","Seerangoda","448",754,331,423
"6133060","Kurunegala","Ganewatta","Thambagalla","445",1823,865,958
"6133065","Kurunegala","Ganewatta","Pannawa","446",1209,589,620
"6133070","Kurunegala","Ganewatta","Nelawa","452",1169,580,589
"6133075","Kurunegala","Ganewatta","Makulmade","462",617,281,336
"6133080","Kurunegala","Ganewatta","Neeraviya","441",1158,566,592
"6133085","Kurunegala","Ganewatta","Waduwawa","443",793,374,419
"6133090","Kurunegala","Ganewatta","Santhanagama","430",1286,611,675
"6133095","Kurunegala","Ganewatta","Kumbukgete","429",1041,491,550
"6133100","Kurunegala","Ganewatta","Hettigama","432",1187,548,639
"6133105","Kurunegala","Ganewatta","Boraluwa","431",942,411,531
"6133110","Kurunegala","Ganewatta","Nikagolla","434",1158,535,623
"6133115","Kurunegala","Ganewatta","Thittawella","433",987,473,514
"6133120","Kurunegala","Ganewatta","Jahapagama","428",613,285,328
"6133125","Kurunegala","Ganewatta","Neriyawa","444",1267,603,664
"6133130","Kurunegala","Ganewatta","Arankele","440",665,328,337
"6133135","Kurunegala","Ganewatta","Thittawelgala","442",1491,733,758
"6133140","Kurunegala","Ganewatta","Nikadalupotha","461",1492,700,792
"6133145","Kurunegala","Ganewatta","Hiripitiya","460",1301,628,673
"6133150","Kurunegala","Ganewatta","Hidawewa","463",813,375,438
"6133155","Kurunegala","Ganewatta","Nelumpathgama","447",351,175,176
"6133160","Kurunegala","Ganewatta","Malagamuwa","464",792,369,423
"6133165","Kurunegala","Ganewatta","Othuwela","466",948,465,483
"6133170","Kurunegala","Ganewatta","Moragolla","468",1353,657,696
"6133175","Kurunegala","Ganewatta","Hunupola","467",865,418,447
"6133180","Kurunegala","Ganewatta","Wegolla","465",1019,502,517
"6133185","Kurunegala","Ganewatta","Makulwewa","469",933,433,500
"6133190","Kurunegala","Ganewatta","Thanthirigama","470",559,264,295
"6133195","Kurunegala","Ganewatta","Kirindiwelmada/ Galagedara","471",1387,680,707
"6133200","Kurunegala","Ganewatta","Seeradunna","473",846,404,442
"6133205","Kurunegala","Ganewatta","Kanawa","474",934,449,485
"6133210","Kurunegala","Ganewatta","Pothuvila","472",692,332,360
"6136005","Kurunegala","Wariyapola","Halmillewa","1287",962,479,483
"6136010","Kurunegala","Wariyapola","Thennakongama","1284",793,392,401
"6136015","Kurunegala","Wariyapola","Kelegama","1283",996,462,534
"6136020","Kurunegala","Wariyapola","Konotta","1280",931,435,496
"6136025","Kurunegala","Wariyapola","Ebawalapitiya","1257",1112,549,563
"6136030","Kurunegala","Wariyapola","Mellapotta","1258",1031,498,533
"6136035","Kurunegala","Wariyapola","Wanduressa Welgala","1259",695,341,354
"6136040","Kurunegala","Wariyapola","Walpaluwa","1254",914,426,488
"6136045","Kurunegala","Wariyapola","Minuwangete","1253",1276,627,649
"6136050","Kurunegala","Wariyapola","Nelliya","1252",552,255,297
"6136055","Kurunegala","Wariyapola","Deegithawa","1279",1209,578,631
"6136060","Kurunegala","Wariyapola","Karagaswewa","1277",909,449,460
"6136065","Kurunegala","Wariyapola","Wanduressa","1278",971,455,516
"6136070","Kurunegala","Wariyapola","Karandawetiya","1288",655,311,344
"6136075","Kurunegala","Wariyapola","Ethawa","1289",1490,696,794
"6136080","Kurunegala","Wariyapola","Welawa","1286",705,325,380
"6136085","Kurunegala","Wariyapola","Rabukana","1285",612,289,323
"6136090","Kurunegala","Wariyapola","Avulegama","1273",946,478,468
"6136095","Kurunegala","Wariyapola","Bayawa","1282",1215,582,633
"6136100","Kurunegala","Wariyapola","Muwanwellegedara","1272",783,356,427
"6136105","Kurunegala","Wariyapola","Magulagama","1267",1147,548,599
"6136110","Kurunegala","Wariyapola","Divulakele","1276",910,416,494
"6136115","Kurunegala","Wariyapola","Werella","1281",1575,721,854
"6136120","Kurunegala","Wariyapola","Naramana","1271",1545,735,810
"6136125","Kurunegala","Wariyapola","Thambarawa","1255",1052,491,561
"6136130","Kurunegala","Wariyapola","Pothuwewa","1256",538,276,262
"6136135","Kurunegala","Wariyapola","Netiya","1251",1188,577,611
"6136140","Kurunegala","Wariyapola","Thissawa","1200",622,301,321
"6136145","Kurunegala","Wariyapola","Amunugama","1199",1185,580,605
"6136150","Kurunegala","Wariyapola","Goluwawa","1198",763,366,397
"6136155","Kurunegala","Wariyapola","Kithulwehera","1250",1571,782,789
"6136160","Kurunegala","Wariyapola","Ipalawa","1249",1156,556,600
"6136165","Kurunegala","Wariyapola","Mamunuwa","1270",1664,797,867
"6136170","Kurunegala","Wariyapola","Padeniya","1268",1252,612,640
"6136175","Kurunegala","Wariyapola","Madatuwa","1269",1385,651,734
"6136180","Kurunegala","Wariyapola","Pattalegedara","1266",887,436,451
"6136185","Kurunegala","Wariyapola","Mirihanegama","1274",738,368,370
"6136190","Kurunegala","Wariyapola","Nabadawewa","1275",740,348,392
"6136195","Kurunegala","Wariyapola","Kahagolla","1265",828,409,419
"6136200","Kurunegala","Wariyapola","Habarawa","1264",1040,492,548
"6136205","Kurunegala","Wariyapola","Ambakadawara","1263",961,454,507
"6136210","Kurunegala","Wariyapola","Pennithawa","1262",1073,510,563
"6136215","Kurunegala","Wariyapola","Hettigedara","1261",700,323,377
"6136220","Kurunegala","Wariyapola","Medagama","1260",1101,497,604
"6136225","Kurunegala","Wariyapola","Ginipendegama","1246",1612,781,831
"6136230","Kurunegala","Wariyapola","Wariyapola","1245",2184,1128,1056
"6136235","Kurunegala","Wariyapola","Rathmale","1247",991,483,508
"6136240","Kurunegala","Wariyapola","Piyumgalla","1248",976,485,491
"6136245","Kurunegala","Wariyapola","Elavitigama","1242",1175,548,627
"6136250","Kurunegala","Wariyapola","Wewagedara","1243",2000,1211,789
"6136255","Kurunegala","Wariyapola","Randeniya","1244",1013,494,519
"6136260","Kurunegala","Wariyapola","Werapola","1237",1905,911,994
"6136265","Kurunegala","Wariyapola","Horombuwa","1240",1131,555,576
"6136270","Kurunegala","Wariyapola","Vilakatupotha","1239",1441,689,752
"6136275","Kurunegala","Wariyapola","Embawa","1241",738,351,387
"6136280","Kurunegala","Wariyapola","Malwana","1235",1881,945,936
"6139005","Kurunegala","Kobeigane","Hathalawa","1321",1021,503,518
"6139010","Kurunegala","Kobeigane","Makeliyawa","1315",1316,632,684
"6139015","Kurunegala","Kobeigane","Mawathagama","1310",1035,505,530
"6139020","Kurunegala","Kobeigane","Hengamuwa","1309",1006,477,529
"6139025","Kurunegala","Kobeigane","Waduressa","1305",979,478,501
"6139030","Kurunegala","Kobeigane","Wannigama","1304",1145,552,593
"6139035","Kurunegala","Kobeigane","Vithikuliya","1303",1361,662,699
"6139040","Kurunegala","Kobeigane","Beddegama","1290",1099,553,546
"6139045","Kurunegala","Kobeigane","Pubbiliya","1293",1016,517,499
"6139050","Kurunegala","Kobeigane","Kandattawa","1306",1034,482,552
"6139055","Kurunegala","Kobeigane","Amunakole","1307",1046,500,546
"6139060","Kurunegala","Kobeigane","Kithagama","1312",777,396,381
"6139065","Kurunegala","Kobeigane","Thelahera","1314",1108,549,559
"6139070","Kurunegala","Kobeigane","Assedduma","1322",763,379,384
"6139075","Kurunegala","Kobeigane","Leekolawewa","1320",702,330,372
"6139080","Kurunegala","Kobeigane","Kahatagaswewa","1323",869,404,465
"6139085","Kurunegala","Kobeigane","Welpothuwewa","1324",1474,696,778
"6139090","Kurunegala","Kobeigane","Boraluwewa","1318",965,483,482
"6139095","Kurunegala","Kobeigane","Maulla","1319",832,412,420
"6139100","Kurunegala","Kobeigane","Beliwewa","1316",901,434,467
"6139105","Kurunegala","Kobeigane","Bakunawala","1317",857,445,412
"6139110","Kurunegala","Kobeigane","Alahenegama","1313",649,307,342
"6139115","Kurunegala","Kobeigane","Aralugaswewa","1308",960,481,479
"6139120","Kurunegala","Kobeigane","Walaswewa","1292",925,437,488
"6139125","Kurunegala","Kobeigane","Pannawa","1291",2085,981,1104
"6139130","Kurunegala","Kobeigane","Galatabendiwewa","1295",886,424,462
"6139135","Kurunegala","Kobeigane","Bamunugama","1294",1333,662,671
"6139140","Kurunegala","Kobeigane","Hirigolla","1302",1091,541,550
"6139145","Kurunegala","Kobeigane","Kobeigane","1301",1082,533,549
"6139150","Kurunegala","Kobeigane","Holambalewa","1311",974,456,518
"6139155","Kurunegala","Kobeigane","Halmillakotuwa","1299",1179,571,608
"6139160","Kurunegala","Kobeigane","Kattapitiya","1300",885,425,460
"6139165","Kurunegala","Kobeigane","Baladora","1298",1057,503,554
"6139170","Kurunegala","Kobeigane","Midellawa","1296",848,417,431
"6139175","Kurunegala","Kobeigane","Hindagahawewa","1297",715,346,369
"6142005","Kurunegala","Bingiriya","Molaeliya","1455",948,448,500
"6142010","Kurunegala","Bingiriya","Getulawa","1456",1733,841,892
"6142015","Kurunegala","Bingiriya","Pahala Thalampola","1446",1210,596,614
"6142020","Kurunegala","Bingiriya","Ihala Konkandawala","1448",1524,726,798
"6142025","Kurunegala","Bingiriya","Bandarigalgoda","1444",1061,522,539
"6142030","Kurunegala","Bingiriya","Manelembuwa","1443",992,477,515
"6142035","Kurunegala","Bingiriya","Pahala Kiniyama","1449",918,447,471
"6142040","Kurunegala","Bingiriya","Kiniyama East","1450",913,456,457
"6142045","Kurunegala","Bingiriya","Kiniyama West","1451",1682,837,845
"6142050","Kurunegala","Bingiriya","Puwakgahakadawala","1447",888,434,454
"6142055","Kurunegala","Bingiriya","Weerapokuna","1445",1035,484,551
"6142060","Kurunegala","Bingiriya","Koshenagara","1454",1213,564,649
"6142065","Kurunegala","Bingiriya","Ihala Galwewa","1453",861,415,446
"6142070","Kurunegala","Bingiriya","Pahala Galwewa","1452",1092,518,574
"6142075","Kurunegala","Bingiriya","Urapotta","1458",903,424,479
"6142080","Kurunegala","Bingiriya","Brahmanayagama","1457",497,222,275
"6142085","Kurunegala","Bingiriya","Hendiyapola","1440",1163,538,625
"6142090","Kurunegala","Bingiriya","Karandanayagama","1441",1439,703,736
"6142095","Kurunegala","Bingiriya","Kosagama","1442",1091,519,572
"6142100","Kurunegala","Bingiriya","Wanduressa","1467",1033,524,509
"6142105","Kurunegala","Bingiriya","Pahala Koswatta","1465",781,383,398
"6142110","Kurunegala","Bingiriya","Maunawa","1462",930,427,503
"6142115","Kurunegala","Bingiriya","Bowatta","1463",1635,759,876
"6142120","Kurunegala","Bingiriya","Panawewa","1464",1577,790,787
"6142125","Kurunegala","Bingiriya","Mookalanhena","1461",1683,671,1012
"6142130","Kurunegala","Bingiriya","Murukandiya","1460",665,304,361
"6142135","Kurunegala","Bingiriya","Bingiriya","1459",1221,595,626
"6142140","Kurunegala","Bingiriya","Vilattawa Palatha","1478",1268,614,654
"6142145","Kurunegala","Bingiriya","Aluthgama","1479",1416,694,722
"6142150","Kurunegala","Bingiriya","Ihala Kalugama","1476",1606,776,830
"6142155","Kurunegala","Bingiriya","Wellarawa","1468",1689,817,872
"6142160","Kurunegala","Bingiriya","Bakmeeruppa","1469",1491,719,772
"6142165","Kurunegala","Bingiriya","Hiruwalpola","1475",1235,605,630
"6142170","Kurunegala","Bingiriya","Kaduruwewa","1477",2357,1176,1181
"6142175","Kurunegala","Bingiriya","Horagasagara","1473",1205,610,595
"6142180","Kurunegala","Bingiriya","Ihala Kadigamuwa","1480",2305,1126,1179
"6142185","Kurunegala","Bingiriya","Ihala Koswatta","1466",2098,981,1117
"6142190","Kurunegala","Bingiriya","Nithalawa","1439",1247,588,659
"6142195","Kurunegala","Bingiriya","Kudakalawa","1438",1058,503,555
"6142200","Kurunegala","Bingiriya","Tharana","1434",1285,608,677
"6142205","Kurunegala","Bingiriya","Konkadawala","1429",1363,667,696
"6142210","Kurunegala","Bingiriya","Hamannapahuwa","1430",879,387,492
"6142215","Kurunegala","Bingiriya","Kurundupotha","1431",1243,600,643
"6142220","Kurunegala","Bingiriya","Madulupitiya","1428",782,366,416
"6142225","Kurunegala","Bingiriya","Udawela","1435",1400,644,756
"6142230","Kurunegala","Bingiriya","Meladeniya","1437",676,309,367
"6142235","Kurunegala","Bingiriya","Padiwela","1436",1110,535,575
"6142240","Kurunegala","Bingiriya","Kelegedara","1432",830,393,437
"6142245","Kurunegala","Bingiriya","Thorabichchiya","1433",804,384,420
"6142250","Kurunegala","Bingiriya","Heenpannawa","1481",862,391,471
"6142255","Kurunegala","Bingiriya","Pahala Kadigamuwa","1482",907,426,481
"6142260","Kurunegala","Bingiriya","Pahala Mandakondana","1474",545,256,289
"6145005","Kurunegala","Panduwasnuwara West","Kahatavila","1326",1003,481,522
"6145010","Kurunegala","Panduwasnuwara West","Madaina","1329",838,407,431
"6145015","Kurunegala","Panduwasnuwara West","Dothella","1325",1223,597,626
"6145020","Kurunegala","Panduwasnuwara West","Ganegama","1328",725,356,369
"6145025","Kurunegala","Panduwasnuwara West","Mandapola","1351",1218,583,635
"6145030","Kurunegala","Panduwasnuwara West","Konwewa","1350",1514,718,796
"6145035","Kurunegala","Panduwasnuwara West","Rambewa","1349",633,311,322
"6145040","Kurunegala","Panduwasnuwara West","Madulla","1327",820,390,430
"6145045","Kurunegala","Panduwasnuwara West","Wadumunna","1331",1160,571,589
"6145050","Kurunegala","Panduwasnuwara West","Akurana","1330",924,450,474
"6145055","Kurunegala","Panduwasnuwara West","Yodhayakanda","1427",541,277,264
"6145060","Kurunegala","Panduwasnuwara West","Udagama","1426",994,487,507
"6145065","Kurunegala","Panduwasnuwara West","Karandawa","1425",796,383,413
"6145070","Kurunegala","Panduwasnuwara West","Pallegama","1332",881,434,447
"6145075","Kurunegala","Panduwasnuwara West","Divulwewa","1335",750,350,400
"6145080","Kurunegala","Panduwasnuwara West","Girathalana","1334",1166,559,607
"6145085","Kurunegala","Panduwasnuwara West","Nikapitiya","1348",1055,525,530
"6145090","Kurunegala","Panduwasnuwara West","Othegama","1352",911,455,456
"6145095","Kurunegala","Panduwasnuwara West","Diggalagedara","1353",908,440,468
"6145100","Kurunegala","Panduwasnuwara West","Dorabavila","1354",1046,507,539
"6145105","Kurunegala","Panduwasnuwara West","Nallura","1356",1126,507,619
"6145110","Kurunegala","Panduwasnuwara West","Palugaswewa","1358",1033,521,512
"6145115","Kurunegala","Panduwasnuwara West","Madige Midiyala","1357",2342,1098,1244
"6145120","Kurunegala","Panduwasnuwara West","Midiyala","1360",1474,762,712
"6145125","Kurunegala","Panduwasnuwara West","Hidagahawewa","1359",925,431,494
"6145130","Kurunegala","Panduwasnuwara West","Hammaliya","1361",1388,677,711
"6145135","Kurunegala","Panduwasnuwara West","Bandara Koswatta","1372",934,449,485
"6145140","Kurunegala","Panduwasnuwara West","Hathapola","1371",878,420,458
"6145145","Kurunegala","Panduwasnuwara West","Kadawalagedara","1355",1468,696,772
"6145150","Kurunegala","Panduwasnuwara West","Panduwasnuwara","1346",1017,505,512
"6145155","Kurunegala","Panduwasnuwara West","Kotambapitiya","1347",1385,676,709
"6145160","Kurunegala","Panduwasnuwara West","Hettipola","1336",1400,696,704
"6145165","Kurunegala","Panduwasnuwara West","Dolahamuna","1337",1117,529,588
"6145170","Kurunegala","Panduwasnuwara West","Munihirigama","1333",940,492,448
"6145175","Kurunegala","Panduwasnuwara West","Kevitiya","1422",792,387,405
"6145180","Kurunegala","Panduwasnuwara West","Pepolegama","1424",592,264,328
"6145185","Kurunegala","Panduwasnuwara West","Hanthihawa","1423",939,439,500
"6145190","Kurunegala","Panduwasnuwara West","Barampola","1421",903,446,457
"6145195","Kurunegala","Panduwasnuwara West","Hettigama","1418",785,397,388
"6145200","Kurunegala","Panduwasnuwara West","Ehetumulla","1420",918,438,480
"6145205","Kurunegala","Panduwasnuwara West","Kurundu Kumbura","1338",1621,781,840
"6145210","Kurunegala","Panduwasnuwara West","Bogolla","1339",990,488,502
"6145215","Kurunegala","Panduwasnuwara West","Bamunumulla","1343",764,371,393
"6145220","Kurunegala","Panduwasnuwara West","Meegaspitiya","1345",687,317,370
"6145225","Kurunegala","Panduwasnuwara West","Yayegedara","1370",1029,531,498
"6148226","Kurunegala","Panduwasnuwara West","Moragolla","1344",829,403,426
"6148227","Kurunegala","Panduwasnuwara West","Rideekanda","1342",984,486,498
"6148228","Kurunegala","Panduwasnuwara West","Thengodagedara","1341",567,271,296
"6145230","Kurunegala","Panduwasnuwara West","Tekewa","1340",727,348,379
"6145235","Kurunegala","Panduwasnuwara West","Rittadeniya","1412",675,316,359
"6145240","Kurunegala","Panduwasnuwara West","Jayasiripura","1419",904,456,448
"6145245","Kurunegala","Panduwasnuwara West","Pihimbiya","1416",620,288,332
"6145250","Kurunegala","Panduwasnuwara West","Rathmale","1417",1099,507,592
"6145255","Kurunegala","Panduwasnuwara West","Nagollagoda","1414",749,359,390
"6145260","Kurunegala","Panduwasnuwara West","Ambagahagedara","1415",683,346,337
"6145265","Kurunegala","Panduwasnuwara West","Dahanekgedara","1413",1087,527,560
"6145270","Kurunegala","Panduwasnuwara West","Ebogedara","1409",730,355,375
"6145275","Kurunegala","Panduwasnuwara West","Doratiyagedara","1411",841,404,437
"6145280","Kurunegala","Panduwasnuwara West","Akarawatta","1401",951,434,517
"6145285","Kurunegala","Panduwasnuwara West","Malwanegedara","1400",818,387,431
"6145290","Kurunegala","Panduwasnuwara West","Moonamaldeniya","1399",567,271,296
"6145295","Kurunegala","Panduwasnuwara West","Kamburapola","1402",1075,521,554
"6145300","Kurunegala","Panduwasnuwara West","Pahala Gomugomuwa","1396",1134,549,585
"6145305","Kurunegala","Panduwasnuwara West","Ihala Gomugomuwa","1395",946,442,504
"6145310","Kurunegala","Panduwasnuwara West","Hidiyamulla","1405",1161,551,610
"6145315","Kurunegala","Panduwasnuwara West","Karagahagedara","1398",1515,720,795
"6145320","Kurunegala","Panduwasnuwara West","Epaladeniya","1397",907,420,487
"6148020","Kurunegala","Panduwasnuwara East","Medagama","1375",822,375,447
"6148025","Kurunegala","Panduwasnuwara East","Kosdeniya","1377",752,361,391
"6148030","Kurunegala","Panduwasnuwara East","Wilbagedara","1373",784,379,405
"6148035","Kurunegala","Panduwasnuwara East","Hanwella","1374",684,315,369
"6148040","Kurunegala","Panduwasnuwara East","Palavitiya","1369",813,379,434
"6148045","Kurunegala","Panduwasnuwara East","Kolambagama","1363",919,473,446
"6148050","Kurunegala","Panduwasnuwara East","Gallehepitiya","1362",1499,708,791
"6148055","Kurunegala","Panduwasnuwara East","Ranorawa","1365",965,451,514
"6148060","Kurunegala","Panduwasnuwara East","Katumuluwa","1364",758,353,405
"6148065","Kurunegala","Panduwasnuwara East","Maveehena","1367",772,362,410
"6148070","Kurunegala","Panduwasnuwara East","Rathmalla","1366",960,443,517
"6148075","Kurunegala","Panduwasnuwara East","Dunupotha","1368",997,490,507
"6148080","Kurunegala","Panduwasnuwara East","Beddegama","1376",731,364,367
"6148085","Kurunegala","Panduwasnuwara East","Thissawa","1378",985,486,499
"6148090","Kurunegala","Panduwasnuwara East","Nelibewa","1384",523,267,256
"6148095","Kurunegala","Panduwasnuwara East","Dematawa","1385",668,314,354
"6148100","Kurunegala","Panduwasnuwara East","Kanduboda","1410",1109,536,573
"6148105","Kurunegala","Panduwasnuwara East","Henegedara","1407",839,413,426
"6148110","Kurunegala","Panduwasnuwara East","Magulagama","1408",1005,463,542
"6148115","Kurunegala","Panduwasnuwara East","Angamuwa","1386",963,463,500
"6148120","Kurunegala","Panduwasnuwara East","Anukkanhena","1406",913,437,476
"6148125","Kurunegala","Panduwasnuwara East","Moragane","1383",902,430,472
"6148130","Kurunegala","Panduwasnuwara East","Kanapothuhera","1382",603,274,329
"6148135","Kurunegala","Panduwasnuwara East","Kanogama","1379",564,268,296
"6148140","Kurunegala","Panduwasnuwara East","Kandegedara","1380",528,251,277
"6148145","Kurunegala","Panduwasnuwara East","Galagedara","1381",730,355,375
"6148150","Kurunegala","Panduwasnuwara East","Adukkane","1392",727,342,385
"6148155","Kurunegala","Panduwasnuwara East","Udugampalagedara","1393",410,195,215
"6148160","Kurunegala","Panduwasnuwara East","Weliwehera","1389",825,411,414
"6148165","Kurunegala","Panduwasnuwara East","Gonnawa","1388",1482,739,743
"6148170","Kurunegala","Panduwasnuwara East","Bodhimulla","1403",751,370,381
"6148175","Kurunegala","Panduwasnuwara East","Nindawela","1404",718,349,369
"6148180","Kurunegala","Panduwasnuwara East","Wijaya Udagama","1387",727,339,388
"6148185","Kurunegala","Panduwasnuwara East","Wetehepitiya","1394",710,361,349
"6148190","Kurunegala","Panduwasnuwara East","Hindawa","1391",1029,505,524
"6148195","Kurunegala","Panduwasnuwara East","Kanoyaya","1390",839,380,459
"6149005","Kurunegala","Bamunakotuwa","Erihabe","1234",655,316,339
"6149010","Kurunegala","Bamunakotuwa","Panawa","1236",596,293,303
"6149015","Kurunegala","Bamunakotuwa","Pahala Imiyangoda","1238",969,450,519
"6149020","Kurunegala","Bamunakotuwa","Walpola","1215",1487,717,770
"6149025","Kurunegala","Bamunakotuwa","Mahakeliya","1212",1324,619,705
"6149030","Kurunegala","Bamunakotuwa","Kelimune","1213",2353,1104,1249
"6149035","Kurunegala","Bamunakotuwa","Nathagane","1214",708,334,374
"6149040","Kurunegala","Bamunakotuwa","Kadiharaya","1216",1472,696,776
"6149045","Kurunegala","Bamunakotuwa","Bamunakotuwa","1233",1027,514,513
"6149050","Kurunegala","Bamunakotuwa","Moonamale","1232",800,359,441
"6149055","Kurunegala","Bamunakotuwa","Thalgahagama","1231",1008,474,534
"6149060","Kurunegala","Bamunakotuwa","Ganthiriyawa","1230",801,351,450
"6149065","Kurunegala","Bamunakotuwa","Panakaduwa","1228",801,373,428
"6149070","Kurunegala","Bamunakotuwa","Pahala Kolamunna","1229",1003,499,504
"6149075","Kurunegala","Bamunakotuwa","Wathukana","1226",949,437,512
"6149080","Kurunegala","Bamunakotuwa","Nelunkanuwa","1223",1007,469,538
"6149085","Kurunegala","Bamunakotuwa","Weudagama","1227",375,175,200
"6149090","Kurunegala","Bamunakotuwa","Panagamuwa","1222",817,406,411
"6149095","Kurunegala","Bamunakotuwa","Panadare","1224",698,327,371
"6149100","Kurunegala","Bamunakotuwa","Walaliya","1217",1713,805,908
"6149105","Kurunegala","Bamunakotuwa","Kedapath Vehera","1218",1241,609,632
"6149110","Kurunegala","Bamunakotuwa","Rukattane","1208",431,214,217
"6149115","Kurunegala","Bamunakotuwa","Bogoda","1207",698,327,371
"6149120","Kurunegala","Bamunakotuwa","Hanhamunawa","1202",1652,798,854
"6149125","Kurunegala","Bamunakotuwa","Nawagatta","1209",1283,586,697
"6149130","Kurunegala","Bamunakotuwa","Mirihampitiya","1211",1298,629,669
"6149135","Kurunegala","Bamunakotuwa","Henegedara","1225",1516,690,826
"6149140","Kurunegala","Bamunakotuwa","Dampitiya","1219",661,319,342
"6149145","Kurunegala","Bamunakotuwa","Ethanawatta","1210",593,276,317
"6149150","Kurunegala","Bamunakotuwa","Wedanda","1201",1154,568,586
"6149155","Kurunegala","Bamunakotuwa","Pallawa Dampitiya","1203",907,455,452
"6149160","Kurunegala","Bamunakotuwa","Demataluwa","1206",1465,724,741
"6149165","Kurunegala","Bamunakotuwa","Kanotuwa","1205",1124,574,550
"6149170","Kurunegala","Bamunakotuwa","Siwallawagedara","1220",360,168,192
"6149175","Kurunegala","Bamunakotuwa","Homathagama","1221",581,266,315
"6149180","Kurunegala","Bamunakotuwa","Divulgaspitiya","1204",690,342,348
"6151005","Kurunegala","Maspotha","Wilgamdematawa","778",988,475,513
"6151010","Kurunegala","Maspotha","Gonagama","776",982,456,526
"6151015","Kurunegala","Maspotha","Rekawa","773",842,411,431
"6151020","Kurunegala","Maspotha","Pimburuwellegama","777",368,178,190
"6151025","Kurunegala","Maspotha","Galagedara","774",904,432,472
"6151030","Kurunegala","Maspotha","Minhettiya","775",752,365,387
"6151035","Kurunegala","Maspotha","Hanwella","784",691,330,361
"6151040","Kurunegala","Maspotha","Maragama","781",566,275,291
"6151045","Kurunegala","Maspotha","Wegolla","779",453,214,239
"6151050","Kurunegala","Maspotha","Oggamuwa","780",1005,478,527
"6151055","Kurunegala","Maspotha","Thisnampola","785",542,257,285
"6151060","Kurunegala","Maspotha","Kudagalgamuwa","786",1108,526,582
"6151065","Kurunegala","Maspotha","Gane Kolaniya","794",833,405,428
"6151070","Kurunegala","Maspotha","Kidapola","790",1440,689,751
"6151075","Kurunegala","Maspotha","Demalussa","783",359,168,191
"6151080","Kurunegala","Maspotha","Maspotha","782",1304,614,690
"6151085","Kurunegala","Maspotha","Rathkarawwa","789",1546,757,789
"6151090","Kurunegala","Maspotha","Mapegamuwa","793",657,325,332
"6151095","Kurunegala","Maspotha","Dahigamuwa","795",768,361,407
"6151100","Kurunegala","Maspotha","Siyambalangamuwa","791",1562,736,826
"6151105","Kurunegala","Maspotha","Gurulepola","792",1129,513,616
"6151110","Kurunegala","Maspotha","Pellandeniya","787",1443,712,731
"6151115","Kurunegala","Maspotha","Hettigedara","788",2191,1039,1152
"6151120","Kurunegala","Maspotha","Wawagedara","796",777,354,423
"6151125","Kurunegala","Maspotha","Kalahogedara","798",1428,673,755
"6151130","Kurunegala","Maspotha","Maveedalupotha","799",1584,762,822
"6151135","Kurunegala","Maspotha","Udabadalawa","802",1036,489,547
"6151140","Kurunegala","Maspotha","Thiththawella","800",1341,643,698
"6151145","Kurunegala","Maspotha","Udadigana","801",559,266,293
"6151150","Kurunegala","Maspotha","Yanthampalawa","810",988,457,531
"6151160","Kurunegala","Maspotha","Aswedduma","803",2179,991,1188
"6151165","Kurunegala","Maspotha","Dematagahapelessa","804",887,448,439
"6154005","Kurunegala","Kurunegala","Kalatuwa Pelessa","769",641,294,347
"6154010","Kurunegala","Kurunegala","Seeradunna","770",659,317,342
"6154015","Kurunegala","Kurunegala","Seruwawa","767",812,418,394
"6154020","Kurunegala","Kurunegala","Pubbowa","768",718,324,394
"6154025","Kurunegala","Kurunegala","Thalvita","766",997,475,522
"6154030","Kurunegala","Kurunegala","Waraddana","763",966,475,491
"6154035","Kurunegala","Kurunegala","Pahala Waraddana","765",890,449,441
"6154040","Kurunegala","Kurunegala","Rangama","764",1075,511,564
"6154045","Kurunegala","Kurunegala","Wellawa","759",1383,680,703
"6154050","Kurunegala","Kurunegala","Ginikarawa","771",985,448,537
"6154055","Kurunegala","Kurunegala","Pahala Hadirawalana","757",889,426,463
"6154060","Kurunegala","Kurunegala","Thalatuwa","758",835,405,430
"6154065","Kurunegala","Kurunegala","Rikillagamuwa","761",1041,497,544
"6154070","Kurunegala","Kurunegala","Dematagolla","760",733,350,383
"6154075","Kurunegala","Kurunegala","Budanapitiya","762",1708,821,887
"6154080","Kurunegala","Kurunegala","Hadirawalana  Ihala","756",790,382,408
"6154085","Kurunegala","Kurunegala","Mahakandegama","772",787,360,427
"6154090","Kurunegala","Kurunegala","Alakoladeniya","820",1391,681,710
"6154095","Kurunegala","Kurunegala","Bamunugedara","797",2896,1325,1571
"6154100","Kurunegala","Kurunegala","Kurunegala Town - North East","834",3311,1624,1687
"6154105","Kurunegala","Kurunegala","Kurunegala Town - North","831",1441,754,687
"6154110","Kurunegala","Kurunegala","Gangoda","832",2020,843,1177
"6154115","Kurunegala","Kurunegala","Vilgoda","811",1465,717,748
"6154120","Kurunegala","Kurunegala","Heraliyawala","817",1636,797,839
"6154125","Kurunegala","Kurunegala","Bamunawala","815",3243,1556,1687
"6154130","Kurunegala","Kurunegala","Malkaduwawa","816",2386,1102,1284
"6154135","Kurunegala","Kurunegala","Malkaduwawa South","818",1485,706,779
"6154140","Kurunegala","Kurunegala","Malkaduwawa North","819",1972,958,1014
"6154145","Kurunegala","Kurunegala","Kurunegala Town - West","837",3717,1739,1978
"6154150","Kurunegala","Kurunegala","Iluppugedara","838",3314,1649,1665
"6154155","Kurunegala","Kurunegala","Kurunegala Town - Central","839",1304,647,657
"6154160","Kurunegala","Kurunegala","Kurunegala Town - Bazaar","840",475,363,112
"6154165","Kurunegala","Kurunegala","Gettuwana","833",1661,782,879
"6154170","Kurunegala","Kurunegala","Kurunegala Town - East","835",1531,740,791
"6154175","Kurunegala","Kurunegala","Theliyagonna","836",2745,1314,1431
"6154180","Kurunegala","Kurunegala","Udawalpola","842",1378,691,687
"6154185","Kurunegala","Kurunegala","Kurunegala Town - South","841",1936,904,1032
"6154190","Kurunegala","Kurunegala","Veherabenda","808",1479,709,770
"6154195","Kurunegala","Kurunegala","Henamulla","807",1262,597,665
"6154200","Kurunegala","Kurunegala","Wehera East","805",1438,682,756
"6154205","Kurunegala","Kurunegala","Wehera West","806",1213,561,652
"6154210","Kurunegala","Kurunegala","Akaragana North","813",983,479,504
"6154215","Kurunegala","Kurunegala","Wanduragala","812",810,388,422
"6154220","Kurunegala","Kurunegala","Rathgalla","821",1338,666,672
"6154225","Kurunegala","Kurunegala","Boyagane","829",1325,641,684
"6154230","Kurunegala","Kurunegala","Akaragana South","814",1579,710,869
"6154235","Kurunegala","Kurunegala","Vilbawa","822",1566,762,804
"6154240","Kurunegala","Kurunegala","Nailiya","823",1932,935,997
"6154245","Kurunegala","Kurunegala","Madithiyawala","830",2247,1032,1215
"6154250","Kurunegala","Kurunegala","Thorawathura","827",1335,646,689
"6154255","Kurunegala","Kurunegala","Mathawa","828",2117,1021,1096
"6154260","Kurunegala","Kurunegala","Attanapitiya","825",807,377,430
"6154265","Kurunegala","Kurunegala","Pahala Thalampitiya","824",786,365,421
"6154270","Kurunegala","Kurunegala","Kudumbuwa","826",1322,639,683
"6157005","Kurunegala","Mallawapitiya","Meddegama West","729",1036,509,527
"6157010","Kurunegala","Mallawapitiya","Udagama","730",867,395,472
"6157015","Kurunegala","Mallawapitiya","Pillawa","724",1648,805,843
"6157020","Kurunegala","Mallawapitiya","Hengawa","726",994,489,505
"6157025","Kurunegala","Mallawapitiya","Narampola","725",1201,560,641
"6157030","Kurunegala","Mallawapitiya","Ranawana","723",971,459,512
"6157035","Kurunegala","Mallawapitiya","Kahatapitiya","731",681,323,358
"6157040","Kurunegala","Mallawapitiya","Meddegama East","728",692,324,368
"6157045","Kurunegala","Mallawapitiya","Maraluwawa","716",1518,718,800
"6157050","Kurunegala","Mallawapitiya","Pahala Gettuwana","717",961,453,508
"6157055","Kurunegala","Mallawapitiya","Thorayaya","722",2922,1387,1535
"6157060","Kurunegala","Mallawapitiya","Kuda Kowana","719",1327,665,662
"6157065","Kurunegala","Mallawapitiya","Kowana","718",1008,498,510
"6157070","Kurunegala","Mallawapitiya","Denagamuwa","721",924,469,455
"6157075","Kurunegala","Mallawapitiya","Yaggapitiya","727",536,251,285
"6157080","Kurunegala","Mallawapitiya","Mehiella North","713",1743,835,908
"6157085","Kurunegala","Mallawapitiya","Hewana","715",2095,1002,1093
"6157090","Kurunegala","Mallawapitiya","Uyandana","720",1307,605,702
"6157095","Kurunegala","Mallawapitiya","Mehiella South","714",1860,902,958
"6157100","Kurunegala","Mallawapitiya","Mallawapitiya","711",4326,2134,2192
"6157105","Kurunegala","Mallawapitiya","Millawa","712",3243,1536,1707
"6157110","Kurunegala","Mallawapitiya","Kolapelalikanda","733",1258,609,649
"6157115","Kurunegala","Mallawapitiya","Doratiyawa","732",1779,861,918
"6157120","Kurunegala","Mallawapitiya","Messagammana","735",623,300,323
"6157125","Kurunegala","Mallawapitiya","Hewapola","734",1350,673,677
"6157130","Kurunegala","Mallawapitiya","Manel Oluwa","743",703,315,388
"6157135","Kurunegala","Mallawapitiya","Walpolakanda North","745",556,270,286
"6157140","Kurunegala","Mallawapitiya","Walpolakanda South","746",576,258,318
"6157145","Kurunegala","Mallawapitiya","Indulgoda","742",955,454,501
"6157150","Kurunegala","Mallawapitiya","Konpala","736",980,481,499
"6157155","Kurunegala","Mallawapitiya","Dembepola","739",609,310,299
"6157160","Kurunegala","Mallawapitiya","Bodhigama","738",693,334,359
"6157165","Kurunegala","Mallawapitiya","Thiragama","737",825,378,447
"6157170","Kurunegala","Mallawapitiya","Bogamuwa","741",1078,518,560
"6157175","Kurunegala","Mallawapitiya","Werawella","749",604,272,332
"6157180","Kurunegala","Mallawapitiya","Indulgodakanda","744",1441,638,803
"6157185","Kurunegala","Mallawapitiya","Morathenna","752",559,263,296
"6157190","Kurunegala","Mallawapitiya","Katupitiya North","747",723,344,379
"6157195","Kurunegala","Mallawapitiya","Katupitiya South","748",773,366,407
"6157200","Kurunegala","Mallawapitiya","Ihala Thalampitiya","753",894,421,473
"6157205","Kurunegala","Mallawapitiya","Wattegedara","755",963,466,497
"6157210","Kurunegala","Mallawapitiya","Koralegedara","740",720,350,370
"6157215","Kurunegala","Mallawapitiya","Mahagama","754",1019,491,528
"6157220","Kurunegala","Mallawapitiya","Belgoda","750",808,365,443
"6157225","Kurunegala","Mallawapitiya","Belgoda Kanda","751",285,141,144
"6160005","Kurunegala","Mawathagama","Kongaswala","708",1297,625,672
"6160010","Kurunegala","Mawathagama","Barandana","704",783,377,406
"6160015","Kurunegala","Mawathagama","Wewagedara","705",916,420,496
"6160020","Kurunegala","Mawathagama","Etagahawela","706",1064,530,534
"6160025","Kurunegala","Mawathagama","Galapitamulla","707",1356,679,677
"6160030","Kurunegala","Mawathagama","Hidagolla","710",1139,514,625
"6160035","Kurunegala","Mawathagama","Udanagama","702",486,234,252
"6160040","Kurunegala","Mawathagama","Tharapotha","701",1117,563,554
"6160045","Kurunegala","Mawathagama","Tigola","703",879,425,454
"6160050","Kurunegala","Mawathagama","Arampola Watta North","692",843,395,448
"6160055","Kurunegala","Mawathagama","Arampola Watta South","693",736,362,374
"6160060","Kurunegala","Mawathagama","Ellagonna","690",475,211,264
"6160065","Kurunegala","Mawathagama","Pothubowa","689",688,341,347
"6160070","Kurunegala","Mawathagama","Madawa","699",1541,751,790
"6160075","Kurunegala","Mawathagama","Kanduboda","700",549,256,293
"6160080","Kurunegala","Mawathagama","Kahandawelipotha","709",1196,570,626
"6160085","Kurunegala","Mawathagama","Maswewa","696",887,436,451
"6160090","Kurunegala","Mawathagama","Pilessa Ihalagama","695",890,445,445
"6160095","Kurunegala","Mawathagama","Pilessa Pahalagama","694",518,251,267
"6160100","Kurunegala","Mawathagama","Henepola","698",904,435,469
"6160105","Kurunegala","Mawathagama","Maralanda","688",1123,555,568
"6160110","Kurunegala","Mawathagama","Arampola","685",1137,559,578
"6160115","Kurunegala","Mawathagama","Delgolla Watta North","683",1525,760,765
"6160120","Kurunegala","Mawathagama","Nawa Pothubowa","691",935,435,500
"6160125","Kurunegala","Mawathagama","Welikumbura","682",910,453,457
"6160130","Kurunegala","Mawathagama","Ilukewela North","650",1577,732,845
"6160135","Kurunegala","Mawathagama","Mawathagama","677",2173,1066,1107
"6160140","Kurunegala","Mawathagama","Delgolla Watta South","684",814,379,435
"6160145","Kurunegala","Mawathagama","Mawathagama North","678",1344,618,726
"6160150","Kurunegala","Mawathagama","Mee/ Pallegama East","672",679,318,361
"6160155","Kurunegala","Mawathagama","Bulathwatta","686",297,136,161
"6160160","Kurunegala","Mawathagama","Rathneggama","697",594,270,324
"6160165","Kurunegala","Mawathagama","Yatiwala","687",413,198,215
"6160170","Kurunegala","Mawathagama","Mee/ Pallegama West","671",792,379,413
"6160175","Kurunegala","Mawathagama","Mee/  Medagamgoda","670",354,162,192
"6160180","Kurunegala","Mawathagama","Mee/ Wambugamgoda","673",520,218,302
"6160185","Kurunegala","Mawathagama","Mawathagama West","681",592,264,328
"6160190","Kurunegala","Mawathagama","Samodagama","680",734,327,407
"6160195","Kurunegala","Mawathagama","Ilukewela South","649",1023,481,542
"6160200","Kurunegala","Mawathagama","Ihala Weligepola","651",2019,957,1062
"6160205","Kurunegala","Mawathagama","Akade","640",616,283,333
"6160210","Kurunegala","Mawathagama","Waraddana","641",872,409,463
"6160215","Kurunegala","Mawathagama","Wadiyagoda","646",1011,467,544
"6160220","Kurunegala","Mawathagama","Bandaragala","647",1501,735,766
"6160225","Kurunegala","Mawathagama","Singhapura","652",1367,644,723
"6160230","Kurunegala","Mawathagama","Paragahadeniya","653",2352,1226,1126
"6160235","Kurunegala","Mawathagama","Delpaddana","648",878,413,465
"6160240","Kurunegala","Mawathagama","Kotikapala","675",838,394,444
"6160245","Kurunegala","Mawathagama","Kotikapola Ihalagama","676",739,310,429
"6160250","Kurunegala","Mawathagama","Mawathagama South","679",1503,670,833
"6160255","Kurunegala","Mawathagama","Meddegamgoda","674",600,290,310
"6160260","Kurunegala","Mawathagama","Mee/ Udagama","669",1439,675,764
"6160265","Kurunegala","Mawathagama","Gonagaldeniya","668",488,235,253
"6160270","Kurunegala","Mawathagama","Gonagala","667",687,320,367
"6160275","Kurunegala","Mawathagama","Dunukewatta","665",867,412,455
"6160280","Kurunegala","Mawathagama","Kalugamuwa","660",931,440,491
"6160285","Kurunegala","Mawathagama","Watareka","663",1318,625,693
"6160290","Kurunegala","Mawathagama","Katugampalagedara","664",528,249,279
"6160295","Kurunegala","Mawathagama","Kahapathwala North","655",813,379,434
"6160300","Kurunegala","Mawathagama","Malandeniya","656",1111,520,591
"6160305","Kurunegala","Mawathagama","Kahapathwala","654",1148,562,586
"6160310","Kurunegala","Mawathagama","Hettipola","645",745,363,382
"6160315","Kurunegala","Mawathagama","Boyagoda","644",557,266,291
"6160320","Kurunegala","Mawathagama","Udakottamulla","643",691,330,361
"6160325","Kurunegala","Mawathagama","Metibokka","642",710,333,377
"6160330","Kurunegala","Mawathagama","Kossinna","658",589,284,305
"6160335","Kurunegala","Mawathagama","Eriminna","657",588,273,315
"6160340","Kurunegala","Mawathagama","Uda Iguruwatta","661",396,191,205
"6160345","Kurunegala","Mawathagama","Kandehena","666",404,192,212
"6160350","Kurunegala","Mawathagama","Uggalpaya","662",509,245,264
"6160355","Kurunegala","Mawathagama","Halwahala","659",289,142,147
"6163005","Kurunegala","Rideegama","Paragaswewa","529",458,216,242
"6163010","Kurunegala","Rideegama","Adapola","528",930,440,490
"6163015","Kurunegala","Rideegama","Udakendawala","527",815,395,420
"6163020","Kurunegala","Rideegama","Katiyawa","534",971,475,496
"6163025","Kurunegala","Rideegama","Udahena","535",733,362,371
"6163030","Kurunegala","Rideegama","Wanduressa","540",1001,479,522
"6163035","Kurunegala","Rideegama","Meepitiya","550",590,266,324
"6163040","Kurunegala","Rideegama","Kanugolla","532",801,367,434
"6163045","Kurunegala","Rideegama","Koswatta","531",959,460,499
"6163050","Kurunegala","Rideegama","Dodangahakotuwa","530",358,161,197
"6163055","Kurunegala","Rideegama","Wegama","533",764,369,395
"6163060","Kurunegala","Rideegama","Gopallawa","552",704,324,380
"6163065","Kurunegala","Rideegama","Rathvita","551",758,368,390
"6163070","Kurunegala","Rideegama","Balawattala","546",1463,694,769
"6163075","Kurunegala","Rideegama","Udattapola Pahala","538",817,381,436
"6163080","Kurunegala","Rideegama","Ihala Udattapola","537",668,316,352
"6163085","Kurunegala","Rideegama","Kotuhena","539",1063,506,557
"6163090","Kurunegala","Rideegama","Kelemulla","541",700,333,367
"6163095","Kurunegala","Rideegama","Nithulpitiya","542",747,336,411
"6163100","Kurunegala","Rideegama","Kandupalatha","543",529,264,265
"6163105","Kurunegala","Rideegama","Diniminiyathenna","544",930,449,481
"6163110","Kurunegala","Rideegama","Minirangama","536",879,435,444
"6163115","Kurunegala","Rideegama","Alakolamada","547",793,374,419
"6163120","Kurunegala","Rideegama","Korossa","548",1814,878,936
"6163125","Kurunegala","Rideegama","Dodangaslanda","549",587,297,290
"6163130","Kurunegala","Rideegama","Kothalawalagama","555",1054,500,554
"6163135","Kurunegala","Rideegama","Nuwarayaya","554",915,448,467
"6163140","Kurunegala","Rideegama","Lihiniwehera","553",1638,768,870
"6163145","Kurunegala","Rideegama","Wewegedara","558",1501,682,819
"6163150","Kurunegala","Rideegama","Rambukandana","606",1534,723,811
"6163155","Kurunegala","Rideegama","Warakawehera","559",1327,631,696
"6163160","Kurunegala","Rideegama","Rideegama","557",1258,661,597
"6163165","Kurunegala","Rideegama","Madithiyawa","556",755,342,413
"6163170","Kurunegala","Rideegama","Thelambugalla","545",1135,511,624
"6163175","Kurunegala","Rideegama","Reddagoda","560",819,386,433
"6163180","Kurunegala","Rideegama","Pallehorombuwa","561",933,438,495
"6163185","Kurunegala","Rideegama","Ginihiriya","562",1134,529,605
"6163190","Kurunegala","Rideegama","Palleyaya","563",803,360,443
"6163195","Kurunegala","Rideegama","Kahahena","564",689,338,351
"6163200","Kurunegala","Rideegama","Udahorombuwa","565",575,276,299
"6163205","Kurunegala","Rideegama","Jankure","571",239,118,121
"6163210","Kurunegala","Rideegama","Rambadagalla","603",1972,904,1068
"6163215","Kurunegala","Rideegama","Nahalla","604",1496,730,766
"6163220","Kurunegala","Rideegama","Olagama","605",532,256,276
"6163225","Kurunegala","Rideegama","Morathiha","608",989,485,504
"6163230","Kurunegala","Rideegama","Hunugalkadulla","607",984,465,519
"6163235","Kurunegala","Rideegama","Kavisigamuwa","610",1079,533,546
"6163240","Kurunegala","Rideegama","Doranepola","615",440,207,233
"6163245","Kurunegala","Rideegama","Hunupolagedara","614",752,342,410
"6163250","Kurunegala","Rideegama","Kuthurumahana","612",644,297,347
"6163255","Kurunegala","Rideegama","Dedurunadeegama","611",604,288,316
"6163260","Kurunegala","Rideegama","Karandagolla","616",880,402,478
"6163265","Kurunegala","Rideegama","Ambakote","617",861,433,428
"6163270","Kurunegala","Rideegama","Kosgollepola","619",533,243,290
"6163275","Kurunegala","Rideegama","Kandepola","613",161,82,79
"6163280","Kurunegala","Rideegama","Gabadagama","609",329,143,186
"6163285","Kurunegala","Rideegama","Kandegedara","599",751,338,413
"6163290","Kurunegala","Rideegama","Haliyamulla","598",1139,535,604
"6163295","Kurunegala","Rideegama","Welikanda","593",362,173,189
"6163300","Kurunegala","Rideegama","Kithulwala","570",451,208,243
"6163305","Kurunegala","Rideegama","Delvita","569",878,431,447
"6163310","Kurunegala","Rideegama","Goraka Ela","566",481,238,243
"6163315","Kurunegala","Rideegama","Pallekanda","568",769,370,399
"6163320","Kurunegala","Rideegama","Kalugahathenna","575",433,210,223
"6163325","Kurunegala","Rideegama","Kiribathgalla","567",707,364,343
"6163330","Kurunegala","Rideegama","Bambaragahakanda","574",551,257,294
"6163335","Kurunegala","Rideegama","Kithulgolla","573",415,206,209
"6163340","Kurunegala","Rideegama","Eriyagolla","577",897,449,448
"6163345","Kurunegala","Rideegama","Gurumada","592",524,230,294
"6163350","Kurunegala","Rideegama","Polwatta","597",823,387,436
"6163355","Kurunegala","Rideegama","Panagamuwa","596",545,243,302
"6163360","Kurunegala","Rideegama","Pitiyegedara","595",593,267,326
"6163365","Kurunegala","Rideegama","Hadiramulla","594",1242,562,680
"6163370","Kurunegala","Rideegama","Ogodapola","601",1068,516,552
"6163375","Kurunegala","Rideegama","Ranthetikanda","600",301,152,149
"6163380","Kurunegala","Rideegama","Gonamada","621",338,168,170
"6163385","Kurunegala","Rideegama","Buluwalakanda","620",329,169,160
"6163390","Kurunegala","Rideegama","Buluwala","618",658,329,329
"6163395","Kurunegala","Rideegama","Hewenpola","622",1081,528,553
"6163400","Kurunegala","Rideegama","Kongoda","626",499,263,236
"6163405","Kurunegala","Rideegama","Akkara Panaha","624",669,325,344
"6163410","Kurunegala","Rideegama","Welagedara","623",1022,497,525
"6163415","Kurunegala","Rideegama","Paliella","633",808,379,429
"6163420","Kurunegala","Rideegama","Metiyampotha","632",1120,501,619
"6163425","Kurunegala","Rideegama","Gonadeniya","625",594,289,305
"6163430","Kurunegala","Rideegama","Medakanda","635",282,129,153
"6163435","Kurunegala","Rideegama","Medagama","628",673,316,357
"6163440","Kurunegala","Rideegama","Nelaulla","602",659,329,330
"6163445","Kurunegala","Rideegama","Malbe","591",720,349,371
"6163450","Kurunegala","Rideegama","Mahawela","586",1555,761,794
"6163455","Kurunegala","Rideegama","Gallawa","576",1014,499,515
"6163460","Kurunegala","Rideegama","Mirissala","578",613,283,330
"6163465","Kurunegala","Rideegama","Dunumawa","572",464,227,237
"6163470","Kurunegala","Rideegama","Galbindinaela","579",462,229,233
"6163475","Kurunegala","Rideegama","Kosgolla","585",557,257,300
"6163480","Kurunegala","Rideegama","Pihimbuwa","590",751,363,388
"6163485","Kurunegala","Rideegama","Maspotha","589",540,245,295
"6163490","Kurunegala","Rideegama","Erepolakanda","629",266,125,141
"6163495","Kurunegala","Rideegama","Siyambalangamuwa","627",612,290,322
"6163500","Kurunegala","Rideegama","Thalgaspitiya","631",701,332,369
"6163505","Kurunegala","Rideegama","Jakaduwa","634",602,280,322
"6163510","Kurunegala","Rideegama","Balagala","630",555,257,298
"6163515","Kurunegala","Rideegama","Pussella","636",974,445,529
"6163520","Kurunegala","Rideegama","Pusselikanda","637",404,207,197
"6163525","Kurunegala","Rideegama","Gonigoda","588",787,368,419
"6163530","Kurunegala","Rideegama","Meeliyadda","584",775,373,402
"6163535","Kurunegala","Rideegama","Kanadeniyawala","580",887,412,475
"6163540","Kurunegala","Rideegama","Ganegoda","587",560,257,303
"6163545","Kurunegala","Rideegama","Bogamuwa","638",876,428,448
"6163550","Kurunegala","Rideegama","Kurukeppitiya","639",488,247,241
"6163555","Kurunegala","Rideegama","Paragoda","582",670,313,357
"6163560","Kurunegala","Rideegama","Ikiriwatta","583",901,439,462
"6163565","Kurunegala","Rideegama","Niyangama","581",921,438,483
"6166005","Kurunegala","Weerambugedara","Lokahettiya","878",414,197,217
"6166010","Kurunegala","Weerambugedara","Medagama","877",1026,477,549
"6166015","Kurunegala","Weerambugedara","Pathinwatta","876",721,325,396
"6166020","Kurunegala","Weerambugedara","Bamunugedara","875",714,339,375
"6166025","Kurunegala","Weerambugedara","Gallehera","879",611,281,330
"6166030","Kurunegala","Weerambugedara","Kadadunna","880",430,201,229
"6166035","Kurunegala","Weerambugedara","Weerambugedara","869",1063,504,559
"6166040","Kurunegala","Weerambugedara","Gonawa","870",835,415,420
"6166045","Kurunegala","Weerambugedara","Yalawa","873",1133,533,600
"6166050","Kurunegala","Weerambugedara","Madawala North","871",544,249,295
"6166055","Kurunegala","Weerambugedara","Sandagala South","846",827,418,409
"6166060","Kurunegala","Weerambugedara","Sandagala North","845",683,307,376
"6166065","Kurunegala","Weerambugedara","Damunugala","848",709,351,358
"6166070","Kurunegala","Weerambugedara","Piduruwella","847",1703,771,932
"6166075","Kurunegala","Weerambugedara","Clovis Watta","844",1094,513,581
"6166080","Kurunegala","Weerambugedara","Madawala South","872",831,407,424
"6166085","Kurunegala","Weerambugedara","Mudunna","874",782,346,436
"6166090","Kurunegala","Weerambugedara","Hanwella","867",804,418,386
"6166095","Kurunegala","Weerambugedara","Huruggamuwa","866",1090,527,563
"6166100","Kurunegala","Weerambugedara","Ginipenda","865",717,346,371
"6166105","Kurunegala","Weerambugedara","Kalugamuwa","864",1236,590,646
"6166110","Kurunegala","Weerambugedara","Yanthampola","868",486,222,264
"6166115","Kurunegala","Weerambugedara","Bulupitiya","849",906,432,474
"6166120","Kurunegala","Weerambugedara","Uhumeeya","843",1278,596,682
"6166125","Kurunegala","Weerambugedara","Wewelpola","851",561,257,304
"6166130","Kurunegala","Weerambugedara","Ranjanagama","853",1534,737,797
"6166135","Kurunegala","Weerambugedara","Kanumale","855",2177,999,1178
"6166140","Kurunegala","Weerambugedara","Godavita","854",968,468,500
"6166145","Kurunegala","Weerambugedara","Ambahera","852",1135,545,590
"6166150","Kurunegala","Weerambugedara","Galabadagama","850",778,358,420
"6166155","Kurunegala","Weerambugedara","Dehikumbura","862",1381,629,752
"6166160","Kurunegala","Weerambugedara","Poogalla","863",857,403,454
"6166165","Kurunegala","Weerambugedara","Udugama","859",654,300,354
"6166170","Kurunegala","Weerambugedara","Thammita","858",626,282,344
"6166175","Kurunegala","Weerambugedara","Parakumbura","856",995,462,533
"6166180","Kurunegala","Weerambugedara","Algama","857",768,348,420
"6166185","Kurunegala","Weerambugedara","Kaduruwella","860",584,291,293
"6166190","Kurunegala","Weerambugedara","Sevendana","861",684,297,387
"6169005","Kurunegala","Kuliyapitiya East","Karangamuwa","1119",1108,541,567
"6169010","Kurunegala","Kuliyapitiya East","Dalupothagama","1120",1128,565,563
"6169015","Kurunegala","Kuliyapitiya East","Polpitiya","1108",1308,623,685
"6169020","Kurunegala","Kuliyapitiya East","Pothuwewa","1106",856,414,442
"6169025","Kurunegala","Kuliyapitiya East","Kotadeniyawa","1109",1091,534,557
"6169030","Kurunegala","Kuliyapitiya East","Thelahera","1107",696,355,341
"6169035","Kurunegala","Kuliyapitiya East","Nettipolagedara","1116",1346,626,720
"6169040","Kurunegala","Kuliyapitiya East","Arakyala","1114",2420,1089,1331
"6169045","Kurunegala","Kuliyapitiya East","Thoranegedara","1121",1024,469,555
"6169050","Kurunegala","Kuliyapitiya East","Medelpola","1128",1240,625,615
"6169055","Kurunegala","Kuliyapitiya East","Pothuhera","1129",1930,956,974
"6169060","Kurunegala","Kuliyapitiya East","Kekunagolla","1115",3783,1945,1838
"6169065","Kurunegala","Kuliyapitiya East","Dehigama","1117",1486,745,741
"6169070","Kurunegala","Kuliyapitiya East","Siyambalagaskotuwa","1131",2527,1289,1238
"6169075","Kurunegala","Kuliyapitiya East","Ambahenwewa","1132",1340,618,722
"6169080","Kurunegala","Kuliyapitiya East","Bogamulla","1110",742,365,377
"6169085","Kurunegala","Kuliyapitiya East","Andigedara","1111",879,413,466
"6169090","Kurunegala","Kuliyapitiya East","Karagahagedara","1113",936,473,463
"6169095","Kurunegala","Kuliyapitiya East","Bogahapitiya","1112",910,424,486
"6169100","Kurunegala","Kuliyapitiya East","Kureekotuwa","1130",1338,582,756
"6169105","Kurunegala","Kuliyapitiya East","Alahitiyawa","1118",1223,598,625
"6169110","Kurunegala","Kuliyapitiya East","Godagama","1126",894,420,474
"6169115","Kurunegala","Kuliyapitiya East","Thalliyadda","1127",1415,684,731
"6169120","Kurunegala","Kuliyapitiya East","Konduruwapola","1140",830,393,437
"6169125","Kurunegala","Kuliyapitiya East","Barigoda","1141",1555,713,842
"6169130","Kurunegala","Kuliyapitiya East","Ganangamuwa","1139",1007,472,535
"6169135","Kurunegala","Kuliyapitiya East","Bihalpola","1138",961,473,488
"6169140","Kurunegala","Kuliyapitiya East","Udagedara","1135",1035,521,514
"6169145","Kurunegala","Kuliyapitiya East","Horombawa","1134",2837,1367,1470
"6169150","Kurunegala","Kuliyapitiya East","Molligoda","1133",1360,635,725
"6169155","Kurunegala","Kuliyapitiya East","Kosgolla","1137",1586,734,852
"6169160","Kurunegala","Kuliyapitiya East","Mahagama","1136",721,363,358
"6169165","Kurunegala","Kuliyapitiya East","Nakkawatta","1145",813,383,430
"6169170","Kurunegala","Kuliyapitiya East","Hewanellagaraya","1146",801,374,427
"6169175","Kurunegala","Kuliyapitiya East","Ihala Muruthenge","1093",1336,622,714
"6169180","Kurunegala","Kuliyapitiya East","Pahala Muruthenge","1094",744,351,393
"6169185","Kurunegala","Kuliyapitiya East","Galgammulla","1095",960,454,506
"6169190","Kurunegala","Kuliyapitiya East","Ranasgalla","1092",510,235,275
"6169195","Kurunegala","Kuliyapitiya East","Wakkunuwala","1091",610,296,314
"6169200","Kurunegala","Kuliyapitiya East","Etampola","1085",933,461,472
"6169205","Kurunegala","Kuliyapitiya East","Rathneheruwa","1086",614,309,305
"6169210","Kurunegala","Kuliyapitiya East","Deekirikewa","1089",885,434,451
"6169215","Kurunegala","Kuliyapitiya East","Panavitiya","1090",1020,505,515
"6169220","Kurunegala","Kuliyapitiya East","Dethawa","1087",672,313,359
"6169225","Kurunegala","Kuliyapitiya East","Saliyala","1088",652,315,337
"6172005","Kurunegala","Kuliyapitiya West","Katuwella","1176",452,206,246
"6172010","Kurunegala","Kuliyapitiya West","Pahala Elathalawa","1175",1509,722,787
"6172015","Kurunegala","Kuliyapitiya West","Mawela","1173",493,241,252
"6172020","Kurunegala","Kuliyapitiya West","Koshena","1167",1436,680,756
"6172025","Kurunegala","Kuliyapitiya West","Pahala Galpola","1168",1592,789,803
"6172030","Kurunegala","Kuliyapitiya West","Ihala Galpola","1169",917,429,488
"6172035","Kurunegala","Kuliyapitiya West","Ihala Elathalawa","1174",1065,495,570
"6172040","Kurunegala","Kuliyapitiya West","Deegalla","1170",1662,790,872
"6172045","Kurunegala","Kuliyapitiya West","Ihala Embawa","1178",1466,725,741
"6172050","Kurunegala","Kuliyapitiya West","Kabalewa","1177",2167,1036,1131
"6172055","Kurunegala","Kuliyapitiya West","Dikhera","1171",1105,526,579
"6172060","Kurunegala","Kuliyapitiya West","Ilukhena","1172",1423,676,747
"6172065","Kurunegala","Kuliyapitiya West","Kumbalwala","1183",1045,497,548
"6172070","Kurunegala","Kuliyapitiya West","Pallewela","1181",1335,628,707
"6172075","Kurunegala","Kuliyapitiya West","Pahala Weerambuwa","1185",1133,537,596
"6172080","Kurunegala","Kuliyapitiya West","Ihala Weerambuwa","1184",1686,791,895
"6172085","Kurunegala","Kuliyapitiya West","Kurudelpotha","1182",897,438,459
"6172090","Kurunegala","Kuliyapitiya West","Thabbomulla","1187",1599,684,915
"6172095","Kurunegala","Kuliyapitiya West","Meegahakotuwa","1159",2316,1100,1216
"6172100","Kurunegala","Kuliyapitiya West","Kuliyapitiya Town","1157",2076,1027,1049
"6172105","Kurunegala","Kuliyapitiya West","Embawa","1180",1035,532,503
"6172110","Kurunegala","Kuliyapitiya West","Pahala Embawa","1179",1246,562,684
"6172115","Kurunegala","Kuliyapitiya West","Pahala Piduma","1166",1175,531,644
"6172125","Kurunegala","Kuliyapitiya West","Kongahagedara","1164",751,346,405
"6172130","Kurunegala","Kuliyapitiya West","Thummodara","1163",1529,712,817
"6172135","Kurunegala","Kuliyapitiya West","Ihala Piduma","1165",631,299,332
"6172140","Kurunegala","Kuliyapitiya West","Henegedara","1160",1670,776,894
"6172145","Kurunegala","Kuliyapitiya West","Delana","1161",1152,554,598
"6172150","Kurunegala","Kuliyapitiya West","Mookalanyaya","1162",1182,565,617
"6172155","Kurunegala","Kuliyapitiya West","Kirindawa","1143",1066,488,578
"6172160","Kurunegala","Kuliyapitiya West","Anukkane","1122",969,467,502
"6172165","Kurunegala","Kuliyapitiya West","Beminigalla","1123",871,418,453
"6172170","Kurunegala","Kuliyapitiya West","Kumbukkotuwa","1124",965,435,530
"6172175","Kurunegala","Kuliyapitiya West","Wahumuwa","1144",1360,635,725
"6172180","Kurunegala","Kuliyapitiya West","Unaleeya","1125",1283,603,680
"6172185","Kurunegala","Kuliyapitiya West","Kithalawa","1142",1310,619,691
"6172190","Kurunegala","Kuliyapitiya West","Yakarawatta","1152",1063,503,560
"6172195","Kurunegala","Kuliyapitiya West","Bohingamuwa","1154",1201,546,655
"6172200","Kurunegala","Kuliyapitiya West","Haggamuwa","1155",718,332,386
"6172205","Kurunegala","Kuliyapitiya West","Galahitiyawa","1156",2044,951,1093
"6172210","Kurunegala","Kuliyapitiya West","Dandagamuwa East","1192",1036,486,550
"6172215","Kurunegala","Kuliyapitiya West","Dandagamuwa West","1193",1196,573,623
"6172220","Kurunegala","Kuliyapitiya West","Pahala Kalugamuwa","1191",1156,522,634
"6172225","Kurunegala","Kuliyapitiya West","Mahimpitiya","1188",969,469,500
"6172230","Kurunegala","Kuliyapitiya West","Madakumburumulla","1186",1377,662,715
"6172235","Kurunegala","Kuliyapitiya West","Thalahitimulla","1189",705,331,374
"6172240","Kurunegala","Kuliyapitiya West","Weralugama","1197",1183,561,622
"6172245","Kurunegala","Kuliyapitiya West","Ihala Kalugamuwa","1190",1393,663,730
"6172250","Kurunegala","Kuliyapitiya West","Hammalawa","1194",1047,482,565
"6172255","Kurunegala","Kuliyapitiya West","Galagedara","1196",366,187,179
"6172260","Kurunegala","Kuliyapitiya West","Pitadeniya","1195",585,278,307
"6172265","Kurunegala","Kuliyapitiya West","Diyadora","1103",925,462,463
"6172270","Kurunegala","Kuliyapitiya West","Inguruwatta","1105",1437,695,742
"6172275","Kurunegala","Kuliyapitiya West","Diyadora Ihala Watta","1104",1293,627,666
"6172280","Kurunegala","Kuliyapitiya West","Narangalla","1153",1457,701,756
"6172285","Kurunegala","Kuliyapitiya West","Wadugedara","1100",582,273,309
"6172290","Kurunegala","Kuliyapitiya West","Kongolla","1148",929,428,501
"6172295","Kurunegala","Kuliyapitiya West","Ihala Ennaruwa","1147",768,370,398
"6172300","Kurunegala","Kuliyapitiya West","Deeyawala","1149",758,362,396
"6172305","Kurunegala","Kuliyapitiya West","Udihitimulla","1151",543,255,288
"6172310","Kurunegala","Kuliyapitiya West","Ketawalegedara","1101",591,280,311
"6172315","Kurunegala","Kuliyapitiya West","Eluwapola","1102",731,353,378
"6172320","Kurunegala","Kuliyapitiya West","Kandegedara","1099",694,343,351
"6172325","Kurunegala","Kuliyapitiya West","Katuwattewela","1098",1146,558,588
"6172330","Kurunegala","Kuliyapitiya West","Edandewela","1097",651,308,343
"6172335","Kurunegala","Kuliyapitiya West","Wewagama","1096",950,456,494
"6172340","Kurunegala","Kuliyapitiya West","Degammeda","1150",1092,526,566
"6175005","Kurunegala","Udubaddawa","Ihala Weerakodiyana","1470",951,423,528
"6175010","Kurunegala","Udubaddawa","Kovulwewa","1472",1209,566,643
"6175015","Kurunegala","Udubaddawa","Pahala Weerakodiyana","1471",998,483,515
"6175020","Kurunegala","Udubaddawa","Rantetiyawa","1485",690,334,356
"6175025","Kurunegala","Udubaddawa","Wathuwatta","1484",916,434,482
"6175030","Kurunegala","Udubaddawa","Habarawewa","1492",879,441,438
"6175035","Kurunegala","Udubaddawa","Kekunawala","1493",1915,919,996
"6175040","Kurunegala","Udubaddawa","Kandayaya","1483",830,403,427
"6175045","Kurunegala","Udubaddawa","Kappangamuwa","1497",1231,577,654
"6175050","Kurunegala","Udubaddawa","Kahadenigama","1502",749,350,399
"6175055","Kurunegala","Udubaddawa","Divurumpola","1494",1468,801,667
"6175060","Kurunegala","Udubaddawa","Pahala Yagamwela","1491",1874,869,1005
"6175065","Kurunegala","Udubaddawa","Ihala Yagamwela","1490",1020,493,527
"6175070","Kurunegala","Udubaddawa","Gahalagaswala","1496",1089,527,562
"6175075","Kurunegala","Udubaddawa","Siyambalagasruppa East","1488",1067,525,542
"6175080","Kurunegala","Udubaddawa","Siyambalagasruppa West","1487",2290,1135,1155
"6175085","Kurunegala","Udubaddawa","Dummalasooriya","1486",831,374,457
"6175090","Kurunegala","Udubaddawa","Thunthota","1489",703,336,367
"6175095","Kurunegala","Udubaddawa","Kattimahana","1510",1080,517,563
"6175100","Kurunegala","Udubaddawa","Palugamuwa","1509",1622,788,834
"6175105","Kurunegala","Udubaddawa","Karandavila","1495",1069,497,572
"6175110","Kurunegala","Udubaddawa","Bunnehepola","1501",2209,1083,1126
"6175115","Kurunegala","Udubaddawa","Ihalagama North","1503",902,421,481
"6175120","Kurunegala","Udubaddawa","Paranagama","1498",1251,619,632
"6175125","Kurunegala","Udubaddawa","Pahalagama","1499",1415,682,733
"6175130","Kurunegala","Udubaddawa","Ihalagama South","1504",1106,518,588
"6175135","Kurunegala","Udubaddawa","Mahaagara","1500",2065,960,1105
"6175140","Kurunegala","Udubaddawa","Henegedara","1522",873,431,442
"6175145","Kurunegala","Udubaddawa","Kanubichchiya","1511",1058,517,541
"6175150","Kurunegala","Udubaddawa","Polgaha Agara","1513",779,376,403
"6175155","Kurunegala","Udubaddawa","Dunakadeniya North","1514",1386,649,737
"6175160","Kurunegala","Udubaddawa","Udadeniya","1512",1211,585,626
"6175165","Kurunegala","Udubaddawa","Meegahapelessa","1521",1329,632,697
"6175170","Kurunegala","Udubaddawa","Bibiladeniya","1505",2091,1012,1079
"6175175","Kurunegala","Udubaddawa","Ammanamulla","1506",828,412,416
"6175180","Kurunegala","Udubaddawa","Walpitagama","1508",1138,515,623
"6175185","Kurunegala","Udubaddawa","Horathepola","1507",1448,694,754
"6175190","Kurunegala","Udubaddawa","Nawasigahawatta","1516",1312,634,678
"6175195","Kurunegala","Udubaddawa","Kootharippuwa","1517",901,433,468
"6175200","Kurunegala","Udubaddawa","Dunakadeniya South","1515",1515,694,821
"6175205","Kurunegala","Udubaddawa","Kumbukgahamulla","1519",970,449,521
"6175210","Kurunegala","Udubaddawa","Ilippugamuwa","1520",1100,532,568
"6175215","Kurunegala","Udubaddawa","Kumara Udawela","1518",863,415,448
"6178005","Kurunegala","Pannala","Gallehemulla","1596",1172,548,624
"6178010","Kurunegala","Pannala","Nabirittankadawara","1525",2209,1071,1138
"6178015","Kurunegala","Pannala","Udugama","1524",1408,680,728
"6178020","Kurunegala","Pannala","Pethigodagedara","1526",1475,711,764
"6178025","Kurunegala","Pannala","Eriyagolla","1523",2446,1155,1291
"6178030","Kurunegala","Pannala","Yatattawala","1532",1084,510,574
"6178035","Kurunegala","Pannala","Thelambugammana","1531",1084,505,579
"6178040","Kurunegala","Pannala","Ingaradavula","1553",1052,506,546
"6178045","Kurunegala","Pannala","Mohottawa","1551",864,413,451
"6178050","Kurunegala","Pannala","Batapotha Ela","1557",1266,598,668
"6178055","Kurunegala","Pannala","Katugampala","1560",1571,748,823
"6178060","Kurunegala","Pannala","Hamanagoda","1562",799,369,430
"6178065","Kurunegala","Pannala","Mummana","1564",1219,574,645
"6178070","Kurunegala","Pannala","Wattegedara","1559",986,475,511
"6178075","Kurunegala","Pannala","Wettewa","1563",1179,549,630
"6178080","Kurunegala","Pannala","Kavudumunna","1561",1454,716,738
"6178085","Kurunegala","Pannala","Hamangalla","1554",1283,609,674
"6178090","Kurunegala","Pannala","Narangoda South","1556",847,409,438
"6178095","Kurunegala","Pannala","Narangoda North","1555",1386,676,710
"6178100","Kurunegala","Pannala","Erepola","1552",1483,685,798
"6178105","Kurunegala","Pannala","Madigepola","1527",689,331,358
"6178110","Kurunegala","Pannala","Hengawa","1530",1090,535,555
"6178115","Kurunegala","Pannala","Paragammana","1528",1472,703,769
"6178120","Kurunegala","Pannala","Nedalagamuwa North","1537",1632,808,824
"6178125","Kurunegala","Pannala","Nedalagamuwa South","1536",1501,733,768
"6178130","Kurunegala","Pannala","Yayamulla","1538",935,450,485
"6178135","Kurunegala","Pannala","Raddalana","1592",1195,567,628
"6178140","Kurunegala","Pannala","Waguruwela","1594",818,388,430
"6178145","Kurunegala","Pannala","Muthugalayagama","1599",1335,657,678
"6178150","Kurunegala","Pannala","Kandepola","1595",1487,728,759
"6178155","Kurunegala","Pannala","Hundirapola","1597",1334,634,700
"6178160","Kurunegala","Pannala","Welpalla","1598",1237,592,645
"6178165","Kurunegala","Pannala","Daraluwa","1593",1841,888,953
"6178170","Kurunegala","Pannala","Hunuvila","1534",1058,495,563
"6178175","Kurunegala","Pannala","Kongoda","1535",913,422,491
"6178180","Kurunegala","Pannala","Werahera","1529",1544,734,810
"6178185","Kurunegala","Pannala","Bowatta","1533",1326,623,703
"6178190","Kurunegala","Pannala","Koodalupotta","1543",1902,939,963
"6178195","Kurunegala","Pannala","Bammanna","1545",1837,881,956
"6178200","Kurunegala","Pannala","Kadirapola","1544",1043,507,536
"6178205","Kurunegala","Pannala","Mahingamuwa","1558",1731,803,928
"6178210","Kurunegala","Pannala","Dodampotta","1567",974,467,507
"6178215","Kurunegala","Pannala","Konduruwawela","1571",1023,492,531
"6178220","Kurunegala","Pannala","Meddepola Pahala","1570",1368,681,687
"6178225","Kurunegala","Pannala","Maharagama","1566",2114,1011,1103
"6178230","Kurunegala","Pannala","Meddepola Ihala","1569",801,376,425
"6178235","Kurunegala","Pannala","Siyambalawalana","1568",679,316,363
"6178240","Kurunegala","Pannala","Ihala Labbala","1573",858,401,457
"6178245","Kurunegala","Pannala","Ihala Kotuwella","1582",1124,514,610
"6178250","Kurunegala","Pannala","Horawadunna","1542",1643,804,839
"6178255","Kurunegala","Pannala","Elabadagama East","1539",2920,1375,1545
"6178260","Kurunegala","Pannala","Elabadagama North","1540",2094,961,1133
"6178265","Kurunegala","Pannala","Elabadagama West","1541",2414,1174,1240
"6178270","Kurunegala","Pannala","Mookalana","1548",777,369,408
"6178275","Kurunegala","Pannala","Makandura Ihala","1588",2360,1130,1230
"6178280","Kurunegala","Pannala","Elivila","1590",1242,577,665
"6178285","Kurunegala","Pannala","Gonulla East","1601",981,481,500
"6178290","Kurunegala","Pannala","Indivinna","1591",1468,675,793
"6178295","Kurunegala","Pannala","Hettirippuwa","1602",1089,527,562
"6178300","Kurunegala","Pannala","Villiyagama","1603",939,476,463
"6178305","Kurunegala","Pannala","Gonulla West","1600",1396,652,744
"6178310","Kurunegala","Pannala","Irabadagama","1606",2069,998,1071
"6178315","Kurunegala","Pannala","Wetakeyawa","1608",1676,804,872
"6178320","Kurunegala","Pannala","Makandura Pahala","1589",1791,837,954
"6178325","Kurunegala","Pannala","Panwalakumbura","1609",1738,852,886
"6178330","Kurunegala","Pannala","Hendiyagala","1607",2352,1121,1231
"6178335","Kurunegala","Pannala","Sandalankawa","1604",1956,920,1036
"6178340","Kurunegala","Pannala","Thambakanda","1605",1142,539,603
"6178345","Kurunegala","Pannala","Nalawalana","1586",2035,978,1057
"6178350","Kurunegala","Pannala","Medirivila","1587",1403,728,675
"6178355","Kurunegala","Pannala","Pahala Galayaya","1547",1685,794,891
"6178360","Kurunegala","Pannala","Ihala Galayaya","1546",1106,523,583
"6178365","Kurunegala","Pannala","Pannala","1549",1937,918,1019
"6178370","Kurunegala","Pannala","Kekillapitiya","1583",1509,741,768
"6178375","Kurunegala","Pannala","Maholawa","1579",2020,956,1064
"6178380","Kurunegala","Pannala","Thalammehera","1584",2223,1047,1176
"6178385","Kurunegala","Pannala","Badabedda","1550",2022,961,1061
"6178390","Kurunegala","Pannala","Kohombapola","1585",997,463,534
"6178395","Kurunegala","Pannala","Elibichchiya","1578",1096,559,537
"6178400","Kurunegala","Pannala","Mellawalana","1580",1567,761,806
"6178405","Kurunegala","Pannala","Pahala Labbala","1574",1012,492,520
"6178410","Kurunegala","Pannala","Bopitiya","1572",1590,795,795
"6178415","Kurunegala","Pannala","Balawala","1581",1164,598,566
"6178420","Kurunegala","Pannala","Mattegama","1575",1499,717,782
"6178425","Kurunegala","Pannala","Wellewa","1577",1708,813,895
"6178430","Kurunegala","Pannala","Narangamuwa","1576",1236,587,649
"6178435","Kurunegala","Pannala","Malgamuwa","1565",1241,580,661
"6181005","Kurunegala","Narammala","Pahamune","1073",1485,660,825
"6181010","Kurunegala","Narammala","Kadahapola","1074",2002,991,1011
"6181015","Kurunegala","Narammala","Penthenigoda","1079",1481,703,778
"6181020","Kurunegala","Narammala","Ganegoda","1081",504,249,255
"6181025","Kurunegala","Narammala","Meewewa","1084",788,384,404
"6181030","Kurunegala","Narammala","Dangolla","1083",970,451,519
"6181035","Kurunegala","Narammala","Meewewa/  Bemmullegedara","1082",804,359,445
"6181040","Kurunegala","Narammala","Puwakgaha Kotuwa","1080",759,368,391
"6181045","Kurunegala","Narammala","Polgahayaya","1078",1547,751,796
"6181050","Kurunegala","Narammala","Ginigathpitiya","1077",1171,570,601
"6181055","Kurunegala","Narammala","Dambagirigama East","1075",1189,555,634
"6181060","Kurunegala","Narammala","Medagoda","1055",851,405,446
"6181065","Kurunegala","Narammala","Dambagirigama West","1076",1006,460,546
"6181070","Kurunegala","Narammala","Narammala","1065",2044,991,1053
"6181075","Kurunegala","Narammala","Ranawatta","1066",898,433,465
"6181080","Kurunegala","Narammala","Senanayaka Colony","1067",568,283,285
"6181085","Kurunegala","Narammala","Kottapitiya","1068",547,257,290
"6181090","Kurunegala","Narammala","Ambagammana","1072",821,393,428
"6181095","Kurunegala","Narammala","Yakkavita","1069",698,331,367
"6181100","Kurunegala","Narammala","Halwella","1063",2505,1244,1261
"6181105","Kurunegala","Narammala","Rammuthugala","1064",619,302,317
"6181110","Kurunegala","Narammala","Welikumbura","1056",879,418,461
"6181115","Kurunegala","Narammala","Dampelessa","1057",938,470,468
"6181120","Kurunegala","Narammala","Kivulegedara","1058",1207,571,636
"6181125","Kurunegala","Narammala","Polwattegedara","1062",854,404,450
"6181130","Kurunegala","Narammala","Karalappala","1070",579,279,300
"6181135","Kurunegala","Narammala","Embalapola","1071",479,222,257
"6181140","Kurunegala","Narammala","Weragala","1061",825,423,402
"6181145","Kurunegala","Narammala","Rangallepola","1060",757,376,381
"6181150","Kurunegala","Narammala","Nakalagamuwa","1059",555,286,269
"6181155","Kurunegala","Narammala","Godakooruwa","1054",898,450,448
"6181160","Kurunegala","Narammala","Kivulgalla","1053",2097,988,1109
"6181165","Kurunegala","Narammala","Eriyagolla","1050",674,322,352
"6181170","Kurunegala","Narammala","Metiyagane West","1049",651,313,338
"6181175","Kurunegala","Narammala","Maravita","1044",1236,608,628
"6181180","Kurunegala","Narammala","Muthugala East","1045",981,446,535
"6181185","Kurunegala","Narammala","Metiyagane East","1048",1006,455,551
"6181190","Kurunegala","Narammala","Kasungama","1051",1059,486,573
"6181195","Kurunegala","Narammala","Pelawatta","1052",1080,527,553
"6181200","Kurunegala","Narammala","Pothupitiya","1047",888,442,446
"6181205","Kurunegala","Narammala","Muthugala West","1046",817,377,440
"6181210","Kurunegala","Narammala","Dambadeniya South","1042",1992,969,1023
"6181215","Kurunegala","Narammala","Dambadeniya North","1041",650,318,332
"6181220","Kurunegala","Narammala","Udawelawatta","1043",955,464,491
"6181225","Kurunegala","Narammala","Riligala","1040",1641,771,870
"6181230","Kurunegala","Narammala","Athuruwala","1038",1703,800,903
"6181235","Kurunegala","Narammala","Puskoladeniya","1037",1055,523,532
"6181240","Kurunegala","Narammala","Delikanu Anga","1039",789,387,402
"6181245","Kurunegala","Narammala","Kudagammana","1031",1292,628,664
"6181250","Kurunegala","Narammala","Riloluwa","1035",725,337,388
"6181255","Kurunegala","Narammala","Handapangala","1033",920,424,496
"6181260","Kurunegala","Narammala","Paranagama","1036",643,294,349
"6181265","Kurunegala","Narammala","Marandagolla","1034",1332,622,710
"6181270","Kurunegala","Narammala","Epaladeniya","1032",865,433,432
"6184005","Kurunegala","Alawwa","Vilgamuwa","989",771,373,398
"6184010","Kurunegala","Alawwa","Vilgamuwa Watta","984",607,302,305
"6184015","Kurunegala","Alawwa","Wennoruwa West","976",809,383,426
"6184020","Kurunegala","Alawwa","Wennoruwa East","975",1007,493,514
"6184025","Kurunegala","Alawwa","Damunupola","968",710,336,374
"6184030","Kurunegala","Alawwa","Pannala","969",1030,486,544
"6184035","Kurunegala","Alawwa","Nungamuwa Pahala","967",751,381,370
"6184040","Kurunegala","Alawwa","Wadawa","965",874,418,456
"6184045","Kurunegala","Alawwa","Nungamuwa Ihala","966",703,351,352
"6184050","Kurunegala","Alawwa","Dehelgamuwa","970",616,295,321
"6184055","Kurunegala","Alawwa","Ihala Wettewa","977",869,418,451
"6184060","Kurunegala","Alawwa","Kiriwanapola","983",933,445,488
"6184065","Kurunegala","Alawwa","Kandegedara South","986",733,345,388
"6184070","Kurunegala","Alawwa","Welikare","992",793,375,418
"6184075","Kurunegala","Alawwa","Galgamuwa North","990",940,456,484
"6184080","Kurunegala","Alawwa","Galgamuwa South","991",789,392,397
"6184085","Kurunegala","Alawwa","Pangolla","993",732,381,351
"6184090","Kurunegala","Alawwa","Kandegedara North","985",898,441,457
"6184095","Kurunegala","Alawwa","Divulgahakotuwa","978",704,324,380
"6184100","Kurunegala","Alawwa","Waduwawa","971",1599,854,745
"6184105","Kurunegala","Alawwa","Lewdeniya","973",831,423,408
"6184110","Kurunegala","Alawwa","Poramadala","972",1058,504,554
"6184115","Kurunegala","Alawwa","Galatharaya","999",526,253,273
"6184120","Kurunegala","Alawwa","Hinnarapola","979",613,309,304
"6184125","Kurunegala","Alawwa","Nugawela","982",1494,754,740
"6184130","Kurunegala","Alawwa","Maharachchimulla","988",776,390,386
"6184135","Kurunegala","Alawwa","Pahala Kalalpitiya","987",1033,507,526
"6184140","Kurunegala","Alawwa","Henduwawa","994",792,402,390
"6184145","Kurunegala","Alawwa","Kendagolla","1030",771,377,394
"6184150","Kurunegala","Alawwa","Boyawalana","1029",759,356,403
"6184155","Kurunegala","Alawwa","Henduwawa Colony","995",1059,497,562
"6184160","Kurunegala","Alawwa","Ihala Kalalpitiya","1008",759,370,389
"6184165","Kurunegala","Alawwa","Medagampola","980",1040,529,511
"6184170","Kurunegala","Alawwa","Maldeniya","981",663,336,327
"6184175","Kurunegala","Alawwa","Koholana","998",1831,928,903
"6184180","Kurunegala","Alawwa","Ihala Walakumbura","996",1259,608,651
"6184185","Kurunegala","Alawwa","Yatigaloluwa","974",973,467,506
"6184190","Kurunegala","Alawwa","Pahala Walakumbura","997",1009,497,512
"6184195","Kurunegala","Alawwa","Alawwa South","1001",2064,1037,1027
"6184200","Kurunegala","Alawwa","Alawwa North","1000",1978,956,1022
"6184205","Kurunegala","Alawwa","Kebellavita","1004",610,297,313
"6184210","Kurunegala","Alawwa","Humbuluwa East","1006",1227,574,653
"6184215","Kurunegala","Alawwa","Humbuluwa West","1007",1736,794,942
"6184220","Kurunegala","Alawwa","Imbulgoda","1012",572,280,292
"6184225","Kurunegala","Alawwa","Keppitiwalana","1009",1415,651,764
"6184230","Kurunegala","Alawwa","Madawala","1010",896,432,464
"6184235","Kurunegala","Alawwa","Othara Kiruwampola","1011",681,309,372
"6184240","Kurunegala","Alawwa","Nebadawathura","1028",828,383,445
"6184245","Kurunegala","Alawwa","Galdeniya","1027",610,302,308
"6184250","Kurunegala","Alawwa","Kanameewala","1026",666,328,338
"6184255","Kurunegala","Alawwa","Wedeniya","1025",826,381,445
"6184260","Kurunegala","Alawwa","Nawathalwatta","1023",1249,575,674
"6184265","Kurunegala","Alawwa","Thumbulla","1013",1400,672,728
"6184270","Kurunegala","Alawwa","Abbowa","1014",1837,915,922
"6184275","Kurunegala","Alawwa","Paramaulla","1003",1526,731,795
"6184280","Kurunegala","Alawwa","Galpottepola","1005",821,391,430
"6184285","Kurunegala","Alawwa","Miriheliya","1002",1204,586,618
"6184290","Kurunegala","Alawwa","Pallemorugama","1017",610,305,305
"6184295","Kurunegala","Alawwa","Udakekulawala","1016",705,346,359
"6184300","Kurunegala","Alawwa","Udagankanda","1015",987,481,506
"6184305","Kurunegala","Alawwa","Wewala","1022",872,418,454
"6184310","Kurunegala","Alawwa","Pallekekulawala","1024",727,367,360
"6184315","Kurunegala","Alawwa","Yattalgoda","1020",709,365,344
"6184320","Kurunegala","Alawwa","Bowala","1021",891,427,464
"6184325","Kurunegala","Alawwa","Bujjomuwa","1018",1162,549,613
"6184330","Kurunegala","Alawwa","Kendahena","1019",744,343,401
"6187005","Kurunegala","Polgahawela","Ahugoda East","883",876,443,433
"6187010","Kurunegala","Polgahawela","Amunugama","884",937,457,480
"6187015","Kurunegala","Polgahawela","Gammana","905",763,358,405
"6187020","Kurunegala","Polgahawela","Pothuhera East","902",782,375,407
"6187025","Kurunegala","Polgahawela","Pothuhera West","903",1302,617,685
"6187030","Kurunegala","Polgahawela","Ahugoda Meda","882",604,276,328
"6187035","Kurunegala","Polgahawela","Ahugoda West","881",533,266,267
"6187040","Kurunegala","Polgahawela","Mahapitiya","901",572,271,301
"6187045","Kurunegala","Polgahawela","Dewate Gedara","888",280,136,144
"6187050","Kurunegala","Polgahawela","Hiripathwella","886",758,374,384
"6187055","Kurunegala","Polgahawela","Ginneriya","957",393,197,196
"6187060","Kurunegala","Polgahawela","Wadakada","956",696,341,355
"6187065","Kurunegala","Polgahawela","Habarawa","885",564,279,285
"6187070","Kurunegala","Polgahawela","Embalawatta","887",416,192,224
"6187075","Kurunegala","Polgahawela","Lihinigiriya","889",511,232,279
"6187080","Kurunegala","Polgahawela","Medalassa Kalugamuwa","891",429,203,226
"6187085","Kurunegala","Polgahawela","Yatihena","900",348,176,172
"6187090","Kurunegala","Polgahawela","Maningamuwa","958",434,212,222
"6187095","Kurunegala","Polgahawela","Mawathagama","899",542,256,286
"6187100","Kurunegala","Polgahawela","Mandawela","908",541,243,298
"6187105","Kurunegala","Polgahawela","Kureepotta","904",618,289,329
"6187110","Kurunegala","Polgahawela","Arambepola","906",682,303,379
"6187115","Kurunegala","Polgahawela","Handugala","898",1236,594,642
"6187120","Kurunegala","Polgahawela","Bevilgamuwa East","895",863,409,454
"6187125","Kurunegala","Polgahawela","Bevilgamuwa West","964",400,185,215
"6187130","Kurunegala","Polgahawela","Thiyador Watta","894",570,254,316
"6187135","Kurunegala","Polgahawela","Dembegoda","959",426,207,219
"6187140","Kurunegala","Polgahawela","Imbulana","890",502,235,267
"6187145","Kurunegala","Polgahawela","Kebilittawala","918",662,302,360
"6187150","Kurunegala","Polgahawela","Egalla","952",971,460,511
"6187155","Kurunegala","Polgahawela","Gallenamulla","951",774,378,396
"6187160","Kurunegala","Polgahawela","Udapola","950",655,321,334
"6187165","Kurunegala","Polgahawela","Kaluhendiwala","897",352,178,174
"6187170","Kurunegala","Polgahawela","Thalawattegedara","896",630,287,343
"6187175","Kurunegala","Polgahawela","Kolambalamulla","892",400,194,206
"6187180","Kurunegala","Polgahawela","Parabevila","893",1392,673,719
"6187185","Kurunegala","Polgahawela","Koradoluwa","912",723,341,382
"6187190","Kurunegala","Polgahawela","Walagammulla","907",667,321,346
"6187195","Kurunegala","Polgahawela","Kendahena","962",375,181,194
"6187200","Kurunegala","Polgahawela","Polpitiya North","914",372,173,199
"6187205","Kurunegala","Polgahawela","Poojapitiya","911",337,165,172
"6187210","Kurunegala","Polgahawela","Polambe","910",302,143,159
"6187215","Kurunegala","Polgahawela","Hondella","913",1013,491,522
"6187220","Kurunegala","Polgahawela","Imbulgoda","909",599,280,319
"6187225","Kurunegala","Polgahawela","Barahelagamuwa","919",631,317,314
"6187230","Kurunegala","Polgahawela","Dewalepola","953",727,335,392
"6187235","Kurunegala","Polgahawela","Ihala Udapola","955",627,287,340
"6187240","Kurunegala","Polgahawela","Divulkumbura","954",611,308,303
"6187245","Kurunegala","Polgahawela","Bandawa","922",1935,894,1041
"6187250","Kurunegala","Polgahawela","Hathalispahuwa","963",459,225,234
"6187255","Kurunegala","Polgahawela","Rathmalgoda","917",876,418,458
"6187260","Kurunegala","Polgahawela","Kollura","923",542,259,283
"6187265","Kurunegala","Polgahawela","Wellewa","916",1127,576,551
"6187270","Kurunegala","Polgahawela","Polpitiya South","915",519,250,269
"6187275","Kurunegala","Polgahawela","Nahakotamada","926",418,209,209
"6187280","Kurunegala","Polgahawela","Aragoda","925",837,408,429
"6187285","Kurunegala","Polgahawela","Sunilagama","929",724,363,361
"6187290","Kurunegala","Polgahawela","Denagamuwa","924",1347,687,660
"6187295","Kurunegala","Polgahawela","Madalagama","920",994,457,537
"6187300","Kurunegala","Polgahawela","Godawela","921",786,386,400
"6187305","Kurunegala","Polgahawela","Kotambule","949",655,307,348
"6187310","Kurunegala","Polgahawela","Mawatta","947",822,405,417
"6187315","Kurunegala","Polgahawela","Weeragala","948",524,259,265
"6187320","Kurunegala","Polgahawela","Yogamuwakanda","945",411,199,212
"6187325","Kurunegala","Polgahawela","Epakanda","937",1151,567,584
"6187330","Kurunegala","Polgahawela","Ganegoda North","941",638,286,352
"6187335","Kurunegala","Polgahawela","Delgolla","943",875,417,458
"6187340","Kurunegala","Polgahawela","Gorokgahapotta","961",674,329,345
"6187345","Kurunegala","Polgahawela","Godigamuwa","927",1084,501,583
"6187350","Kurunegala","Polgahawela","Udukedeniya","928",928,441,487
"6187355","Kurunegala","Polgahawela","Panaliya North","930",891,425,466
"6187360","Kurunegala","Polgahawela","Tenpana","932",1082,530,552
"6187365","Kurunegala","Polgahawela","Kuleepitiya North","939",751,366,385
"6187370","Kurunegala","Polgahawela","Ganegoda South","942",1032,510,522
"6187375","Kurunegala","Polgahawela","Polgahawela North","934",1207,596,611
"6187380","Kurunegala","Polgahawela","Meddalanda","935",1406,691,715
"6187385","Kurunegala","Polgahawela","Morugama","944",902,424,478
"6187390","Kurunegala","Polgahawela","Galbadagama","936",573,288,285
"6187395","Kurunegala","Polgahawela","Weligodapitiya","946",1052,492,560
"6187400","Kurunegala","Polgahawela","Polgahawela South","938",1644,781,863
"6187405","Kurunegala","Polgahawela","Kuleepitiya South","940",1157,549,608
"6187410","Kurunegala","Polgahawela","Serapees Watta","933",1209,546,663
"6187415","Kurunegala","Polgahawela","Panaliya South","931",978,472,506
"6187420","Kurunegala","Polgahawela","Oruliyadda","960",2548,1217,1331
"6203005","Puttalam","Kalpitiya","Duechbay","633",1259,685,574
"6203010","Puttalam","Kalpitiya","Palliyawatta","633A",1207,827,380
"6203015","Puttalam","Kalpitiya","Anawasala","631A",3482,1704,1778
"6203020","Puttalam","Kalpitiya","Sinnakudirippu","631",1065,523,542
"6203025","Puttalam","Kalpitiya","Wanni Mundalama","630B",2263,1139,1124
"6203030","Puttalam","Kalpitiya","Mandalakudawa","630C",6217,3023,3194
"6203035","Puttalam","Kalpitiya","Periyakudirippu","630",1085,546,539
"6203040","Puttalam","Kalpitiya","Pudukudirippuwa","630A",2063,1035,1028
"6203045","Puttalam","Kalpitiya","Kandakuliya Kudawa","629C",619,314,305
"6203050","Puttalam","Kalpitiya","Kurinjipitiya North","629",2120,1052,1068
"6203055","Puttalam","Kalpitiya","Kurinjipitiya South","629B",2204,1069,1135
"6203060","Puttalam","Kalpitiya","Kandakuliya","629A",4548,2186,2362
"6203065","Puttalam","Kalpitiya","Palliwasalthure","628A",3897,1856,2041
"6203070","Puttalam","Kalpitiya","Musalpitiya","628",1963,950,1013
"6203075","Puttalam","Kalpitiya","Mudalappaliya","626",4003,1879,2124
"6203080","Puttalam","Kalpitiya","Thalavila East","626A",1738,837,901
"6203085","Puttalam","Kalpitiya","Thalavila West","626B",1091,548,543
"6203090","Puttalam","Kalpitiya","Palakudawa","626C",2464,1216,1248
"6203095","Puttalam","Kalpitiya","Thigali","624",2503,1231,1272
"6203100","Puttalam","Kalpitiya","Ettala","623",3267,1637,1630
"6203105","Puttalam","Kalpitiya","Andankanniya","622A",1168,533,635
"6203110","Puttalam","Kalpitiya","Alankudawa","622",6608,3164,3444
"6203115","Puttalam","Kalpitiya","Norochchola","621A",7029,3530,3499
"6203120","Puttalam","Kalpitiya","Paniyadiya","621",2534,1242,1292
"6203125","Puttalam","Kalpitiya","Narakkalliya","620",2507,1709,798
"6203130","Puttalam","Kalpitiya","Mampuriya","619",2815,1411,1404
"6203135","Puttalam","Kalpitiya","Nawakkaduwa","605",1884,953,931
"6203140","Puttalam","Kalpitiya","Nirmalapura","605B",2033,1028,1005
"6203145","Puttalam","Kalpitiya","Daluwa","605A",1010,503,507
"6203150","Puttalam","Kalpitiya","Thethapola","603",2056,1099,957
"6203155","Puttalam","Kalpitiya","Karamba","603A",7703,3815,3888
"6206005","Puttalam","Vanathavilluwa","Pukkulama","634",113,75,38
"6206010","Puttalam","Vanathavilluwa","Ralmaduwa","635/2",805,422,383
"6206015","Puttalam","Vanathavilluwa","Parana Eluwankulama","635",234,127,107
"6206020","Puttalam","Vanathavilluwa","Aluth Eluwankulama","635/1",770,393,377
"6206025","Puttalam","Vanathavilluwa","Serakkuliya","635/3",1368,689,679
"6206030","Puttalam","Vanathavilluwa","Karathivu North","635/4",2409,1145,1264
"6206035","Puttalam","Vanathavilluwa","Karathivu South","636",956,465,491
"6206040","Puttalam","Vanathavilluwa","Mangala Pura","636/6",1014,496,518
"6206045","Puttalam","Vanathavilluwa","Bandaranayakapura","636/5",980,475,505
"6206050","Puttalam","Vanathavilluwa","Vanathavilluwa North","636/2",865,471,394
"6206055","Puttalam","Vanathavilluwa","Vanathavilluwa South","636/1",1248,614,634
"6206060","Puttalam","Vanathavilluwa","Wijayapura West","636/4",722,346,376
"6206065","Puttalam","Vanathavilluwa","Wijayapura East","636/3",805,408,397
"6206070","Puttalam","Vanathavilluwa","Karadipuwal","637/3",455,230,225
"6206075","Puttalam","Vanathavilluwa","Samagipura","637/2",889,427,462
"6206080","Puttalam","Vanathavilluwa","Vattakandal","637",2900,1403,1497
"6206085","Puttalam","Vanathavilluwa","Mailankulama","637/1",927,445,482
"6209005","Puttalam","Karuwalagaswewa","Pahala Puliyankulama","638",917,505,412
"6209010","Puttalam","Karuwalagaswewa","Moonamalgaswewa","638D",848,428,420
"6209015","Puttalam","Karuwalagaswewa","Saliyawewa","638A",2166,1097,1069
"6209020","Puttalam","Karuwalagaswewa","Ranawarapitiya","638E",518,249,269
"6209025","Puttalam","Karuwalagaswewa","Saliyawewa - C","638C",733,371,362
"6209030","Puttalam","Karuwalagaswewa","Saliyawewa - B","638B",572,293,279
"6209035","Puttalam","Karuwalagaswewa","Palugassegama","639D",1168,571,597
"6209040","Puttalam","Karuwalagaswewa","Ihala Puliyankulama","639",773,408,365
"6209045","Puttalam","Karuwalagaswewa","Thambapanniya","640D",732,335,397
"6209050","Puttalam","Karuwalagaswewa","Medagama","639B",731,345,386
"6209055","Puttalam","Karuwalagaswewa","Aluthgama","639A",1554,786,768
"6209060","Puttalam","Karuwalagaswewa","Weerapura","642D",1592,814,778
"6209065","Puttalam","Karuwalagaswewa","Dangaswewa","642C",663,338,325
"6209070","Puttalam","Karuwalagaswewa","Ipalogama","642",633,302,331
"6209075","Puttalam","Karuwalagaswewa","Kumbukwewa","642B",708,354,354
"6209080","Puttalam","Karuwalagaswewa","Rambawewa","642A",584,285,299
"6209085","Puttalam","Karuwalagaswewa","Pahariya","639C",546,268,278
"6209090","Puttalam","Karuwalagaswewa","Murukkuwatawana","640",677,337,340
"6209095","Puttalam","Karuwalagaswewa","Thabbowa South","640F",1745,842,903
"6209100","Puttalam","Karuwalagaswewa","Thabbowa North","640A",506,238,268
"6209105","Puttalam","Karuwalagaswewa","Thewanuwara","640B",880,451,429
"6209110","Puttalam","Karuwalagaswewa","Pawattamaduwa","640G",687,329,358
"6209115","Puttalam","Karuwalagaswewa","Karuwalagaswewa","640C",1363,741,622
"6209120","Puttalam","Karuwalagaswewa","Kuda Medawachchiya","640E",471,241,230
"6209125","Puttalam","Karuwalagaswewa","Paleegama","648",875,434,441
"6209130","Puttalam","Karuwalagaswewa","Egodapitiya","648A",798,408,390
"6212005","Puttalam","Nawagattegama","Mahameddewa","643/1",1062,533,529
"6212010","Puttalam","Nawagattegama","Moragahawewa","643",584,305,279
"6212015","Puttalam","Nawagattegama","Maha Andarawewa","644/2",548,260,288
"6212020","Puttalam","Nawagattegama","Kirimetiyawa","644",1392,688,704
"6212025","Puttalam","Nawagattegama","Miyellewa","644/3",898,450,448
"6212030","Puttalam","Nawagattegama","Thammennawetiya","646",736,328,408
"6212035","Puttalam","Nawagattegama","Samurdhigama","646/3",551,267,284
"6212040","Puttalam","Nawagattegama","Amunuwewa","647",319,154,165
"6212045","Puttalam","Nawagattegama","Kuruluwewa","647/3",618,299,319
"6212050","Puttalam","Nawagattegama","Tharanagahawewa","647/2",575,292,283
"6212055","Puttalam","Nawagattegama","Kelewewa","647/1",560,273,287
"6212060","Puttalam","Nawagattegama","Welewewa North","646/1",753,368,385
"6212065","Puttalam","Nawagattegama","Mullegama","645/3",883,431,452
"6212070","Puttalam","Nawagattegama","Welewewa South","646/2",883,446,437
"6212075","Puttalam","Nawagattegama","Gedarawewa","645/4",340,180,160
"6212080","Puttalam","Nawagattegama","Rambakanayagama","644/1",906,426,480
"6212085","Puttalam","Nawagattegama","Inginimitiya East","645/1",1048,531,517
"6212090","Puttalam","Nawagattegama","Inginimitiya West","645/2",951,466,485
"6212095","Puttalam","Nawagattegama","Konkadawala","645",876,434,442
"6215005","Puttalam","Puttalam","Manalthivu","606",7576,3674,3902
"6215010","Puttalam","Puttalam","Sirambiadiya","615D",2099,1018,1081
"6215015","Puttalam","Puttalam","Sella Kandal","615",809,399,410
"6215020","Puttalam","Puttalam","Nelumwewa","615C",1092,536,556
"6215025","Puttalam","Puttalam","Marikkar Street","617C",3525,1694,1831
"6215030","Puttalam","Puttalam","Mullipuram","617A",3654,1821,1833
"6215035","Puttalam","Puttalam","Pudukudirippuwa","617F",6751,3244,3507
"6215040","Puttalam","Puttalam","Puttalam East","617B",14017,6740,7277
"6215045","Puttalam","Puttalam","Senakudirippuwa","616",3929,1891,2038
"6215050","Puttalam","Puttalam","Thiladiya","618A",10175,4928,5247
"6215055","Puttalam","Puttalam","Puttalam South","618",3166,1565,1601
"6215060","Puttalam","Puttalam","Parana Jumma Palli","617D",1573,737,836
"6215065","Puttalam","Puttalam","Puttalam North","617",1749,854,895
"6215070","Puttalam","Puttalam","Periyapalli Kudiyiruppuwa","617E",626,327,299
"6215075","Puttalam","Puttalam","Rathmalyaya","618B",6774,3132,3642
"6215080","Puttalam","Puttalam","Thammennagama","615B",968,479,489
"6215085","Puttalam","Puttalam","Kaladiya","615A",1454,742,712
"6215090","Puttalam","Puttalam","Bodhirajapura","607C",850,404,446
"6215095","Puttalam","Puttalam","Attavilluwa","607A",1104,589,515
"6215100","Puttalam","Puttalam","Palaviya","607",3410,1668,1742
"6215105","Puttalam","Puttalam","Pottuvilluwa","607D",5307,2441,2866
"6215110","Puttalam","Puttalam","Attavilluwa Central","607B",1835,902,933
"6218005","Puttalam","Mundel","Puludiviyal","601A",2466,1152,1314
"6218010","Puttalam","Mundel","Viruthodai","601",3232,1583,1649
"6218015","Puttalam","Mundel","Weerapura","608B",3937,1845,2092
"6218020","Puttalam","Mundel","Welusumanapura","608A",2260,1112,1148
"6218025","Puttalam","Mundel","Madurankuliya","609",2886,1439,1447
"6218030","Puttalam","Mundel","Kanamulla North","599C",1944,891,1053
"6218035","Puttalam","Mundel","Kadayamotte","599",2028,978,1050
"6218040","Puttalam","Mundel","Nallandaluwa","601B",1641,766,875
"6218045","Puttalam","Mundel","Palasola","601C",2498,1199,1299
"6218050","Puttalam","Mundel","Mukkuthoduwawa","599A",2644,1340,1304
"6218055","Puttalam","Mundel","Kandathoduwawa","599B",1458,709,749
"6218060","Puttalam","Mundel","Kanamulla South","599D",1708,785,923
"6218065","Puttalam","Mundel","Pubudugama","609A",1361,660,701
"6218070","Puttalam","Mundel","Sameeragama","598A",1182,555,627
"6218075","Puttalam","Mundel","Palliwasalpaduwa","598B",1937,932,1005
"6218080","Puttalam","Mundel","Perukkuvattan","598C",1363,642,721
"6218085","Puttalam","Mundel","Kottanthievu","598",2011,975,1036
"6218090","Puttalam","Mundel","Mangalaeliya","610A",1242,634,608
"6218095","Puttalam","Mundel","Nawadankulama","610B",628,299,329
"6218100","Puttalam","Mundel","Mundalama","610",951,475,476
"6218105","Puttalam","Mundel","Kudirippuwa","610D",1152,551,601
"6218110","Puttalam","Mundel","Kattakaduwa","597",2107,1009,1098
"6218115","Puttalam","Mundel","Sinnapaduwa","597B",1364,666,698
"6218120","Puttalam","Mundel","Poonapitiya","597A",1510,742,768
"6218125","Puttalam","Mundel","Andimunai","594A",2621,1225,1396
"6218130","Puttalam","Mundel","Udappuwa","594",1087,460,627
"6218135","Puttalam","Mundel","Udappuwa","594B",3011,1446,1565
"6218140","Puttalam","Mundel","Pulichchakulama","593",4716,2238,2478
"6218145","Puttalam","Mundel","Karathanvilluwa","610C",1426,661,765
"6218150","Puttalam","Mundel","Tharakudivilluwa","593B",2335,1108,1227
"6218155","Puttalam","Mundel","Angunavila","593A",932,448,484
"6221005","Puttalam","Mahakumbukkadawala","Kivula No. 4-2","614C",901,432,469
"6221010","Puttalam","Mahakumbukkadawala","Dangahawala","614D",740,359,381
"6221015","Puttalam","Mahakumbukkadawala","Kivula No. 4-1","614A",1006,479,527
"6221020","Puttalam","Mahakumbukkadawala","Kivula Youth Project","614B",1280,624,656
"6221025","Puttalam","Mahakumbukkadawala","Kivula No. 1","614F",931,451,480
"6221030","Puttalam","Mahakumbukkadawala","Kivulagoda Govi Janapadaya","614E",512,248,264
"6221035","Puttalam","Mahakumbukkadawala","Rathmalgaswewa","613D",486,249,237
"6221040","Puttalam","Mahakumbukkadawala","Dangaswewa","613E",637,314,323
"6221045","Puttalam","Mahakumbukkadawala","Kawayankulama","613",620,303,317
"6221050","Puttalam","Mahakumbukkadawala","Jayarajapura","613A",450,213,237
"6221055","Puttalam","Mahakumbukkadawala","Karuwalabedda","611A",609,278,331
"6221060","Puttalam","Mahakumbukkadawala","Maha Kumbukkadawala","613B",617,314,303
"6221065","Puttalam","Mahakumbukkadawala","Sembukuliya","613C",378,174,204
"6221070","Puttalam","Mahakumbukkadawala","Walpaluwa","658A",987,470,517
"6221075","Puttalam","Mahakumbukkadawala","Kakupandiyawa","658B",642,316,326
"6221080","Puttalam","Mahakumbukkadawala","Punavitiya","612D",583,283,300
"6221085","Puttalam","Mahakumbukkadawala","Garayakgama","658",880,425,455
"6221090","Puttalam","Mahakumbukkadawala","Daluwegama","612E",531,261,270
"6221095","Puttalam","Mahakumbukkadawala","Mohoriya","612",891,437,454
"6221100","Puttalam","Mahakumbukkadawala","Baranankattuwa","611",800,385,415
"6221105","Puttalam","Mahakumbukkadawala","Karungalichole","611B",609,276,333
"6221110","Puttalam","Mahakumbukkadawala","Mahasembukuliya","611D",883,426,457
"6221115","Puttalam","Mahakumbukkadawala","Galkuliya West","612C",593,288,305
"6221120","Puttalam","Mahakumbukkadawala","Galkuliya East","612B",796,379,417
"6221125","Puttalam","Mahakumbukkadawala","Andigama","612A",1271,591,680
"6224005","Puttalam","Anamaduwa","Kottukachchiya Colony 2","649C",1276,627,649
"6224010","Puttalam","Anamaduwa","Kottukachchiya Colony 1","649B",930,456,474
"6224015","Puttalam","Anamaduwa","Mellankulama","614",884,449,435
"6224020","Puttalam","Anamaduwa","Kottukachchiya","649",1341,679,662
"6224025","Puttalam","Anamaduwa","Paliyagama","650D",964,462,502
"6224030","Puttalam","Anamaduwa","Uriyawa","650B",1230,613,617
"6224035","Puttalam","Anamaduwa","Koilandigama","650",1000,491,509
"6224040","Puttalam","Anamaduwa","07 Gammanaya","651B",645,299,346
"6224045","Puttalam","Anamaduwa","Maha Uswewa South","652B",988,479,509
"6224050","Puttalam","Anamaduwa","Maha Uswewa North","652A",1098,511,587
"6224055","Puttalam","Anamaduwa","Alankulama","652",1341,635,706
"6224060","Puttalam","Anamaduwa","Merungoda","651",1237,593,644
"6224065","Puttalam","Anamaduwa","Labugala","651A",819,404,415
"6224070","Puttalam","Anamaduwa","Karambewa","653",450,219,231
"6224075","Puttalam","Anamaduwa","Thalgaswewa","653A",514,251,263
"6224080","Puttalam","Anamaduwa","Periyakulama","653C",1163,561,602
"6224085","Puttalam","Anamaduwa","Paramakandagama","650C",909,466,443
"6224090","Puttalam","Anamaduwa","Thonigala","650A",1374,676,698
"6224095","Puttalam","Anamaduwa","Wadatta","657",1031,523,508
"6224100","Puttalam","Anamaduwa","Viharagama","649A",745,356,389
"6224105","Puttalam","Anamaduwa","Siyambalagashena","657A",1250,615,635
"6224110","Puttalam","Anamaduwa","Thattewa","656",1243,624,619
"6224115","Puttalam","Anamaduwa","Thammennagama","656B",1825,865,960
"6224120","Puttalam","Anamaduwa","Bammannegama","653D",1046,524,522
"6224125","Puttalam","Anamaduwa","Kothalakemiyawa","655",831,412,419
"6224130","Puttalam","Anamaduwa","Gallewa","653B",515,249,266
"6224135","Puttalam","Anamaduwa","Thalakolawewa","655A",1276,589,687
"6224140","Puttalam","Anamaduwa","Anamaduwa","656A",1816,914,902
"6224145","Puttalam","Anamaduwa","Peramakuttuwa","656C",1328,646,682
"6224150","Puttalam","Anamaduwa","Divulwewa","658C",1070,530,540
"6224155","Puttalam","Anamaduwa","Wadigamangawa","659",1047,490,557
"6224160","Puttalam","Anamaduwa","Dharmapalaya","659A",1186,573,613
"6224165","Puttalam","Anamaduwa","Uppalawatta","659B",1020,483,537
"6224170","Puttalam","Anamaduwa","Sangattikulama","661A",1336,665,671
"6224175","Puttalam","Anamaduwa","Mudalakkuliya","661",1558,753,805
"6227005","Puttalam","Pallama","Dewala Handiya","591H",1742,807,935
"6227010","Puttalam","Pallama","Wilpatha East","591B",1498,734,764
"6227015","Puttalam","Pallama","Siyambalagaswewa","662C",793,396,397
"6227020","Puttalam","Pallama","Nagavila","662",1065,559,506
"6227025","Puttalam","Pallama","Periyamaduwa","662B",1090,528,562
"6227035","Puttalam","Pallama","Wilpatha West","591A",1519,749,770
"6227040","Puttalam","Pallama","Thamarakkulama","591C",1440,679,761
"6227045","Puttalam","Pallama","Serukele","662D",813,391,422
"6227050","Puttalam","Pallama","Katupotha","663",1271,640,631
"6227055","Puttalam","Pallama","Madawakkulama","663A",1689,849,840
"6227060","Puttalam","Pallama","Wetiya","663B",1894,866,1028
"6227065","Puttalam","Pallama","Nandimithrapura","664C",2437,1188,1249
"6227070","Puttalam","Pallama","Wendakaduwa","664A",888,435,453
"6227075","Puttalam","Pallama","Pallama","664",1887,911,976
"6227080","Puttalam","Pallama","Wathupola","664B",984,470,514
"6227085","Puttalam","Pallama","Puliyankulama","665",735,369,366
"6227090","Puttalam","Pallama","Thammana","665A",1182,579,603
"6230005","Puttalam","Arachchikattuwa","Battaluoya","591",1393,658,735
"6230010","Puttalam","Arachchikattuwa","Mahamaeliya","591F",907,416,491
"6230015","Puttalam","Arachchikattuwa","Buruthakele","591D",1540,713,827
"6230020","Puttalam","Arachchikattuwa","Wijayakatupatha Elen Megoda","591B",2181,1005,1176
"6230025","Puttalam","Arachchikattuwa","Pahala Attanganaya","592F",608,293,315
"6230030","Puttalam","Arachchikattuwa","Wijayakatupatha Elen Egoda","591E",577,273,304
"6230035","Puttalam","Arachchikattuwa","Anavilundawa","590",959,471,488
"6230040","Puttalam","Arachchikattuwa","Suruvila","589A",865,398,467
"6230045","Puttalam","Arachchikattuwa","Ilakkattuwa","592C",2024,977,1047
"6230050","Puttalam","Arachchikattuwa","Pankulawa","592D",775,358,417
"6230055","Puttalam","Arachchikattuwa","Ihala Attanganaya","592A",782,373,409
"6230060","Puttalam","Arachchikattuwa","Ambakele","592B",677,331,346
"6230065","Puttalam","Arachchikattuwa","Welipelessa","587",1031,487,544
"6230070","Puttalam","Arachchikattuwa","Nalladarankattuwa","592",682,330,352
"6230075","Puttalam","Arachchikattuwa","Karukupane","582",2401,1171,1230
"6230080","Puttalam","Arachchikattuwa","Wairankattuwa","585B",903,446,457
"6230085","Puttalam","Arachchikattuwa","Sengaloya","592E",1186,552,634
"6230090","Puttalam","Arachchikattuwa","Arachchikattuwa West","585",1518,757,761
"6230095","Puttalam","Arachchikattuwa","Arachchikattuwa East","585C",957,458,499
"6230100","Puttalam","Arachchikattuwa","Bandarahena","587A",1657,824,833
"6230105","Puttalam","Arachchikattuwa","Adippala","586",764,370,394
"6230110","Puttalam","Arachchikattuwa","Andanan Kattuwa","586A",658,324,334
"6230115","Puttalam","Arachchikattuwa","Kumarakattuwa","572",1359,660,699
"6230120","Puttalam","Arachchikattuwa","Elivitiya","571",1511,718,793
"6230125","Puttalam","Arachchikattuwa","Diganwewa","574B",1074,515,559
"6230130","Puttalam","Arachchikattuwa","Rajakadaluwa","585A",2122,1055,1067
"6230135","Puttalam","Arachchikattuwa","Kusala","583",867,407,460
"6230140","Puttalam","Arachchikattuwa","Kottapitiya","584",1280,621,659
"6230145","Puttalam","Arachchikattuwa","Bangadeniya","573",1103,544,559
"6230150","Puttalam","Arachchikattuwa","Weerakumandaluwa","574",2556,1248,1308
"6230155","Puttalam","Arachchikattuwa","Karukkuliya","574A",1110,517,593
"6230160","Puttalam","Arachchikattuwa","Mukkandaluwa","574C",1839,882,957
"6230165","Puttalam","Arachchikattuwa","Dematapitiya","581A",1133,571,562
"6233005","Puttalam","Chilaw","Kurusapaduwa","575A",1022,509,513
"6233010","Puttalam","Chilaw","Deduruoya","579B",3062,1516,1546
"6233015","Puttalam","Chilaw","Manuwangama West","569B",759,368,391
"6233020","Puttalam","Chilaw","Manuwangama East","569D",409,201,208
"6233025","Puttalam","Chilaw","Nariyagama North","569C",664,329,335
"6233030","Puttalam","Chilaw","Parappanmulla","569A",761,369,392
"6233035","Puttalam","Chilaw","Weerapandiyana","570A",750,375,375
"6233040","Puttalam","Chilaw","Maha Vilattawa","570",775,376,399
"6233045","Puttalam","Chilaw","Kanattawa","570B",539,272,267
"6233050","Puttalam","Chilaw","Nariyagama South","569F",492,231,261
"6233055","Puttalam","Chilaw","Urudayandaluwa","569E",455,209,246
"6233060","Puttalam","Chilaw","Thissogama","568A",1080,517,563
"6233065","Puttalam","Chilaw","Thimbilla","579A",2441,1238,1203
"6233070","Puttalam","Chilaw","Wattakkaliya","579",3310,1597,1713
"6233075","Puttalam","Chilaw","Weralabada South","575B",2194,1060,1134
"6233080","Puttalam","Chilaw","Weralabada North","575",1205,616,589
"6233085","Puttalam","Chilaw","Egodawatta","575C",1011,463,548
"6233090","Puttalam","Chilaw","Aluthwatta","576",1582,726,856
"6233095","Puttalam","Chilaw","Aluthwatta","576A",1350,610,740
"6233100","Puttalam","Chilaw","Ichchampitiya","580",3481,1556,1925
"6233105","Puttalam","Chilaw","Munneshwarama","568",1130,545,585
"6233110","Puttalam","Chilaw","Thittakade","567",2027,972,1055
"6233115","Puttalam","Chilaw","Mugunuwatawana","569",1263,621,642
"6233120","Puttalam","Chilaw","Kokkavila","549",1596,754,842
"6233125","Puttalam","Chilaw","Puliyankadawara","548A",812,377,435
"6233130","Puttalam","Chilaw","Punchi Vilattawa","548",820,390,430
"6233135","Puttalam","Chilaw","Karavitagara West","550",1035,501,534
"6233140","Puttalam","Chilaw","Karavitagara East","550A",1002,488,514
"6233145","Puttalam","Chilaw","Dambakele","550C",606,291,315
"6233150","Puttalam","Chilaw","Weerakelewatta","550B",1152,547,605
"6233155","Puttalam","Chilaw","Karavita","564",600,297,303
"6233160","Puttalam","Chilaw","Mungandaluwa East","564B",687,327,360
"6233165","Puttalam","Chilaw","Mungandaluwa West","564A",604,284,320
"6233170","Puttalam","Chilaw","Ilippadeniya","565",1080,508,572
"6233175","Puttalam","Chilaw","Sawarana","566A",2083,1017,1066
"6233180","Puttalam","Chilaw","Maikkulama","566B",3668,1714,1954
"6233185","Puttalam","Chilaw","Pitipana East","578A",1073,525,548
"6233190","Puttalam","Chilaw","Melpura","578C",1473,671,802
"6233195","Puttalam","Chilaw","Pitipana North","578B",1162,544,618
"6233200","Puttalam","Chilaw","Pitipana South","578",1483,711,772
"6233205","Puttalam","Chilaw","Weralabada","577",2732,1346,1386
"6233210","Puttalam","Chilaw","Welihena","562A",1362,668,694
"6233215","Puttalam","Chilaw","Merawala","566",932,427,505
"6233220","Puttalam","Chilaw","Inigodawela","566C",803,375,428
"6233225","Puttalam","Chilaw","Ihala Olidaluwa","558A",466,218,248
"6233230","Puttalam","Chilaw","Maradankulama","558",700,332,368
"6233235","Puttalam","Chilaw","Olidaluwa","563",748,348,400
"6233240","Puttalam","Chilaw","Ambakandavila","562",1285,629,656
"6233245","Puttalam","Chilaw","Kakkapalliya","561",789,353,436
"6236005","Puttalam","Madampe","Athuwana","547C",944,482,462
"6236010","Puttalam","Madampe","Mahagama North","547A",1048,490,558
"6236015","Puttalam","Madampe","Mahagama South","547",856,427,429
"6236020","Puttalam","Madampe","Kongasyaya","547B",566,274,292
"6236025","Puttalam","Madampe","Ponnankanniya","555",578,285,293
"6236030","Puttalam","Madampe","Manakkulama","556B",1670,789,881
"6236035","Puttalam","Madampe","Dematapitiya","557A",719,358,361
"6236040","Puttalam","Madampe","Thambagalla West","557C",704,360,344
"6236045","Puttalam","Madampe","Thambagalla","557",445,215,230
"6236050","Puttalam","Madampe","Thambagalla Watta","557B",939,463,476
"6236055","Puttalam","Madampe","Medagama","546A",912,433,479
"6236060","Puttalam","Madampe","Panirendawa","546B",574,282,292
"6236065","Puttalam","Madampe","Rathmal Agara","545A",536,251,285
"6236070","Puttalam","Madampe","Rathnagiriya","545B",647,322,325
"6236075","Puttalam","Madampe","Nankadawara","545",785,377,408
"6236080","Puttalam","Madampe","Kuda Bingiriya","546",991,469,522
"6236085","Puttalam","Madampe","Indigasvila","557D",449,217,232
"6236090","Puttalam","Madampe","Walahena","556A",1120,547,573
"6236095","Puttalam","Madampe","Pambala","560",764,353,411
"6236100","Puttalam","Madampe","Pambala South","560A",982,471,511
"6236105","Puttalam","Madampe","Hareendragama","554A",446,222,224
"6236110","Puttalam","Madampe","Sembukattiya","553",1257,620,637
"6236115","Puttalam","Madampe","Uraliya","551",840,407,433
"6236120","Puttalam","Madampe","Heen Agara","551A",1397,661,736
"6236125","Puttalam","Madampe","Kachchakaduwa","544A",611,298,313
"6236130","Puttalam","Madampe","Galmuruwa North","544",512,262,250
"6236135","Puttalam","Madampe","Kudirippuwa","543",1109,521,588
"6236140","Puttalam","Madampe","Karukkuwatawana","552",879,425,454
"6236145","Puttalam","Madampe","Erunvila","534D",1112,553,559
"6236150","Puttalam","Madampe","Karukkuwa","554",1193,586,607
"6236155","Puttalam","Madampe","Galahitiyawa","534C",1452,681,771
"6236160","Puttalam","Madampe","Maraggalagama","537",2377,1077,1300
"6236165","Puttalam","Madampe","Irattakulama North","534",807,381,426
"6236170","Puttalam","Madampe","Irattakulama South","534B",678,316,362
"6236175","Puttalam","Madampe","Egodayagama","535A",439,198,241
"6236180","Puttalam","Madampe","Pattiyagama","535",731,346,385
"6236185","Puttalam","Madampe","Ihalagama","536",1095,505,590
"6236190","Puttalam","Madampe","Uraliyagara","533",3073,1571,1502
"6236195","Puttalam","Madampe","Mellawagara","533A",1741,870,871
"6236200","Puttalam","Madampe","Suduwella","541A",1001,481,520
"6236205","Puttalam","Madampe","Pothuvila","534A",1533,742,791
"6236210","Puttalam","Madampe","Pallakele","543A",1127,550,577
"6236215","Puttalam","Madampe","Galmuruwa South","542A",1206,576,630
"6236220","Puttalam","Madampe","Henapola","542",968,498,470
"6236225","Puttalam","Madampe","Mugunuwatawana","541",1056,478,578
"6236230","Puttalam","Madampe","Pookulama","540A",412,185,227
"6236235","Puttalam","Madampe","Nelumpokuna","540",610,301,309
"6236240","Puttalam","Madampe","Mahabaddegama","537A",1331,755,576
"6236245","Puttalam","Madampe","Thaniwellagama","540B",698,330,368
"6239005","Puttalam","Mahawewa","Iranavila West","532",3700,1825,1875
"6239010","Puttalam","Mahawewa","Iranavila East","532A",1057,487,570
"6239015","Puttalam","Mahawewa","Thoduwawa North","531A",3014,1459,1555
"6239020","Puttalam","Mahawewa","Meda Thoduwawa","531B",2010,961,1049
"6239025","Puttalam","Mahawewa","Thoduwawa South","531",1354,649,705
"6239030","Puttalam","Mahawewa","Mattakotuwa","530",1095,491,604
"6239035","Puttalam","Mahawewa","Pahala Mahawewa","528",569,254,315
"6239040","Puttalam","Mahawewa","Adapparagama","529A",672,300,372
"6239045","Puttalam","Mahawewa","Ihala Kudawewa","522",855,416,439
"6239050","Puttalam","Mahawewa","Puruduwella","522C",416,204,212
"6239055","Puttalam","Mahawewa","Galamuna","522A",820,400,420
"6239060","Puttalam","Mahawewa","Medagoda","520",680,326,354
"6239065","Puttalam","Mahawewa","Hewana","521",715,343,372
"6239070","Puttalam","Mahawewa","Yatakalana","520A",730,361,369
"6239075","Puttalam","Mahawewa","Muttibendivila","517",545,270,275
"6239080","Puttalam","Mahawewa","Ihala Walahapitiya","518",1041,497,544
"6239085","Puttalam","Mahawewa","Meda Walahapitiya","518A",974,467,507
"6239090","Puttalam","Mahawewa","Pahala Kudawewa","522B",557,266,291
"6239095","Puttalam","Mahawewa","Maligawatta","529",834,396,438
"6239100","Puttalam","Mahawewa","Meda Mahawewa","524A",688,310,378
"6239105","Puttalam","Mahawewa","Veehena","528A",741,359,382
"6239110","Puttalam","Mahawewa","Mattakotuwella","530A",1501,727,774
"6239115","Puttalam","Mahawewa","Barudelpola","530B",1414,704,710
"6239120","Puttalam","Mahawewa","Ihala Mahawewa","524",2256,1070,1186
"6239125","Puttalam","Mahawewa","Pahala Koswadiya","527",645,290,355
"6239130","Puttalam","Mahawewa","Meda Koswadiya","527A",893,444,449
"6239135","Puttalam","Mahawewa","Ihala Koswadiya","526",1012,476,536
"6239140","Puttalam","Mahawewa","Pahala Walahapitiya","519",535,266,269
"6239145","Puttalam","Mahawewa","Panangoda","521A",1885,909,976
"6239150","Puttalam","Mahawewa","Sagaragama","517A",733,353,380
"6239155","Puttalam","Mahawewa","Egodagoda","518B",649,291,358
"6239160","Puttalam","Mahawewa","Puhulhena","519A",839,397,442
"6239165","Puttalam","Mahawewa","Halpanvila East","525",1410,663,747
"6239170","Puttalam","Mahawewa","Meda Hattiniya","515A",855,407,448
"6239175","Puttalam","Mahawewa","Halpanvila West","525A",757,355,402
"6239180","Puttalam","Mahawewa","Thalvila","511",1535,727,808
"6239185","Puttalam","Mahawewa","Modarawella","511A",537,267,270
"6239190","Puttalam","Mahawewa","Pahala Hattiniya","515",1032,487,545
"6239195","Puttalam","Mahawewa","Maravila North","512C",456,229,227
"6239200","Puttalam","Mahawewa","Ihala Hattiniya","514",1317,640,677
"6239205","Puttalam","Mahawewa","Maranda North","513A",1767,882,885
"6239210","Puttalam","Mahawewa","Maranda South","513B",1109,548,561
"6239215","Puttalam","Mahawewa","Horagolla North","513C",1129,514,615
"6239220","Puttalam","Mahawewa","Horagolla South","513",1129,591,538
"6239225","Puttalam","Mahawewa","Maravila Town","512",761,298,463
"6239230","Puttalam","Mahawewa","Maravila South","512B",1108,531,577
"6239235","Puttalam","Mahawewa","Maravila Wella","512A",747,364,383
"6242005","Puttalam","Nattandiya","Pahala Nattandiya","508",1313,648,665
"6242010","Puttalam","Nattandiya","Mailawa","507A",1162,568,594
"6242015","Puttalam","Nattandiya","Pilakatumulla","507",694,331,363
"6242020","Puttalam","Nattandiya","Dunkannawa","505B",2336,1152,1184
"6242025","Puttalam","Nattandiya","Maningala","505A",3185,1516,1669
"6242030","Puttalam","Nattandiya","Sandanangama","505",1417,658,759
"6242035","Puttalam","Nattandiya","Ihala Thabbowa","506",1573,748,825
"6242040","Puttalam","Nattandiya","Meda Thabbowa","506B",957,478,479
"6242045","Puttalam","Nattandiya","Pahala Thabbowa","506A",1462,689,773
"6242050","Puttalam","Nattandiya","Weerahena East","509",1497,708,789
"6242055","Puttalam","Nattandiya","Ihala Nattandiya","508A",1882,918,964
"6242060","Puttalam","Nattandiya","Meda Nattandiya","508B",1851,880,971
"6242065","Puttalam","Nattandiya","Weerahena West","509A",2177,977,1200
"6242070","Puttalam","Nattandiya","Mudukatuwa North","510",3099,1445,1654
"6242075","Puttalam","Nattandiya","Mudukatuwa South","510A",3030,1457,1573
"6242080","Puttalam","Nattandiya","Mudukatuwa East","510B",544,246,298
"6242085","Puttalam","Nattandiya","Pahala Mavila","504B",1256,617,639
"6242090","Puttalam","Nattandiya","Meda Mavila","504A",1755,827,928
"6242095","Puttalam","Nattandiya","Ihala Mavila","504",869,428,441
"6242100","Puttalam","Nattandiya","Pahala Kottaramulla","497",1073,524,549
"6242105","Puttalam","Nattandiya","Paluwelgala North","501",665,312,353
"6242110","Puttalam","Nattandiya","Kachchirawa","500A",479,217,262
"6242115","Puttalam","Nattandiya","Paluwelgala South","501A",503,235,268
"6242120","Puttalam","Nattandiya","Naravila","500",1177,565,612
"6242125","Puttalam","Nattandiya","Kuddetiyawa","499A",652,313,339
"6242130","Puttalam","Nattandiya","Yakdessawa","499",632,311,321
"6242135","Puttalam","Nattandiya","Koswatta North","498",809,375,434
"6242140","Puttalam","Nattandiya","Meegahawela","498A",763,378,385
"6242145","Puttalam","Nattandiya","Koswatta South","498B",809,387,422
"6242150","Puttalam","Nattandiya","Morakele South","503A",1178,561,617
"6242155","Puttalam","Nattandiya","Meda Kottaramulla","502A",2279,1099,1180
"6242160","Puttalam","Nattandiya","Morakele North","503",1091,531,560
"6242165","Puttalam","Nattandiya","Ihala Kottaramulla","502",2141,1026,1115
"6242170","Puttalam","Nattandiya","Thummodara East","497A",884,425,459
"6242175","Puttalam","Nattandiya","Thummodara West","497B",1709,830,879
"6242180","Puttalam","Nattandiya","Nakele","495C",407,193,214
"6242185","Puttalam","Nattandiya","Ihala Katuneriya","495",1622,762,860
"6242190","Puttalam","Nattandiya","Bulugahawewa","496B",1153,532,621
"6242195","Puttalam","Nattandiya","Nebadagahayaya","495D",1518,713,805
"6242200","Puttalam","Nattandiya","Lansigama","494A",1487,689,798
"6242205","Puttalam","Nattandiya","Pahala Katuneriya North","494B",1174,545,629
"6242210","Puttalam","Nattandiya","Meda Pahala Katuneriya","494",1417,640,777
"6242215","Puttalam","Nattandiya","Pahala Katuneriya South","494C",1186,561,625
"6242220","Puttalam","Nattandiya","Meda Katuneriya","496",815,355,460
"6242225","Puttalam","Nattandiya","Meegahawewa","496A",993,472,521
"6242230","Puttalam","Nattandiya","Dematapitiya","495A",803,406,397
"6242235","Puttalam","Nattandiya","Dhammikagama","495B",667,302,365
"6245005","Puttalam","Wennappuwa","Kolinjadiya West","493A",1452,675,777
"6245010","Puttalam","Wennappuwa","Kolinjadiya North","493B",1036,457,579
"6245015","Puttalam","Wennappuwa","Udasirigama","467C",1142,539,603
"6245020","Puttalam","Wennappuwa","Sirigampala North","467B",1067,514,553
"6245025","Puttalam","Wennappuwa","Lunuvila East","467",1965,930,1035
"6245030","Puttalam","Wennappuwa","Sirigampala South","467A",1724,854,870
"6245035","Puttalam","Wennappuwa","Meda Lunuvila","467D",5051,2542,2509
"6245040","Puttalam","Wennappuwa","Lunuvila West","467F",1268,612,656
"6245045","Puttalam","Wennappuwa","Wennappuwa North","491",1637,749,888
"6245050","Puttalam","Wennappuwa","Kolinjadiya East","493",774,365,409
"6245055","Puttalam","Wennappuwa","Kolinjadiya South","493C",859,408,451
"6245060","Puttalam","Wennappuwa","Ulhitiyawa West","492C",1373,651,722
"6245065","Puttalam","Wennappuwa","Ulhitiyawa North","492",1445,645,800
"6245070","Puttalam","Wennappuwa","Meda Ulhitiyawa","492B",1763,798,965
"6245075","Puttalam","Wennappuwa","Wennappuwa West","491C",1684,740,944
"6245080","Puttalam","Wennappuwa","Meda Wennappuwa","491B",1159,502,657
"6245085","Puttalam","Wennappuwa","Wennappuwa East","491D",1213,551,662
"6245090","Puttalam","Wennappuwa","Lunuvila South","467E",1458,672,786
"6245095","Puttalam","Wennappuwa","Bandirippuwa North","476",1314,636,678
"6245100","Puttalam","Wennappuwa","Bandirippuwa West","476B",1483,665,818
"6245105","Puttalam","Wennappuwa","Wennappuwa South","491A",1321,613,708
"6245110","Puttalam","Wennappuwa","Ulhitiyawa South","492A",1786,831,955
"6245115","Puttalam","Wennappuwa","Kadawatha","492D",1409,684,725
"6245120","Puttalam","Wennappuwa","Dummaladeniya West","489",1273,620,653
"6245125","Puttalam","Wennappuwa","Meda Dummaladeniya","489A",1382,663,719
"6245130","Puttalam","Wennappuwa","Dummaladeniya North","490A",863,403,460
"6245135","Puttalam","Wennappuwa","Bandirippuwa East","476A",2366,1147,1219
"6245140","Puttalam","Wennappuwa","Dummaladeniya East","490",993,486,507
"6245145","Puttalam","Wennappuwa","Dummaladeniya South","490B",854,386,468
"6245150","Puttalam","Wennappuwa","Wellamankaraya","486B",1339,633,706
"6245155","Puttalam","Wennappuwa","Meda Nainamadama","486A",1661,761,900
"6245160","Puttalam","Wennappuwa","Hanathotupola","485A",911,413,498
"6245165","Puttalam","Wennappuwa","Boralessa West","488A",809,373,436
"6245170","Puttalam","Wennappuwa","Boralessa North","488B",993,463,530
"6245175","Puttalam","Wennappuwa","Boralessa East","488",1489,703,786
"6245180","Puttalam","Wennappuwa","Boralessa South","488C",875,407,468
"6245185","Puttalam","Wennappuwa","Nainamadama West","486",1226,576,650
"6245190","Puttalam","Wennappuwa","Nainamadama East","485",1030,459,571
"6245195","Puttalam","Wennappuwa","Mirissankotuwa North","487",623,294,329
"6245200","Puttalam","Wennappuwa","Mirissankotuwa South","487A",882,431,451
"6245205","Puttalam","Wennappuwa","Bolawatta","484A",941,459,482
"6245210","Puttalam","Wennappuwa","Rangammulla","483",832,376,456
"6245215","Puttalam","Wennappuwa","Kammala","481B",1303,623,680
"6245220","Puttalam","Wennappuwa","Angampitiya East","484",836,376,460
"6245225","Puttalam","Wennappuwa","Angampitiya West","484B",1274,607,667
"6245230","Puttalam","Wennappuwa","Aluttota","481A",1353,706,647
"6245235","Puttalam","Wennappuwa","Sindathriya","481",1158,548,610
"6245240","Puttalam","Wennappuwa","Waikkala North","482",1154,560,594
"6245245","Puttalam","Wennappuwa","Waikkala South","482A",1275,592,683
"6245250","Puttalam","Wennappuwa","Bolana","480A",1007,490,517
"6245255","Puttalam","Wennappuwa","Thambaravila","480",1016,521,495
"6245260","Puttalam","Wennappuwa","Thopputhota","482B",1010,500,510
"6248005","Puttalam","Dankotuwa","Bothalegama","466C",1357,680,677
"6248010","Puttalam","Dankotuwa","Kirimetiyana East","466",927,423,504
"6248015","Puttalam","Dankotuwa","Thulawala","465",1101,527,574
"6248020","Puttalam","Dankotuwa","Hundirapola","464A",705,337,368
"6248025","Puttalam","Dankotuwa","Pothuwatawana","464",2021,1022,999
"6248030","Puttalam","Dankotuwa","Lihiriyagama","462",972,470,502
"6248035","Puttalam","Dankotuwa","Kahatavila Part","464C",2097,996,1101
"6248040","Puttalam","Dankotuwa","Kahatavila West","464B",1565,753,812
"6248045","Puttalam","Dankotuwa","Meda Kirimetiyana","466A",1366,658,708
"6248050","Puttalam","Dankotuwa","Kirimetiyana North","466D",1505,729,776
"6248055","Puttalam","Dankotuwa","Kirimetiyana West","466F",1136,531,605
"6248060","Puttalam","Dankotuwa","Kirimetiyana South","466E",894,442,452
"6248065","Puttalam","Dankotuwa","Pansal Handiya","466B",1026,507,519
"6248070","Puttalam","Dankotuwa","Haldanduwana North","468",1288,589,699
"6248075","Puttalam","Dankotuwa","Mellawa","463",2206,1057,1149
"6248080","Puttalam","Dankotuwa","Ihala Bujjampola","470A",927,473,454
"6248085","Puttalam","Dankotuwa","Pahala Bujjampola","470",1906,936,970
"6248090","Puttalam","Dankotuwa","Haldanduwana West","468C",2121,989,1132
"6248095","Puttalam","Dankotuwa","Meda Haldanduwana","468B",2965,1467,1498
"6248100","Puttalam","Dankotuwa","Katukenda East","475",1754,883,871
"6248105","Puttalam","Dankotuwa","Meda Katukenda","475B",1322,662,660
"6248110","Puttalam","Dankotuwa","Gonavila North","477",660,291,369
"6248115","Puttalam","Dankotuwa","Meda Gonavila","477B",936,454,482
"6248120","Puttalam","Dankotuwa","Katukenda West","475A",564,269,295
"6248125","Puttalam","Dankotuwa","Dankotuwa West","474C",1373,691,682
"6248130","Puttalam","Dankotuwa","Dankotuwa North","474",706,336,370
"6248135","Puttalam","Dankotuwa","Ihala Dummalakotuwa","474D",896,425,471
"6248140","Puttalam","Dankotuwa","Haldanduwana South","468A",1200,577,623
"6248145","Puttalam","Dankotuwa","Pahala Mohottimulla","469A",1226,588,638
"6248150","Puttalam","Dankotuwa","Ihala Mohottimulla","469",924,444,480
"6248155","Puttalam","Dankotuwa","Sendiriyamulla","461",1208,603,605
"6248160","Puttalam","Dankotuwa","Singakkuliya","460A",1035,489,546
"6248165","Puttalam","Dankotuwa","Kaluwachchimulla","460",1153,582,571
"6248170","Puttalam","Dankotuwa","Motemulla","471B",1471,730,741
"6248175","Puttalam","Dankotuwa","Etiyawala North","471",1281,615,666
"6248180","Puttalam","Dankotuwa","Pahala Dummalakotuwa","474E",1391,655,736
"6248185","Puttalam","Dankotuwa","Dankotuwa East","474B",1712,819,893
"6248190","Puttalam","Dankotuwa","Dankotuwa South","474A",659,314,345
"6248195","Puttalam","Dankotuwa","Gonavila South","477A",1669,778,891
"6248200","Puttalam","Dankotuwa","Godella","473",1725,831,894
"6248205","Puttalam","Dankotuwa","Morukkuliya","473A",2437,1192,1245
"6248210","Puttalam","Dankotuwa","Metikotuwa","472",1848,895,953
"6248215","Puttalam","Dankotuwa","Thamarakuliya","472A",570,281,289
"6248220","Puttalam","Dankotuwa","Etiyawala South","471A",1846,915,931
"6248225","Puttalam","Dankotuwa","Jankurawela","459A",712,359,353
"6248230","Puttalam","Dankotuwa","Yogiyana","459",865,414,451
"6248235","Puttalam","Dankotuwa","Dikwela","458",1171,561,610
"9103005","Ratnapura","Eheliyagoda","Divurumpitiya","137B",3169,1510,1659
"9103010","Ratnapura","Eheliyagoda","Hewainna","139B",1984,984,1000
"9103015","Ratnapura","Eheliyagoda","Kalatuwawa East","139A",1536,738,798
"9103020","Ratnapura","Eheliyagoda","Getahetta","137C",1627,803,824
"9103025","Ratnapura","Eheliyagoda","Walavita","137",1423,687,736
"9103030","Ratnapura","Eheliyagoda","Meennana","137A",3736,1838,1898
"9103035","Ratnapura","Eheliyagoda","Bopetta Didda","137E",2478,1235,1243
"9103040","Ratnapura","Eheliyagoda","Thoranakada","136C",2505,1261,1244
"9103045","Ratnapura","Eheliyagoda","Ganegoda","138B",1305,658,647
"9103050","Ratnapura","Eheliyagoda","Iddamalgoda","138",927,462,465
"9103055","Ratnapura","Eheliyagoda","Huladduwa","138D",683,334,349
"9103060","Ratnapura","Eheliyagoda","Kalatuwawa West","139",1400,685,715
"9103065","Ratnapura","Eheliyagoda","Uduwaka","138C",641,314,327
"9103070","Ratnapura","Eheliyagoda","Napawala","138A",809,404,405
"9103075","Ratnapura","Eheliyagoda","Pelpitiya","136E",1096,549,547
"9103080","Ratnapura","Eheliyagoda","Udumatta","136F",1524,738,786
"9103085","Ratnapura","Eheliyagoda","Vilegoda","136B",1709,843,866
"9103090","Ratnapura","Eheliyagoda","Vilegoda East","137D",1157,582,575
"9103095","Ratnapura","Eheliyagoda","Eheliyagoda Watta","126D",1260,634,626
"9103100","Ratnapura","Eheliyagoda","Asgangula North","126B",1525,746,779
"9103105","Ratnapura","Eheliyagoda","Kendangamuwa Ihalagama","136",2085,980,1105
"9103110","Ratnapura","Eheliyagoda","Moragala","136D",1721,837,884
"9103115","Ratnapura","Eheliyagoda","Bulugahapitiya","141",2868,1414,1454
"9103120","Ratnapura","Eheliyagoda","Yakudagoda","136G",2396,1211,1185
"9103125","Ratnapura","Eheliyagoda","Kendangamuwa","136A",1403,740,663
"9103130","Ratnapura","Eheliyagoda","Asgangula South","126C",899,450,449
"9103135","Ratnapura","Eheliyagoda","Mahara","126",660,341,319
"9103140","Ratnapura","Eheliyagoda","Mahingoda","126A",3105,1511,1594
"9106141","Ratnapura","Kuruvita","Amuhenkanda","146A",2318,1145,1173
"9106142","Ratnapura","Kuruvita","Pathberiya West","127B",2298,1113,1185
"9106143","Ratnapura","Kuruvita","Pathberiya","127",3088,1463,1625
"9106144","Ratnapura","Kuruvita","Parakaduwa","127A",2142,1039,1103
"9103145","Ratnapura","Eheliyagoda","Nakandala","140B",990,487,503
"9106146","Ratnapura","Kuruvita","Bodhimaluwa","146B",2873,1442,1431
"9106147","Ratnapura","Kuruvita","Thalavitiya","146",3480,1653,1827
"9106148","Ratnapura","Kuruvita","Pohorabawa","148",2545,1219,1326
"9106149","Ratnapura","Kuruvita","Miyanadeniya","148A",1798,906,892
"9103150","Ratnapura","Eheliyagoda","Viyalagoda","140A",1305,620,685
"9103155","Ratnapura","Eheliyagoda","Kendangamuwa Pahalagama","140",1795,866,929
"9103160","Ratnapura","Eheliyagoda","Paleegala","141B",1347,655,692
"9103165","Ratnapura","Eheliyagoda","Miyanakolathenna","141C",580,280,300
"9103170","Ratnapura","Eheliyagoda","Mitipola","142B",1430,706,724
"9103175","Ratnapura","Eheliyagoda","Mapota","143C",903,443,460
"9103180","Ratnapura","Eheliyagoda","Karandana North","143",2475,1201,1274
"9103185","Ratnapura","Eheliyagoda","Kiriporuwa","142",1216,587,629
"9103190","Ratnapura","Eheliyagoda","Nedurana","141A",1831,907,924
"9103195","Ratnapura","Eheliyagoda","Erepola","142C",1098,557,541
"9103200","Ratnapura","Eheliyagoda","Sirisamanpura","143E",1266,616,650
"9103205","Ratnapura","Eheliyagoda","Nugadanda","143B",1415,687,728
"9103220","Ratnapura","Eheliyagoda","Hindurangala","142A",2198,1041,1157
"9106020","Ratnapura","Kuruvita","Meneripitiya","127C",3246,1560,1686
"9106045","Ratnapura","Kuruvita","Pussella","158",3552,1747,1805
"9106050","Ratnapura","Kuruvita","Devipahala","160A",2850,1457,1393
"9106055","Ratnapura","Kuruvita","Endiriyanwala","160",1820,929,891
"9106060","Ratnapura","Kuruvita","Erathna","161",1533,800,733
"9106065","Ratnapura","Kuruvita","Adavikanda","161B",937,488,449
"9106070","Ratnapura","Kuruvita","Lassakanda","161C",1800,911,889
"9106075","Ratnapura","Kuruvita","Sudagala","161A",2137,1048,1089
"9106080","Ratnapura","Kuruvita","Ekneligoda North","159B",1495,745,750
"9106085","Ratnapura","Kuruvita","Kiragala","159D",2345,1133,1212
"9106090","Ratnapura","Kuruvita","Kandangoda","157",1918,951,967
"9106095","Ratnapura","Kuruvita","Millavitiya","158A",3740,1865,1875
"9106105","Ratnapura","Kuruvita","Ovitigama","156C",1157,601,556
"9106110","Ratnapura","Kuruvita","Theppanawa","156",2040,1022,1018
"9106115","Ratnapura","Kuruvita","Theppanawa Ihalagama","156A",2480,1207,1273
"9106120","Ratnapura","Kuruvita","Pahala Kuruvita","155C",2593,1298,1295
"9106125","Ratnapura","Kuruvita","Kandangoda South","157A",2330,1182,1148
"9106130","Ratnapura","Kuruvita","Wathuyaya","159",1655,814,841
"9106135","Ratnapura","Kuruvita","Udakada","159A",777,376,401
"9106140","Ratnapura","Kuruvita","Ekneligoda","159C",1722,883,839
"9106145","Ratnapura","Kuruvita","Delgamuwa","155B",2694,1319,1375
"9106150","Ratnapura","Kuruvita","Kuruvita","155",4385,2229,2156
"9106155","Ratnapura","Kuruvita","Walandura","154",2762,1674,1088
"9106160","Ratnapura","Kuruvita","Nadukaradeniya","154B",2165,1018,1147
"9106165","Ratnapura","Kuruvita","Kahengama","154A",4500,2301,2199
"9106170","Ratnapura","Kuruvita","Pathagama","155D",2974,1482,1492
"9106175","Ratnapura","Kuruvita","Theppanawa Pahalagama","156B",1272,588,684
"9106180","Ratnapura","Kuruvita","Kithulpe","155A",3704,1812,1892
"9106185","Ratnapura","Kuruvita","Kahengama West","154D",3700,1812,1888
"9106190","Ratnapura","Kuruvita","Kosgoda","154E",2452,1194,1258
"9106195","Ratnapura","Kuruvita","Galukagama","154C",2369,1182,1187
"9109005","Ratnapura","Kiriella","Ellawala","147",2033,987,1046
"9109010","Ratnapura","Kiriella","Deheragoda","147B",3310,1609,1701
"9109015","Ratnapura","Kiriella","Kanuggalla","147C",739,369,370
"9109020","Ratnapura","Kiriella","Ellawala Pahalagama","147A",2315,1114,1201
"9109025","Ratnapura","Kiriella","Mudunkotuwa","149",1765,885,880
"9109030","Ratnapura","Kiriella","Akurana","149B",1351,635,716
"9109035","Ratnapura","Kiriella","Kiriella","145",1182,582,600
"9109040","Ratnapura","Kiriella","Handukanda","145D",1080,544,536
"9109045","Ratnapura","Kiriella","Epitawala","145A",1577,809,768
"9109050","Ratnapura","Kiriella","Munasinhapura","145C",817,396,421
"9103051","Ratnapura","Eheliyagoda","Karandana South","143A",1821,901,920
"9103052","Ratnapura","Eheliyagoda","Karandana West","143D",1538,752,786
"9109055","Ratnapura","Kiriella","Yatipawwa","144",2491,1200,1291
"9109060","Ratnapura","Kiriella","Ellagawa","144A",1169,578,591
"9109065","Ratnapura","Kiriella","Idangoda","145B",2413,1214,1199
"9109070","Ratnapura","Kiriella","Matuwagala","149A",3386,1679,1707
"9109075","Ratnapura","Kiriella","Dodampe West","150A",3298,1639,1659
"9109080","Ratnapura","Kiriella","Dodampe","150",2723,1385,1338
"9109085","Ratnapura","Kiriella","Holeepitiya","150B",964,463,501
"9112005","Ratnapura","Ratnapura","Gileemale North","162",1656,845,811
"9112010","Ratnapura","Ratnapura","Ketawala","162E",1309,653,656
"9112015","Ratnapura","Ratnapura","Guruluwana","162G",1439,717,722
"9112020","Ratnapura","Ratnapura","Siripagama","162C",1022,504,518
"9112025","Ratnapura","Ratnapura","Sri Palabaddala","162B",1108,536,572
"9112030","Ratnapura","Ratnapura","Mapalana","162H",1095,557,538
"9112035","Ratnapura","Ratnapura","Kudawa","162A",2664,1341,1323
"9112040","Ratnapura","Ratnapura","Dehenakanda","164F",2354,1127,1227
"9112045","Ratnapura","Ratnapura","Bambarabotuwa","164A",2610,1237,1373
"9112050","Ratnapura","Ratnapura","Alupola","165B",1597,773,824
"9112055","Ratnapura","Ratnapura","Balakotunna","164E",1819,928,891
"9112060","Ratnapura","Ratnapura","Hapugasthenna","164G",4793,2286,2507
"9112065","Ratnapura","Ratnapura","Rathgama","162F",1673,842,831
"9112070","Ratnapura","Ratnapura","Gileemale South","163",2156,1107,1049
"9112075","Ratnapura","Ratnapura","Pagoda","163D",1923,958,965
"9112080","Ratnapura","Ratnapura","Embuldeniya","162D",1113,544,569
"9112085","Ratnapura","Ratnapura","Malangama","153B",3070,1542,1528
"9112090","Ratnapura","Ratnapura","Amuthagoda","153C",1908,923,985
"9112095","Ratnapura","Ratnapura","Kahangama","151B",2797,1448,1349
"9112100","Ratnapura","Ratnapura","Ketaliyampalla","151A",2381,1206,1175
"9112105","Ratnapura","Ratnapura","New Town","153A",6689,3288,3401
"9112110","Ratnapura","Ratnapura","Ellegedara","153",979,469,510
"9112115","Ratnapura","Ratnapura","Malwala","163A",2660,1315,1345
"9112120","Ratnapura","Ratnapura","Durekkanda","163E",2996,1473,1523
"9112125","Ratnapura","Ratnapura","Galabada","164D",2084,1008,1076
"9112130","Ratnapura","Ratnapura","Gallella","164",1955,965,990
"9112135","Ratnapura","Ratnapura","Amunuthenna","164C",870,419,451
"9112140","Ratnapura","Ratnapura","Kempanawatta","165D",910,465,445
"9112145","Ratnapura","Ratnapura","Gurubevilagama","164B",2039,1025,1014
"9112150","Ratnapura","Ratnapura","Batewela","165",788,413,375
"9112155","Ratnapura","Ratnapura","Hettikanda","165C",1076,548,528
"9112160","Ratnapura","Ratnapura","Banagoda","165A",1275,663,612
"9112165","Ratnapura","Ratnapura","Heenberenduwa","165E",872,436,436
"9112170","Ratnapura","Ratnapura","Egoda Malwala","163C",1080,516,564
"9112175","Ratnapura","Ratnapura","Meehitiya","163B",2374,1202,1172
"9112180","Ratnapura","Ratnapura","Kospelavinna","153D",4332,2124,2208
"9112185","Ratnapura","Ratnapura","Weralupe","152B",5019,2212,2807
"9112190","Ratnapura","Ratnapura","Dewalegawa","151",2806,1402,1404
"9112195","Ratnapura","Ratnapura","Muwagama","182",3079,1369,1710
"9112200","Ratnapura","Ratnapura","Ratnapura Town West","152F",1106,535,571
"9112205","Ratnapura","Ratnapura","Ratnapura Town North","152E",3353,1603,1750
"9112210","Ratnapura","Ratnapura","Mihindugama","152D",5499,2728,2771
"9112215","Ratnapura","Ratnapura","Mahawala","152C",1502,741,761
"9112220","Ratnapura","Ratnapura","Godigamuwa","152",2792,1420,1372
"9112225","Ratnapura","Ratnapura","Ratnapura Town","152A",1796,950,846
"9112230","Ratnapura","Ratnapura","Mudduwa East","182D",3373,1623,1750
"9112235","Ratnapura","Ratnapura","Samagipura","182C",3015,1482,1533
"9112240","Ratnapura","Ratnapura","Ethoya","182E",1983,972,1011
"9112245","Ratnapura","Ratnapura","Mudduwa","182A",2373,1147,1226
"9112250","Ratnapura","Ratnapura","Batugedara","181",1989,1013,976
"9112255","Ratnapura","Ratnapura","Angammana","181C",2224,1089,1135
"9112260","Ratnapura","Ratnapura","Thiriwanketiya","181B",2512,1235,1277
"9112265","Ratnapura","Ratnapura","Kolandagala","181A",2325,1115,1210
"9115005","Ratnapura","Imbulpe","Rawanakanda","266B",853,425,428
"9115010","Ratnapura","Imbulpe","Gallenakanda","266C",819,413,406
"9115015","Ratnapura","Imbulpe","Kattadikanda","266D",624,303,321
"9115020","Ratnapura","Imbulpe","Waleboda North","266A",579,295,284
"9115025","Ratnapura","Imbulpe","Bellankanda","267B",1018,491,527
"9115030","Ratnapura","Imbulpe","Bolthumbe","267",1258,583,675
"9115035","Ratnapura","Imbulpe","Pinnawala","268A",1527,730,797
"9115040","Ratnapura","Imbulpe","Udagama","268",1298,639,659
"9115045","Ratnapura","Imbulpe","Maddegama","269",3202,1505,1697
"9115050","Ratnapura","Imbulpe","Pidaligannawela","269B",1649,805,844
"9115055","Ratnapura","Imbulpe","Ihalagalagama","278",648,320,328
"9115060","Ratnapura","Imbulpe","Viharawela","278A",475,223,252
"9115065","Ratnapura","Imbulpe","Kumburutheniwela","279A",1080,517,563
"9115070","Ratnapura","Imbulpe","Belihuloya","279",677,351,326
"9115075","Ratnapura","Imbulpe","Yakdehiwela","279B",902,462,440
"9115080","Ratnapura","Imbulpe","Muttettuwegama","276",3416,1380,2036
"9115085","Ratnapura","Imbulpe","Puwakgahawela","276A",1026,498,528
"9115090","Ratnapura","Imbulpe","Budunwela","277A",340,171,169
"9115095","Ratnapura","Imbulpe","Halpe","277",597,296,301
"9115100","Ratnapura","Imbulpe","Nittamaluwa","277B",485,234,251
"9115105","Ratnapura","Imbulpe","Kumbalgama","275A",496,252,244
"9115110","Ratnapura","Imbulpe","Kinchigune","275",462,237,225
"9115115","Ratnapura","Imbulpe","Karagasthalawa","276B",745,360,385
"9115120","Ratnapura","Imbulpe","Seelogama","274",933,471,462
"9115125","Ratnapura","Imbulpe","Imbulpe","272",1099,567,532
"9115130","Ratnapura","Imbulpe","Passaramulla","272A",1170,595,575
"9115135","Ratnapura","Imbulpe","Alakolaella","271",933,462,471
"9115140","Ratnapura","Imbulpe","Atawakwela","271A",1659,813,846
"9115145","Ratnapura","Imbulpe","Kanathiriyanwala","269A",1782,870,912
"9115150","Ratnapura","Imbulpe","Pallewela","267C",992,483,509
"9115155","Ratnapura","Imbulpe","Gurubevila","267A",1149,590,559
"9115160","Ratnapura","Imbulpe","Pandeniya","267D",1165,573,592
"9115165","Ratnapura","Imbulpe","Pagalovita","264C",1022,476,546
"9115170","Ratnapura","Imbulpe","Maddethalawa","264B",1182,578,604
"9115175","Ratnapura","Imbulpe","Amuwathugoda","272B",815,391,424
"9115180","Ratnapura","Imbulpe","Medagedaragoda","272C",859,396,463
"9115185","Ratnapura","Imbulpe","Aluthnuwara","273",1795,875,920
"9115190","Ratnapura","Imbulpe","Thotapalla","273A",1018,518,500
"9115195","Ratnapura","Imbulpe","Ulupitiya","262C",850,432,418
"9115200","Ratnapura","Imbulpe","Mamalgaha","273B",1043,498,545
"9115205","Ratnapura","Imbulpe","Welanhinna","263B",1106,540,566
"9115210","Ratnapura","Imbulpe","Amupitiya","273C",1044,525,519
"9115215","Ratnapura","Imbulpe","Naluwela","263A",1255,596,659
"9115220","Ratnapura","Imbulpe","Wegapitiya","264A",3202,1520,1682
"9115225","Ratnapura","Imbulpe","Morahela","264",1128,551,577
"9115230","Ratnapura","Imbulpe","Oluganthota","264D",3217,1509,1708
"9115235","Ratnapura","Imbulpe","Rathmalavinna","263",1371,646,725
"9115240","Ratnapura","Imbulpe","Karadiyamulla","262A",2060,1021,1039
"9115245","Ratnapura","Imbulpe","Hatharabage","262",1001,489,512
"9115250","Ratnapura","Imbulpe","Thunkinda","262B",451,222,229
"9118005","Ratnapura","Balangoda","Egoda Waleboda","266",1771,883,888
"9118010","Ratnapura","Balangoda","Welekumbura","265A",1637,799,838
"9118015","Ratnapura","Balangoda","Wijanathkumbura","265C",932,477,455
"9118020","Ratnapura","Balangoda","Bulathgama","254F",1154,543,611
"9118025","Ratnapura","Balangoda","Thumbagoda","256C",5512,2617,2895
"9118030","Ratnapura","Balangoda","Kirindigala","256B",4091,1953,2138
"9118035","Ratnapura","Balangoda","Yahalewela","252B",1138,570,568
"9118040","Ratnapura","Balangoda","Batugammana","252A",1018,511,507
"9118045","Ratnapura","Balangoda","Aldora","261A",1368,666,702
"9118050","Ratnapura","Balangoda","Watawala","258D",357,175,182
"9118055","Ratnapura","Balangoda","Mulgama","258A",549,282,267
"9118060","Ratnapura","Balangoda","Thanjanthenna","258C",1483,736,747
"9118065","Ratnapura","Balangoda","Kalthota","258",1036,538,498
"9118070","Ratnapura","Balangoda","Uggalkalthota Left Bank South","259A",779,368,411
"9118075","Ratnapura","Balangoda","Medabedda","258B",729,357,372
"9118080","Ratnapura","Balangoda","Neluyaya","258E",840,417,423
"9118085","Ratnapura","Balangoda","Uggalkalthota Left Bank Left","259",602,299,303
"9118090","Ratnapura","Balangoda","Welipathayaya","260B",1737,883,854
"9118095","Ratnapura","Balangoda","Kuragala","258F",789,387,402
"9118100","Ratnapura","Balangoda","Molamura","260C",799,416,383
"9118105","Ratnapura","Balangoda","Rajawaka","260",632,296,336
"9118110","Ratnapura","Balangoda","Bowatta","261",1210,600,610
"9118115","Ratnapura","Balangoda","Vikiliya","252C",1417,680,737
"9118120","Ratnapura","Balangoda","Thotupalathenna","250A",1495,722,773
"9118125","Ratnapura","Balangoda","Kirimetithenna","250",3985,1930,2055
"9118130","Ratnapura","Balangoda","Dehigasthalawa","250B",4741,2283,2458
"9118135","Ratnapura","Balangoda","Balangoda Town","256A",2136,1085,1051
"9118140","Ratnapura","Balangoda","Balangoda","256",3821,1824,1997
"9118145","Ratnapura","Balangoda","Jahinkanda","254D",1383,675,708
"9118150","Ratnapura","Balangoda","Meddekanda","254A",1295,577,718
"9118155","Ratnapura","Balangoda","Ellewatta","254E",1954,935,1019
"9118160","Ratnapura","Balangoda","Polwathugoda","265B",1799,912,887
"9118165","Ratnapura","Balangoda","Durakanda","265D",1216,601,615
"9118170","Ratnapura","Balangoda","Rassagala","265",2326,1141,1185
"9118175","Ratnapura","Balangoda","Ampitiyawatta","254B",1490,739,751
"9118180","Ratnapura","Balangoda","Massenna","254",897,421,476
"9118185","Ratnapura","Balangoda","Pettigala","254C",2322,1157,1165
"9118190","Ratnapura","Balangoda","Pallekanda","255",910,427,483
"9118195","Ratnapura","Balangoda","Ellepola","255A",1236,557,679
"9118200","Ratnapura","Balangoda","Thalangama","255C",2019,936,1083
"9118205","Ratnapura","Balangoda","Kumara Gama","255B",2026,1009,1017
"9118210","Ratnapura","Balangoda","Damahana","252",1426,682,744
"9118215","Ratnapura","Balangoda","Kongahamankada","260F",1508,766,742
"9118220","Ratnapura","Balangoda","Kalupedigama","260E",922,440,482
"9118225","Ratnapura","Balangoda","Diyavinna","260A",944,467,477
"9118230","Ratnapura","Balangoda","Godakumbura","260D",553,275,278
"9118235","Ratnapura","Balangoda","Imbulamura","253",804,421,383
"9118240","Ratnapura","Balangoda","Mahawalathenna","253A",1036,499,537
"9118245","Ratnapura","Balangoda","Theladiriya","252E",705,342,363
"9118250","Ratnapura","Balangoda","Mawela","251A",1732,878,854
"9118255","Ratnapura","Balangoda","Welage","251",1095,554,541
"9118260","Ratnapura","Balangoda","Gawaranhena","251B",1189,576,613
"9118265","Ratnapura","Balangoda","Horaketiya","266E",1018,470,548
"9121005","Ratnapura","Opanayaka","Polwattahena","244D",1111,563,548
"9121010","Ratnapura","Opanayaka","Metihakwala","244C",1119,548,571
"9121015","Ratnapura","Opanayaka","Malmeekanda","244B",1254,633,621
"9121020","Ratnapura","Opanayaka","Meegahawela","245A",1674,829,845
"9121025","Ratnapura","Opanayaka","Kendaketiya","245B",676,324,352
"9121030","Ratnapura","Opanayaka","Pelendakanda","246B",1378,646,732
"9121035","Ratnapura","Opanayaka","Madola","246",985,463,522
"9121040","Ratnapura","Opanayaka","Udawela","246A",973,466,507
"9121045","Ratnapura","Opanayaka","Opanayaka","245",2477,1190,1287
"9121050","Ratnapura","Opanayaka","Hunuwala North","244",2214,1098,1116
"9121055","Ratnapura","Opanayaka","Hallinna","244A",1842,917,925
"9121060","Ratnapura","Opanayaka","Hunuwala South","243",1259,627,632
"9121065","Ratnapura","Opanayaka","Dandeniya","243A",1256,640,616
"9121070","Ratnapura","Opanayaka","Wallaketiya","246C",1164,581,583
"9121075","Ratnapura","Opanayaka","Akarella","241",2025,1001,1024
"9121080","Ratnapura","Opanayaka","Hattella","242",1224,639,585
"9121085","Ratnapura","Opanayaka","Hattella Egoda","242B",925,433,492
"9121090","Ratnapura","Opanayaka","Batadura","242A",1184,591,593
"9121095","Ratnapura","Opanayaka","Liyanagoda","241A",1219,600,619
"9121100","Ratnapura","Opanayaka","Galkanda","242C",628,298,330
"9124005","Ratnapura","Pelmadulla","Gonakumbura","178A",1241,601,640
"9124010","Ratnapura","Pelmadulla","Bopetta","178",1729,869,860
"9124015","Ratnapura","Pelmadulla","Berenduwa","172B",4016,1997,2019
"9124020","Ratnapura","Pelmadulla","Narangoda","167A",1366,693,673
"9124025","Ratnapura","Pelmadulla","Kuttapitiya","166",2966,1510,1456
"9124030","Ratnapura","Pelmadulla","Ganegama","167",1878,936,942
"9124035","Ratnapura","Pelmadulla","Godagama","171B",2216,1088,1128
"9124040","Ratnapura","Pelmadulla","Dombagasvinna","171C",1950,960,990
"9124045","Ratnapura","Pelmadulla","Sannasgama","171A",2192,1051,1141
"9124050","Ratnapura","Pelmadulla","Dippitigala","172C",1580,768,812
"9124055","Ratnapura","Pelmadulla","Lellopitiya","172",1828,910,918
"9124060","Ratnapura","Pelmadulla","Welimaluwa","172A",3694,1833,1861
"9124065","Ratnapura","Pelmadulla","Gallinna","179C",2427,1171,1256
"9124070","Ratnapura","Pelmadulla","Maudella","179A",2063,1009,1054
"9124075","Ratnapura","Pelmadulla","Marapana","179",3134,1597,1537
"9124080","Ratnapura","Pelmadulla","Pahala Hakamuwa","180",2591,1300,1291
"9124085","Ratnapura","Pelmadulla","Ihala Hakamuwa","180B",1078,512,566
"9124090","Ratnapura","Pelmadulla","Pottakanda","179B",2753,1432,1321
"9124095","Ratnapura","Pelmadulla","Niralgama","180A",2061,1018,1043
"9124100","Ratnapura","Pelmadulla","Alupotha","180C",1266,636,630
"9124105","Ratnapura","Pelmadulla","Dewalegama","171D",2763,1381,1382
"9124110","Ratnapura","Pelmadulla","Denawaka Pathakada","171",3527,1693,1834
"9124115","Ratnapura","Pelmadulla","Rilhena","167C",3015,1544,1471
"9124120","Ratnapura","Pelmadulla","Pahala Bopitiya","167D",1684,841,843
"9124125","Ratnapura","Pelmadulla","Pelmadulla Town","168A",2677,1355,1322
"9124130","Ratnapura","Pelmadulla","Udathula","166A",1887,959,928
"9124135","Ratnapura","Pelmadulla","Warigama","168C",1213,583,630
"9124140","Ratnapura","Pelmadulla","Denawaka Udakada","168",1308,629,679
"9124145","Ratnapura","Pelmadulla","Pelmadullagama","168B",2813,1396,1417
"9124150","Ratnapura","Pelmadulla","Ihala Bopitiya","167B",2099,1025,1074
"9124155","Ratnapura","Pelmadulla","Halpawala","170A",2224,1100,1124
"9124160","Ratnapura","Pelmadulla","Kapuhenthota","170C",3139,1543,1596
"9124165","Ratnapura","Pelmadulla","Panawenna","170",5596,2768,2828
"9124170","Ratnapura","Pelmadulla","Borala","168D",3151,1607,1544
"9124175","Ratnapura","Pelmadulla","Morathota","169",2466,1170,1296
"9124180","Ratnapura","Pelmadulla","Kattange","169A",2763,1346,1417
"9124185","Ratnapura","Pelmadulla","Poronuwa","170B",3115,1520,1595
"9127005","Ratnapura","Elapatha","Kahawatta","189A",1353,676,677
"9127010","Ratnapura","Elapatha","Dambuluwana","189",2035,1007,1028
"9127015","Ratnapura","Elapatha","Raddella","187",1767,894,873
"9127020","Ratnapura","Elapatha","Haldola","187A",2104,1057,1047
"9127025","Ratnapura","Elapatha","Karangoda","186",2241,1142,1099
"9127030","Ratnapura","Elapatha","Samangama","188B",1973,985,988
"9127035","Ratnapura","Elapatha","Kehelovitigama","188A",1847,914,933
"9127040","Ratnapura","Elapatha","Weragama","184A",1615,820,795
"9127045","Ratnapura","Elapatha","Dellabada","188",1300,629,671
"9127050","Ratnapura","Elapatha","Elapatha","185",2611,1328,1283
"9127055","Ratnapura","Elapatha","Pallegedara","185A",2041,1036,1005
"9127060","Ratnapura","Elapatha","Kotamulla","183A",1652,798,854
"9127065","Ratnapura","Elapatha","Amuwala","185B",1617,819,798
"9127070","Ratnapura","Elapatha","Gangulvitiya","183C",2298,1125,1173
"9127075","Ratnapura","Elapatha","Niriella","184",2386,1190,1196
"9127080","Ratnapura","Elapatha","Palawela","184D",1836,921,915
"9127085","Ratnapura","Elapatha","Batakada","184C",1447,710,737
"9127090","Ratnapura","Elapatha","Digana","184B",1337,676,661
"9127095","Ratnapura","Elapatha","Magurugoda","183B",1981,971,1010
"9127100","Ratnapura","Elapatha","Hangamuwa","183",2412,1164,1248
"9130005","Ratnapura","Ayagama","Dumbara","191",2397,1198,1199
"9130010","Ratnapura","Ayagama","Ketepola","191A",1622,828,794
"9130015","Ratnapura","Ayagama","Dethabadakanda","191D",996,508,488
"9130020","Ratnapura","Ayagama","Madabaddara","190B",1800,889,911
"9130025","Ratnapura","Ayagama","Pahala Galathura","190C",1392,713,679
"9130030","Ratnapura","Ayagama","Galathura","190",2331,1180,1151
"9130035","Ratnapura","Ayagama","Sinhalagoda","190A",2091,1097,994
"9130040","Ratnapura","Ayagama","Gangodakanda","193C",1091,552,539
"9130045","Ratnapura","Ayagama","Dumbara Manana","191B",1187,559,628
"9130050","Ratnapura","Ayagama","Gawaragiriya","192",1040,494,546
"9130055","Ratnapura","Ayagama","Pitakanda","193F",1770,908,862
"9130060","Ratnapura","Ayagama","Pallekada","192A",1409,705,704
"9130065","Ratnapura","Ayagama","Ellahena","193E",865,426,439
"9130070","Ratnapura","Ayagama","Vithanagama","193B",1123,560,563
"9130075","Ratnapura","Ayagama","Ayagama","193",2031,997,1034
"9130080","Ratnapura","Ayagama","Udugala North","193D",1089,542,547
"9130085","Ratnapura","Ayagama","Kolambewa","191C",794,393,401
"9130090","Ratnapura","Ayagama","Udugala","193A",2044,1049,995
"9130095","Ratnapura","Ayagama","Paragala","194",1260,623,637
"9130100","Ratnapura","Ayagama","Pimbura","194A",1442,734,708
"9130105","Ratnapura","Ayagama","Nikagoda","194B",1120,545,575
"9133005","Ratnapura","Kalawana","Kodippilikanda","195E",2151,1099,1052
"9133010","Ratnapura","Kalawana","Jathuwangoda","195F",1217,615,602
"9133015","Ratnapura","Kalawana","Meepagama","195C",1422,692,730
"9133020","Ratnapura","Kalawana","Kukulegama North","195",2107,1026,1081
"9133025","Ratnapura","Kalawana","Samanpura","196B",2026,1016,1010
"9133030","Ratnapura","Kalawana","Kalawana West","196",2093,1041,1052
"9133035","Ratnapura","Kalawana","Thapassarakanda","196C",2498,1184,1314
"9133040","Ratnapura","Kalawana","Koswatta","197B",1785,860,925
"9133045","Ratnapura","Kalawana","Kukulegama South","195B",1123,533,590
"9133050","Ratnapura","Kalawana","Pitigalakanda","195D",1179,568,611
"9133055","Ratnapura","Kalawana","Wewagama","195A",794,407,387
"9133060","Ratnapura","Kalawana","Davugalagama","196F",1839,940,899
"9133065","Ratnapura","Kalawana","Wembiyagoda","197C",1295,662,633
"9133070","Ratnapura","Kalawana","Kalawana East","196E",1663,839,824
"9133075","Ratnapura","Kalawana","Wewelkandura","196A",2863,1413,1450
"9133080","Ratnapura","Kalawana","Hangarangala","196D",1962,983,979
"9133085","Ratnapura","Kalawana","Wathurawa","197A",1493,755,738
"9133090","Ratnapura","Kalawana","Delgoda East","197D",1565,770,795
"9133095","Ratnapura","Kalawana","Delgoda West","197",1284,660,624
"9133100","Ratnapura","Kalawana","Weddagala West","198C",901,449,452
"9133105","Ratnapura","Kalawana","Weddagala East","198",1116,569,547
"9133110","Ratnapura","Kalawana","Kudumeeriya","198D",1181,605,576
"9133115","Ratnapura","Kalawana","Thanabela","201A",1408,717,691
"9133120","Ratnapura","Kalawana","Rambuka","201",2132,1075,1057
"9133125","Ratnapura","Kalawana","Dolekanda","201C",1349,635,714
"9133130","Ratnapura","Kalawana","Kathlana","201B",2582,1297,1285
"9133135","Ratnapura","Kalawana","Gangalagamuwa","198A",1502,722,780
"9133140","Ratnapura","Kalawana","Panapola","199",1146,595,551
"9133145","Ratnapura","Kalawana","Kudawa","198B",818,430,388
"9133150","Ratnapura","Kalawana","Hapugoda","199A",1364,676,688
"9133155","Ratnapura","Kalawana","Pothupitiya North","200",1441,743,698
"9133160","Ratnapura","Kalawana","Pothupitiya South","200B",890,465,425
"9133165","Ratnapura","Kalawana","Ilumbakanda","200A",1118,566,552
"9136005","Ratnapura","Nivithigala","Pathakada","174E",2295,1135,1160
"9136010","Ratnapura","Nivithigala","Noragalla","175",3437,1707,1730
"9136015","Ratnapura","Nivithigala","Dombagammana","175C",2699,1343,1356
"9136020","Ratnapura","Nivithigala","Erabadda","175D",1937,975,962
"9136025","Ratnapura","Nivithigala","Kiribathgala","175A",1790,935,855
"9136030","Ratnapura","Nivithigala","Wanniyawatta","175B",1852,889,963
"9136035","Ratnapura","Nivithigala","Watapotha","176A",1587,793,794
"9136040","Ratnapura","Nivithigala","Thuttiripitiya","174C",1827,921,906
"9136045","Ratnapura","Nivithigala","Nivithigala","174",2913,1433,1480
"9136050","Ratnapura","Nivithigala","Yakdehiwatta","174A",2880,1385,1495
"9136055","Ratnapura","Nivithigala","Wathupitiya","173A",2384,1192,1192
"9136060","Ratnapura","Nivithigala","Horangala","173C",2066,1048,1018
"9136065","Ratnapura","Nivithigala","Pahala Karavita","173",3863,1950,1913
"9136070","Ratnapura","Nivithigala","Uda Karavita","173B",2975,1465,1510
"9136075","Ratnapura","Nivithigala","Pinkanda","174D",2349,1179,1170
"9136080","Ratnapura","Nivithigala","Halkandaliya","176D",2156,1087,1069
"9136085","Ratnapura","Nivithigala","Sidurupitiya","174B",1945,980,965
"9136090","Ratnapura","Nivithigala","Doloswala","176",1686,848,838
"9136095","Ratnapura","Nivithigala","Kolombugama","176C",4486,2231,2255
"9136100","Ratnapura","Nivithigala","Doloswalakanda","176B",3340,1646,1694
"9136105","Ratnapura","Nivithigala","Pebotuwa","177A",1740,876,864
"9136110","Ratnapura","Nivithigala","Horanekarakanda","177C",2447,1239,1208
"9136115","Ratnapura","Nivithigala","Delwala","177",5015,2445,2570
"9136120","Ratnapura","Nivithigala","Panahetagala","177B",461,242,219
"9139005","Ratnapura","Kahawatta","Yainna","229",3815,1912,1903
"9139010","Ratnapura","Kahawatta","Nugawela West","230B",2276,1097,1179
"9139015","Ratnapura","Kahawatta","Nugawela East","230",1231,627,604
"9139020","Ratnapura","Kahawatta","Weladura","230A",3769,1831,1938
"9139025","Ratnapura","Kahawatta","Bungiriya","230C",1414,695,719
"9139030","Ratnapura","Kahawatta","Uda Hawpe","229A",3409,1663,1746
"9139035","Ratnapura","Kahawatta","Yatagare","227A",1632,765,867
"9139040","Ratnapura","Kahawatta","Madalagama Colony","227C",2032,1002,1030
"9139045","Ratnapura","Kahawatta","Panapitiya North","226A",1551,784,767
"9139050","Ratnapura","Kahawatta","Nambuluwa","228A",2475,1232,1243
"9139055","Ratnapura","Kahawatta","Atakalanpanna","225",2583,1267,1316
"9139060","Ratnapura","Kahawatta","Pahamunupanna","225A",829,389,440
"9139065","Ratnapura","Kahawatta","Kalalella","228",3097,1514,1583
"9139070","Ratnapura","Kahawatta","Panapitiya South","226D",1396,670,726
"9139075","Ratnapura","Kahawatta","Gabbela","226E",1832,903,929
"9139080","Ratnapura","Kahawatta","Endana","227B",3145,1547,1598
"9139085","Ratnapura","Kahawatta","Madalagama","227",1120,590,530
"9139090","Ratnapura","Kahawatta","Miyanavita West","226F",2286,1112,1174
"9139095","Ratnapura","Kahawatta","Miyanavita East","226B",1050,539,511
"9139100","Ratnapura","Kahawatta","Kiranodagama","226C",1836,874,962
"9139105","Ratnapura","Kahawatta","Pannila","226",520,276,244
"9142005","Ratnapura","Godakawela","Kotakethana","232A",3370,1644,1726
"9142010","Ratnapura","Godakawela","Dimbulwala","232B",2209,1117,1092
"9142015","Ratnapura","Godakawela","Hapurudeniya","232",2106,915,1191
"9142020","Ratnapura","Godakawela","Panawala","235A",1072,505,567
"9142025","Ratnapura","Godakawela","Buluwana","233C",1359,667,692
"9142030","Ratnapura","Godakawela","Makandura","233A",1331,681,650
"9142035","Ratnapura","Godakawela","Ematiyagoda","233B",897,466,431
"9142040","Ratnapura","Godakawela","Ridivita","233",1602,809,793
"9142045","Ratnapura","Godakawela","Maragala","234C",930,471,459
"9142050","Ratnapura","Godakawela","Hiramadagama","235",1306,641,665
"9142055","Ratnapura","Godakawela","Madampe North","238",3352,1656,1696
"9142060","Ratnapura","Godakawela","Kavuduwawa","238B",1548,750,798
"9142065","Ratnapura","Godakawela","Madampe South","238A",1904,941,963
"9142070","Ratnapura","Godakawela","Horamula","238C",2020,1002,1018
"9142075","Ratnapura","Godakawela","Weralugahamula","231A",1118,534,584
"9142080","Ratnapura","Godakawela","Alpitiya","234B",1398,661,737
"9142085","Ratnapura","Godakawela","Galahitiya","234",1973,989,984
"9142090","Ratnapura","Godakawela","Kompitiya","234A",1184,580,604
"9142095","Ratnapura","Godakawela","Malwatta","237C",1901,900,1001
"9142100","Ratnapura","Godakawela","Werahera West","234E",1015,490,525
"9142105","Ratnapura","Godakawela","Werahera East","234D",695,325,370
"9142110","Ratnapura","Godakawela","Godakawela","237A",956,495,461
"9142115","Ratnapura","Godakawela","Warayaya","236A",1455,719,736
"9142120","Ratnapura","Godakawela","Niyangama","236",1665,807,858
"9142125","Ratnapura","Godakawela","Bambaragasthenna","236B",2001,979,1022
"9142130","Ratnapura","Godakawela","Balavinna North","223E",1038,518,520
"9142135","Ratnapura","Godakawela","Balavinna West","223D",2123,1019,1104
"9142140","Ratnapura","Godakawela","Kapuhenthenna","223G",737,369,368
"9142145","Ratnapura","Godakawela","Mawathalanda","223B",1386,687,699
"9142150","Ratnapura","Godakawela","Meddegama","237D",1105,529,576
"9142155","Ratnapura","Godakawela","Masimbula","237",4184,2027,2157
"9142160","Ratnapura","Godakawela","Rakwana Town","231B",1920,907,1013
"9142165","Ratnapura","Godakawela","Kottala","231D",4171,1984,2187
"9142170","Ratnapura","Godakawela","Rakwana South","231C",2509,1234,1275
"9142175","Ratnapura","Godakawela","Rakwana North","231",3136,1462,1674
"9142180","Ratnapura","Godakawela","Yahalawela","237B",2542,1256,1286
"9142185","Ratnapura","Godakawela","Bibilegama West","223C",2200,1088,1112
"9142190","Ratnapura","Godakawela","Bibilegama East","223",1465,735,730
"9142195","Ratnapura","Godakawela","Thambagamuwa West","222B",1482,711,771
"9142200","Ratnapura","Godakawela","Dambavinna","223F",1046,531,515
"9142205","Ratnapura","Godakawela","Balavinna East","223A",2234,1107,1127
"9142210","Ratnapura","Godakawela","Thambagamuwa East","222",1055,503,552
"9142215","Ratnapura","Godakawela","Mahagama West","222C",1133,552,581
"9142220","Ratnapura","Godakawela","Mahagama East","222A",636,333,303
"9145005","Ratnapura","Weligepola","Paragahamaditta","240C",998,503,495
"9145010","Ratnapura","Weligepola","Ilukkumbura","240A",1067,548,519
"9145015","Ratnapura","Weligepola","Panana","240",864,430,434
"9145020","Ratnapura","Weligepola","Galgodagama","240B",1087,512,575
"9145025","Ratnapura","Weligepola","Kongasthenna","239A",753,355,398
"9145030","Ratnapura","Weligepola","Bopitigoda","239C",965,467,498
"9145035","Ratnapura","Weligepola","Gangodagama","239B",955,479,476
"9145040","Ratnapura","Weligepola","Medaganoya","221A",517,282,235
"9145045","Ratnapura","Weligepola","Udaranwala","221C",1421,691,730
"9145050","Ratnapura","Weligepola","Weligepola","239",1193,596,597
"9145055","Ratnapura","Weligepola","Udagangoda","247A",1106,549,557
"9145060","Ratnapura","Weligepola","Belimaliyadda","247",814,408,406
"9145065","Ratnapura","Weligepola","Handagiriya","249",522,285,237
"9145070","Ratnapura","Weligepola","Handagirigoda","249A",858,461,397
"9145075","Ratnapura","Weligepola","Palugahawela","248A",947,475,472
"9145080","Ratnapura","Weligepola","Urawala","248",1167,565,602
"9145085","Ratnapura","Weligepola","Kottimbulwala","219E",815,419,396
"9145090","Ratnapura","Weligepola","Thalagaskanda","220D",1082,533,549
"9145095","Ratnapura","Weligepola","Ranwala","221",1027,504,523
"9145100","Ratnapura","Weligepola","Ammaduwa","221B",1137,537,600
"9145105","Ratnapura","Weligepola","Elamalpe","220A",863,423,440
"9145110","Ratnapura","Weligepola","Thennahena","220C",1032,493,539
"9145115","Ratnapura","Weligepola","Kalatuwakanda","220B",709,356,353
"9145120","Ratnapura","Weligepola","Badullegama","220",1098,518,580
"9145125","Ratnapura","Weligepola","Hatangala","219A",1510,761,749
"9145130","Ratnapura","Weligepola","Bambaragala","219D",1500,772,728
"9145135","Ratnapura","Weligepola","Pussathota","219F",1183,577,606
"9145140","Ratnapura","Weligepola","Madawalalanda","219C",856,427,429
"9145145","Ratnapura","Weligepola","Galpaya","219B",2139,1109,1030
"9145150","Ratnapura","Weligepola","Muttettupola","219",798,388,410
"9148005","Ratnapura","Embilipitiya","Pallebedda","224",2183,1015,1168
"9148010","Ratnapura","Embilipitiya","Thittawelpotha","224D",1861,873,988
"9148015","Ratnapura","Embilipitiya","Panahaduwa","224G",2134,1064,1070
"9148020","Ratnapura","Embilipitiya","Udawalawa","224E",2940,1430,1510
"9148025","Ratnapura","Embilipitiya","Thimbolketiya","224A",2540,1208,1332
"9148030","Ratnapura","Embilipitiya","Kolambage Ara","224C",3574,1758,1816
"9148035","Ratnapura","Embilipitiya","Sankhapala","224F",3167,1524,1643
"9148040","Ratnapura","Embilipitiya","Miriswelpatha","208A",1721,866,855
"9148045","Ratnapura","Embilipitiya","Adaluwa","208F",2536,1208,1328
"9148050","Ratnapura","Embilipitiya","Maduwanwela","207",3907,1900,2007
"9148055","Ratnapura","Embilipitiya","Udawalawa Track 02","207D",3138,1527,1611
"9148060","Ratnapura","Embilipitiya","Rathkarawwa","224B",5169,2509,2660
"9148065","Ratnapura","Embilipitiya","Gangeyaya","207A",3178,1589,1589
"9148070","Ratnapura","Embilipitiya","Ketagal Ara","214E",3255,1623,1632
"9148075","Ratnapura","Embilipitiya","Nindagam Pelessa","207C",2186,1077,1109
"9148080","Ratnapura","Embilipitiya","Ranchamadama","207B",2435,1235,1200
"9148085","Ratnapura","Embilipitiya","Panamura","213B",5085,2518,2567
"9148090","Ratnapura","Embilipitiya","Konkatuwa","213D",3126,1583,1543
"9148095","Ratnapura","Embilipitiya","Embilipitiya Udagama","214",2562,1263,1299
"9148100","Ratnapura","Embilipitiya","Hingura Ara","214D",3442,1728,1714
"9148105","Ratnapura","Embilipitiya","Kalagedi Ara","214I",4387,2148,2239
"9148110","Ratnapura","Embilipitiya","Moraketiya","214C",4196,2088,2108
"9148115","Ratnapura","Embilipitiya","Embilipitiya Pallegama","214A",5655,2820,2835
"9148120","Ratnapura","Embilipitiya","Embilipitiya New Town","214G",5232,2580,2652
"9148125","Ratnapura","Embilipitiya","Yodhagama","214H",5657,2745,2912
"9148130","Ratnapura","Embilipitiya","Modarawana","214F",2726,1318,1408
"9148135","Ratnapura","Embilipitiya","Sudugala","212A",2407,1179,1228
"9148140","Ratnapura","Embilipitiya","Walalgoda","213",2496,1240,1256
"9148145","Ratnapura","Embilipitiya","Jadura","212B",2490,1259,1231
"9148150","Ratnapura","Embilipitiya","Diyapota","212",2277,1123,1154
"9148155","Ratnapura","Embilipitiya","Mulendiyawala","213A",2394,1147,1247
"9148160","Ratnapura","Embilipitiya","Thorakolayaya","213C",2683,1307,1376
"9148165","Ratnapura","Embilipitiya","Kumbugoda Ara","214B",4051,2003,2048
"9148170","Ratnapura","Embilipitiya","Hingura","215",4632,2383,2249
"9148175","Ratnapura","Embilipitiya","Halmillaketiya","216B",2855,1399,1456
"9148180","Ratnapura","Embilipitiya","Thunkama","216",5499,2719,2780
"9148185","Ratnapura","Embilipitiya","Hagala","216A",4236,2091,2145
"9148190","Ratnapura","Embilipitiya","Kuttigala","215B",4247,2083,2164
"9148195","Ratnapura","Embilipitiya","Julangete","215C",2283,1121,1162
"9148200","Ratnapura","Embilipitiya","Padalangala","215A",4171,2013,2158
"9151005","Ratnapura","Kolonna","Buluthota","202",2305,1092,1213
"9151010","Ratnapura","Kolonna","Ranhotikanda","202A",2118,1071,1047
"9151015","Ratnapura","Kolonna","Yakmaditta","204A",785,390,395
"9151020","Ratnapura","Kolonna","Helaudakanda","208D",1012,489,523
"9151025","Ratnapura","Kolonna","Heneggegoda","208C",817,409,408
"9151030","Ratnapura","Kolonna","Kumburugamuwa","208",1316,672,644
"9151035","Ratnapura","Kolonna","Dambemada","208B",619,322,297
"9151040","Ratnapura","Kolonna","Welewathugoda","208E",455,245,210
"9151045","Ratnapura","Kolonna","Ereporuwa","204",1975,1001,974
"9151050","Ratnapura","Kolonna","Wijeriya","203",1666,773,893
"9151055","Ratnapura","Kolonna","Poddana","203B",2508,1252,1256
"9151060","Ratnapura","Kolonna","Ittakanda","203A",1835,936,899
"9151065","Ratnapura","Kolonna","Buthkanda","205A",1942,988,954
"9151070","Ratnapura","Kolonna","Kolonna","205",3057,1537,1520
"9151075","Ratnapura","Kolonna","Maduwanwela Peranigama","205B",2909,1414,1495
"9151080","Ratnapura","Kolonna","Nandanagama","205C",1552,802,750
"9151085","Ratnapura","Kolonna","Ambagahayaya","206B",1482,736,746
"9151090","Ratnapura","Kolonna","Kella","206",1278,639,639
"9151095","Ratnapura","Kolonna","Boraluwageaina","206A",2368,1158,1210
"9151100","Ratnapura","Kolonna","Ullinduwawa","209",2830,1350,1480
"9151105","Ratnapura","Kolonna","Pupulaketiya","206C",1221,608,613
"9151110","Ratnapura","Kolonna","Habbeliara","206D",1393,695,698
"9151115","Ratnapura","Kolonna","Walakada","217B",682,335,347
"9151120","Ratnapura","Kolonna","Koppakanda","210A",1170,589,581
"9151125","Ratnapura","Kolonna","Dapane","210",1601,777,824
"9151130","Ratnapura","Kolonna","Dorapane","211",1030,501,529
"9151135","Ratnapura","Kolonna","Morawadiya","211A",769,400,369
"9151140","Ratnapura","Kolonna","Omalpe","217",1536,773,763
"9151145","Ratnapura","Kolonna","Kempane","217A",1723,843,880
"9203005","Kegalle","Rambukkana","Dombemada East","01B",520,240,280
"9203010","Kegalle","Rambukkana","Dombemada West","01A",405,176,229
"9203015","Kegalle","Rambukkana","Udanvita","01",557,273,284
"9203020","Kegalle","Rambukkana","Maligathenna","03J",646,301,345
"9203025","Kegalle","Rambukkana","Alugolla","03C",511,244,267
"9203030","Kegalle","Rambukkana","Gabbala North","03H",1092,528,564
"9203035","Kegalle","Rambukkana","Gabbala South","03A",1049,480,569
"9203040","Kegalle","Rambukkana","Mahagama","03K",851,377,474
"9203045","Kegalle","Rambukkana","Halwatta","3L",440,195,245
"9203050","Kegalle","Rambukkana","Hewadiwela","03D",894,452,442
"9203055","Kegalle","Rambukkana","Nattambura","03",725,324,401
"9203060","Kegalle","Rambukkana","Kudagama North","02A",626,286,340
"9203065","Kegalle","Rambukkana","Kudagama South","02D",568,278,290
"9203070","Kegalle","Rambukkana","Medagaladeniya","02B",496,220,276
"9203075","Kegalle","Rambukkana","Walgama","04",859,381,478
"9203080","Kegalle","Rambukkana","Udagaladeniya","02",458,201,257
"9203085","Kegalle","Rambukkana","Dambulla","02C",466,218,248
"9203090","Kegalle","Rambukkana","Deliwala","05",1304,603,701
"9203095","Kegalle","Rambukkana","Hangawela","06C",486,229,257
"9203100","Kegalle","Rambukkana","Ihala Walpola","06B",577,274,303
"9203105","Kegalle","Rambukkana","Kotawella","03G",1223,561,662
"9203110","Kegalle","Rambukkana","Kanugolla","03I",873,408,465
"9203115","Kegalle","Rambukkana","Parape North","03B",656,322,334
"9203120","Kegalle","Rambukkana","Parape South","03F",983,433,550
"9203125","Kegalle","Rambukkana","Kossinna","07C",683,310,373
"9203130","Kegalle","Rambukkana","Kansalagamuwa","07B",1113,489,624
"9203135","Kegalle","Rambukkana","Heenabowa","07",687,327,360
"9203140","Kegalle","Rambukkana","Walalgoda","07A",952,448,504
"9203145","Kegalle","Rambukkana","Kiriwallapitiya","08F",674,328,346
"9203150","Kegalle","Rambukkana","Eriyagolla","08G",1071,549,522
"9203155","Kegalle","Rambukkana","Werellapatha","08C",607,295,312
"9203160","Kegalle","Rambukkana","Weligamuwa","06",809,356,453
"9203165","Kegalle","Rambukkana","Thaldewa","06A",1077,545,532
"9203170","Kegalle","Rambukkana","Wahawa","06D",1381,667,714
"9203175","Kegalle","Rambukkana","Padavigampala","05A",1373,669,704
"9203180","Kegalle","Rambukkana","Puwakmote","04A",750,354,396
"9203185","Kegalle","Rambukkana","Udugama","04C",568,286,282
"9203190","Kegalle","Rambukkana","Thismalpola","04B",601,284,317
"9203195","Kegalle","Rambukkana","Yatagama","04D",726,351,375
"9203200","Kegalle","Rambukkana","Meeduma","04E",942,446,496
"9203205","Kegalle","Rambukkana","Hurimaluwa","08B",2678,1279,1399
"9203210","Kegalle","Rambukkana","Eriyawa","08D",1224,562,662
"9203215","Kegalle","Rambukkana","Rambukkana Town","08H",896,494,402
"9203220","Kegalle","Rambukkana","Diyasunnatha","08A",750,359,391
"9203225","Kegalle","Rambukkana","Madawala","08I",865,401,464
"9203230","Kegalle","Rambukkana","Godagandeniya","08",751,346,405
"9203235","Kegalle","Rambukkana","Kempitiya","21D",287,142,145
"9203240","Kegalle","Rambukkana","Kadigamuwa","21",1573,721,852
"9203245","Kegalle","Rambukkana","Halagiriya","21A",790,369,421
"9203250","Kegalle","Rambukkana","Muwapitiya","09C",748,329,419
"9203255","Kegalle","Rambukkana","Beligodapitiya","08E",534,252,282
"9203260","Kegalle","Rambukkana","Pinnawala","10",1256,602,654
"9203265","Kegalle","Rambukkana","Daluggala","08J",427,191,236
"9203270","Kegalle","Rambukkana","Mottappuliya","08K",1465,703,762
"9203275","Kegalle","Rambukkana","Koorempola","10B",1436,683,753
"9203280","Kegalle","Rambukkana","Halpitiya","11A",839,390,449
"9203285","Kegalle","Rambukkana","Naranbedda East","11D",650,306,344
"9203290","Kegalle","Rambukkana","Naranbedda West","11C",708,324,384
"9203295","Kegalle","Rambukkana","Marukwathura","75D",1565,715,850
"9203300","Kegalle","Rambukkana","Imbulgasdeniya","75C",2502,1184,1318
"9203305","Kegalle","Rambukkana","Ambuwangala","75B",787,343,444
"9203310","Kegalle","Rambukkana","Kehelwathugoda","75A",1791,833,958
"9203315","Kegalle","Rambukkana","Dunukewala","11B",1296,594,702
"9203320","Kegalle","Rambukkana","Waduwadeniya","11G",558,258,300
"9203325","Kegalle","Rambukkana","Hiriwadunna","11E",1321,600,721
"9203330","Kegalle","Rambukkana","Bathambure","10A",1063,498,565
"9203335","Kegalle","Rambukkana","Kottana Watta","09D",807,373,434
"9203340","Kegalle","Rambukkana","Kotagama","09A",1095,519,576
"9203345","Kegalle","Rambukkana","Kiriwandeniya","09",1115,529,586
"9203350","Kegalle","Rambukkana","Netiyapana","21C",518,236,282
"9203355","Kegalle","Rambukkana","Udugama Gondewala","21B",1048,476,572
"9203360","Kegalle","Rambukkana","Pattampitiya","22C",612,281,331
"9203365","Kegalle","Rambukkana","Yatiwaldeniya","22B",852,373,479
"9203370","Kegalle","Rambukkana","Henepola","22E",1160,551,609
"9203375","Kegalle","Rambukkana","Deegana Kanda","22D",853,395,458
"9203380","Kegalle","Rambukkana","Gangoda","22A",1175,578,597
"9203385","Kegalle","Rambukkana","Beddawala","22",661,298,363
"9203390","Kegalle","Rambukkana","Yodhagama","09B",1421,706,715
"9203395","Kegalle","Rambukkana","Pitiyegama","11",870,400,470
"9203400","Kegalle","Rambukkana","Deldeniya","11F",800,385,415
"9203405","Kegalle","Rambukkana","Kivulpana","12A",899,419,480
"9203410","Kegalle","Rambukkana","Minwana","12C",623,304,319
"9203415","Kegalle","Rambukkana","Kumbaldiwela","13E",1084,514,570
"9203420","Kegalle","Rambukkana","Galpala","13",650,301,349
"9203425","Kegalle","Rambukkana","Kumbaloluwa","13C",1260,585,675
"9203430","Kegalle","Rambukkana","Kavudaulla","13D",911,439,472
"9203435","Kegalle","Rambukkana","Molagoda","13B",1796,828,968
"9203440","Kegalle","Rambukkana","Waragoda","13F",953,466,487
"9203445","Kegalle","Rambukkana","Mangalagama","13A",1567,787,780
"9206005","Kegalle","Mawanella","Weganthale","20",1477,709,768
"9206010","Kegalle","Mawanella","Yatimahana","23C",960,468,492
"9206015","Kegalle","Mawanella","Keppetipola","23B",1890,897,993
"9206020","Kegalle","Mawanella","Ihala Kotte","23A",917,447,470
"9206025","Kegalle","Mawanella","Makehelwala","23",1499,695,804
"9206030","Kegalle","Mawanella","Dunugama Maliyadda","24B",1869,913,956
"9206035","Kegalle","Mawanella","Karapane","24A",963,451,512
"9206040","Kegalle","Mawanella","Kondeniya","20B",1433,683,750
"9206045","Kegalle","Mawanella","Gondiwala","20A",2420,1134,1286
"9206050","Kegalle","Mawanella","Uthuwankanda","19C",1693,797,896
"9206055","Kegalle","Mawanella","Ambulugala","15",2057,959,1098
"9206060","Kegalle","Mawanella","Attanagoda","15B",1351,633,718
"9206065","Kegalle","Mawanella","Panagamuwa","15G",810,371,439
"9206070","Kegalle","Mawanella","Dehimaduwa","15E",1872,879,993
"9206075","Kegalle","Mawanella","Habbunkaduwa","19D",1828,872,956
"9206080","Kegalle","Mawanella","Mahawatta","29A",3633,1776,1857
"9206085","Kegalle","Mawanella","Muruthawala","29D",3876,1869,2007
"9206090","Kegalle","Mawanella","Randiwala","24",1485,672,813
"9206095","Kegalle","Mawanella","Uda Makadawara","25B",1307,640,667
"9206100","Kegalle","Mawanella","Ganethenna","25A",1457,704,753
"9206105","Kegalle","Mawanella","Makadawara","25",1580,743,837
"9206110","Kegalle","Mawanella","Batawala","27A",2154,1011,1143
"9206115","Kegalle","Mawanella","Hingula","29",2521,1199,1322
"9206120","Kegalle","Mawanella","Owatta","29B",1412,657,755
"9206125","Kegalle","Mawanella","Hinguloya","29C",4833,2180,2653
"9206130","Kegalle","Mawanella","Rankothdiwala","19",1537,720,817
"9206135","Kegalle","Mawanella","Mawanella","19B",1293,639,654
"9206140","Kegalle","Mawanella","Mawana","30A",1096,515,581
"9206145","Kegalle","Mawanella","Kiringadeniya","30",3008,1380,1628
"9206150","Kegalle","Mawanella","Weligalla","19A",1286,646,640
"9206155","Kegalle","Mawanella","Dodanthale","18C",1276,612,664
"9206160","Kegalle","Mawanella","Kappagoda","18A",2960,1380,1580
"9206165","Kegalle","Mawanella","Nankurugama","31B",1760,829,931
"9206170","Kegalle","Mawanella","Kongamuwa","31A",3258,1591,1667
"9206175","Kegalle","Mawanella","Beligammana","29E",1829,853,976
"9206180","Kegalle","Mawanella","Edanduwawa","31",729,333,396
"9206185","Kegalle","Mawanella","Idampitiya","28",1338,623,715
"9206190","Kegalle","Mawanella","Kekirigoda","28A",1814,840,974
"9206195","Kegalle","Mawanella","Uyanwatta","30B",2607,1177,1430
"9206200","Kegalle","Mawanella","Aluthnuwara","27",1584,750,834
"9206205","Kegalle","Mawanella","Molligoda","25C",1287,648,639
"9206210","Kegalle","Mawanella","Mawela","25D",1938,925,1013
"9206215","Kegalle","Mawanella","Warakapana","26A",901,437,464
"9206220","Kegalle","Mawanella","Kahawandala","26",954,444,510
"9206225","Kegalle","Mawanella","Mahanthegama","26C",1101,540,561
"9206230","Kegalle","Mawanella","Heenatipana","26B",1415,672,743
"9206235","Kegalle","Mawanella","Rukulagama","27B",1782,835,947
"9206240","Kegalle","Mawanella","Daswatta","18B",1129,540,589
"9206245","Kegalle","Mawanella","Lewke","18",1220,614,606
"9206250","Kegalle","Mawanella","Kumbalgama","35",836,394,442
"9206255","Kegalle","Mawanella","Balawathgama","35A",902,411,491
"9206260","Kegalle","Mawanella","Werake","34",1923,899,1024
"9206265","Kegalle","Mawanella","Embilmeewala","34A",537,248,289
"9206270","Kegalle","Mawanella","Thambavita","36A",1078,487,591
"9206275","Kegalle","Mawanella","Eraminigammana","36",1176,556,620
"9206280","Kegalle","Mawanella","Ambadeniya","37B",1013,495,518
"9206285","Kegalle","Mawanella","Weragoda","37C",546,259,287
"9206290","Kegalle","Mawanella","Kooragala","37",602,276,326
"9206295","Kegalle","Mawanella","Waduwawala","37A",1338,639,699
"9206300","Kegalle","Mawanella","Ginihappitiya West","36C",1429,625,804
"9206305","Kegalle","Mawanella","Ginihappitiya East","36B",1889,888,1001
"9206310","Kegalle","Mawanella","Ambaruppa","39C",1000,450,550
"9206315","Kegalle","Mawanella","Madulbowa","39B",1373,636,737
"9206320","Kegalle","Mawanella","Ambalawa","40C",1021,507,514
"9206325","Kegalle","Mawanella","Balathgamuwa","40B",533,255,278
"9206330","Kegalle","Mawanella","Kehelpannala East","40",740,357,383
"9206335","Kegalle","Mawanella","Wadiyathenna","39A",1990,935,1055
"9206340","Kegalle","Mawanella","Hemmathagama","38A",1012,470,542
"9206345","Kegalle","Mawanella","Palliporuwa","38",1599,747,852
"9206350","Kegalle","Mawanella","Dumbuluwawa","39",2200,958,1242
"9206355","Kegalle","Mawanella","Kehelpannala West","40A",591,271,320
"9209005","Kegalle","Aranayaka","Deewela Udagama","16A",1181,536,645
"9209010","Kegalle","Aranayaka","Wakirigala","16",1188,543,645
"9209015","Kegalle","Aranayaka","Epalawa Watta","15F",1001,467,534
"9209020","Kegalle","Aranayaka","Uduwewela","15A",1178,572,606
"9209025","Kegalle","Aranayaka","Kande Watta","15D",1220,574,646
"9209030","Kegalle","Aranayaka","Gal Athara","15C",1138,549,589
"9209035","Kegalle","Aranayaka","Gammannagoda","17D",800,388,412
"9209040","Kegalle","Aranayaka","Katugaha","17B",1055,499,556
"9209045","Kegalle","Aranayaka","Ussapitiya","17",1365,650,715
"9209050","Kegalle","Aranayaka","Waharakgoda","17C",1166,556,610
"9209055","Kegalle","Aranayaka","Ruwandeniya","33C",1351,630,721
"9209060","Kegalle","Aranayaka","Attapitiya","33A",1008,459,549
"9209065","Kegalle","Aranayaka","Devanagala","33B",1075,507,568
"9209070","Kegalle","Aranayaka","Kariyagama","17A",1094,519,575
"9209075","Kegalle","Aranayaka","Godigamuwa","46A",1523,720,803
"9209080","Kegalle","Aranayaka","Narangammana","45D",1611,771,840
"9209085","Kegalle","Aranayaka","Lambutuwa","16F",1157,537,620
"9209090","Kegalle","Aranayaka","Wattegedara","16G",779,381,398
"9209095","Kegalle","Aranayaka","Asmadala","16D",983,484,499
"9209100","Kegalle","Aranayaka","Kandamulla","16E",1097,512,585
"9209105","Kegalle","Aranayaka","Kumarapura","47E",865,409,456
"9209110","Kegalle","Aranayaka","Debathgama Udabage","47B",1662,771,891
"9209115","Kegalle","Aranayaka","Debathgama Pallebage","47A",1299,621,678
"9209120","Kegalle","Aranayaka","Hathgampala","47",696,323,373
"9209125","Kegalle","Aranayaka","Moragammana","47C",1408,678,730
"9209130","Kegalle","Aranayaka","Gevilipitiya Town","45B",1377,623,754
"9209135","Kegalle","Aranayaka","Gevilipitiya Gama","45A",961,449,512
"9209140","Kegalle","Aranayaka","Pehinipeddara","45C",1026,465,561
"9209145","Kegalle","Aranayaka","Nikapitiya","46",1726,807,919
"9209150","Kegalle","Aranayaka","Thalgamuwa","33",1073,513,560
"9209155","Kegalle","Aranayaka","Dippitiya","45",1604,724,880
"9209160","Kegalle","Aranayaka","Habalakkawa","44A",1329,636,693
"9209165","Kegalle","Aranayaka","Keerapana","42C",1127,517,610
"9209170","Kegalle","Aranayaka","Vilpola","45E",2322,1039,1283
"9209175","Kegalle","Aranayaka","Galbokka","43C",1221,572,649
"9209180","Kegalle","Aranayaka","Elangipitiya","47F",1237,584,653
"9209185","Kegalle","Aranayaka","Kalugala","47D",1062,494,568
"9209190","Kegalle","Aranayaka","Kehelwatta","48",785,394,391
"9209195","Kegalle","Aranayaka","Dampelgoda","48B",720,366,354
"9209200","Kegalle","Aranayaka","Narangala","58F",854,431,423
"9209205","Kegalle","Aranayaka","Getaberi Kanda","43B",1269,586,683
"9209210","Kegalle","Aranayaka","Pannala","42D",951,428,523
"9209215","Kegalle","Aranayaka","Duldeniya","42A",1316,591,725
"9209220","Kegalle","Aranayaka","Thalgaspitiya Muslimgama","44C",2129,939,1190
"9209225","Kegalle","Aranayaka","Thalgaspitiya","44",789,380,409
"9209230","Kegalle","Aranayaka","Thelleka","42B",992,479,513
"9209235","Kegalle","Aranayaka","Hakurugammana","42",979,466,513
"9209240","Kegalle","Aranayaka","Aranayaka","43",1125,594,531
"9209245","Kegalle","Aranayaka","Udagama","43E",899,401,498
"9209250","Kegalle","Aranayaka","Ambalakanda","43A",873,371,502
"9209255","Kegalle","Aranayaka","Ganthuna Udagama","58B",1269,637,632
"9209260","Kegalle","Aranayaka","Ganthuna Medagama","58G",965,489,476
"9209265","Kegalle","Aranayaka","Jambugasmada","58C",622,308,314
"9209270","Kegalle","Aranayaka","Podape","43D",984,439,545
"9209275","Kegalle","Aranayaka","Deiyanwala","41E",1015,468,547
"9209280","Kegalle","Aranayaka","Arama","41",813,354,459
"9209285","Kegalle","Aranayaka","Rahala","41B",1396,639,757
"9209290","Kegalle","Aranayaka","Randiligama","41D",894,430,464
"9209295","Kegalle","Aranayaka","Yodhagama","44B",760,360,400
"9209300","Kegalle","Aranayaka","Selawa East","41A",542,258,284
"9209305","Kegalle","Aranayaka","Selawa West","41C",558,276,282
"9212005","Kegalle","Kegalle","Siyambalapitiya","51",1808,887,921
"9212010","Kegalle","Kegalle","Pussella","51F",1469,702,767
"9212015","Kegalle","Kegalle","Dimbulgamuwa","14B",1229,572,657
"9212020","Kegalle","Kegalle","Kolongalla","14D",1592,746,846
"9212025","Kegalle","Kegalle","Diyagama","12A",1084,515,569
"9212030","Kegalle","Kegalle","Kalugalla","12",966,445,521
"9212035","Kegalle","Kegalle","Puwakdeniya","14A",2174,997,1177
"9212040","Kegalle","Kegalle","Meepitiya","51G",4650,2268,2382
"9212045","Kegalle","Kegalle","Olagankanda","51C",1847,889,958
"9212050","Kegalle","Kegalle","Wewaladeniya","51D",1521,737,784
"9212055","Kegalle","Kegalle","Ranwala","51A",4487,2002,2485
"9212060","Kegalle","Kegalle","Paranagampola","52C",2030,994,1036
"9212065","Kegalle","Kegalle","Uraulla","52B",1623,795,828
"9212070","Kegalle","Kegalle","Ambanpitiya","52",1812,900,912
"9212075","Kegalle","Kegalle","Beragala","52A",1998,964,1034
"9212080","Kegalle","Kegalle","Kegalle Town","51B",2205,1188,1017
"9212085","Kegalle","Kegalle","Golahela","51E",4651,2159,2492
"9212090","Kegalle","Kegalle","Pallewela","14E",1199,582,617
"9212095","Kegalle","Kegalle","Karandupotha","14",1594,762,832
"9212100","Kegalle","Kegalle","Uda Karadupana","14C",1112,524,588
"9212105","Kegalle","Kegalle","Nilmalgoda","50A",1151,537,614
"9212110","Kegalle","Kegalle","Paragammana","53E",1713,804,909
"9212115","Kegalle","Kegalle","Waldeniya","53C",1350,660,690
"9212120","Kegalle","Kegalle","Dikella","53D",2531,1231,1300
"9212125","Kegalle","Kegalle","Buluruppa","53B",1361,621,740
"9212130","Kegalle","Kegalle","Ekiriyagala","50",1245,582,663
"9212135","Kegalle","Kegalle","Deewela Medagama","16C",1302,619,683
"9212140","Kegalle","Kegalle","Deewela Pallegama","16B",1320,620,700
"9212145","Kegalle","Kegalle","Ewunugalla","49A",1634,778,856
"9212150","Kegalle","Kegalle","Dikkohupitiya","50B",1121,543,578
"9212155","Kegalle","Kegalle","Kavudugama","53A",1349,638,711
"9212160","Kegalle","Kegalle","Makoora","53",1171,563,608
"9212165","Kegalle","Kegalle","Bulugahadeniya","55A",1558,740,818
"9212170","Kegalle","Kegalle","Thalewala","55",1224,570,654
"9212175","Kegalle","Kegalle","Hettimulla","49",1242,589,653
"9212180","Kegalle","Kegalle","Minuwangamuwa","49B",1457,661,796
"9212185","Kegalle","Kegalle","Udumagama","48D",1060,485,575
"9212190","Kegalle","Kegalle","Wadupola","48E",1196,573,623
"9212195","Kegalle","Kegalle","Wathura","54A",1512,699,813
"9212200","Kegalle","Kegalle","Meedeniya South","55D",1241,579,662
"9212205","Kegalle","Kegalle","Meedeniya North","55C",1107,524,583
"9212210","Kegalle","Kegalle","Malavita","55B",1937,935,1002
"9212215","Kegalle","Kegalle","Godigamuwa","54",1152,541,611
"9212220","Kegalle","Kegalle","Hapuvita Pallegama","54B",991,471,520
"9212225","Kegalle","Kegalle","Alapalawala","48A",1400,678,722
"9212230","Kegalle","Kegalle","Nilapalagammana","48C",991,468,523
"9212235","Kegalle","Kegalle","Eregama","57A",960,445,515
"9212240","Kegalle","Kegalle","Athurupana","57",936,439,497
"9212245","Kegalle","Kegalle","Rotuwa","56",806,365,441
"9212250","Kegalle","Kegalle","Hungampola","56C",787,364,423
"9212255","Kegalle","Kegalle","Gurullawala","56A",1169,562,607
"9212260","Kegalle","Kegalle","Moradana","56D",807,371,436
"9212265","Kegalle","Kegalle","Mabopitiya","59",875,410,465
"9212270","Kegalle","Kegalle","Higgoda","59A",1077,498,579
"9212275","Kegalle","Kegalle","Bossella","57B",1016,511,505
"9212280","Kegalle","Kegalle","Ganthuna Pallegama North","58B",1041,489,552
"9212285","Kegalle","Kegalle","Bogala","58",1001,462,539
"9212290","Kegalle","Kegalle","Thiyambarahena","59B",985,441,544
"9212295","Kegalle","Kegalle","Undugoda","56B",1427,670,757
"9212300","Kegalle","Kegalle","Belihulwana","58C",1118,536,582
"9212305","Kegalle","Kegalle","Ganthuna Pallegama South","58A",482,227,255
"9215005","Kegalle","Galigamuwa","Helamada","76B",1730,827,903
"9215010","Kegalle","Galigamuwa","Godapola","76",1770,824,946
"9215015","Kegalle","Galigamuwa","Batuwatta","76A",1904,879,1025
"9215020","Kegalle","Galigamuwa","Makuddala","73",1290,635,655
"9215025","Kegalle","Galigamuwa","Weragoda","73A",1278,613,665
"9215030","Kegalle","Galigamuwa","Jeewana","74A",1109,539,570
"9215035","Kegalle","Galigamuwa","Dewalegama","74",1798,866,932
"9215040","Kegalle","Galigamuwa","Walagama","75A",1333,607,726
"9215045","Kegalle","Galigamuwa","Kandegedara","75",1410,663,747
"9215050","Kegalle","Galigamuwa","Edurapotha West","74C",986,464,522
"9215055","Kegalle","Galigamuwa","Panakawa","74D",2015,955,1060
"9215060","Kegalle","Galigamuwa","Edurapotha East","74B",1504,702,802
"9215065","Kegalle","Galigamuwa","Nawagamuwa","72A",1346,638,708
"9215070","Kegalle","Galigamuwa","Hathnagoda","72",1282,626,656
"9215075","Kegalle","Galigamuwa","Peherambe","70",821,406,415
"9215080","Kegalle","Galigamuwa","Palapoluwa","70A",1505,725,780
"9215085","Kegalle","Galigamuwa","Yattogoda","70B",1532,718,814
"9215090","Kegalle","Galigamuwa","Ballapana Pathabage","70C",1561,750,811
"9215095","Kegalle","Galigamuwa","Kobbewala","71",1825,873,952
"9215100","Kegalle","Galigamuwa","Galigamuwa","69B",2057,1057,1000
"9215105","Kegalle","Galigamuwa","Ballapana Udabage","70D",1475,706,769
"9215110","Kegalle","Galigamuwa","Mayfield","70E",1321,639,682
"9215115","Kegalle","Galigamuwa","Asideniya","69",1330,596,734
"9215120","Kegalle","Galigamuwa","Dematanpitiya","69A",1728,842,886
"9215125","Kegalle","Galigamuwa","Bisowela","69C",2552,1208,1344
"9215130","Kegalle","Galigamuwa","Imbulgala","68",1244,604,640
"9215135","Kegalle","Galigamuwa","Atugoda","68C",1833,878,955
"9215140","Kegalle","Galigamuwa","Renapana","68B",1825,868,957
"9215145","Kegalle","Galigamuwa","Bambaragama","66A",1418,661,757
"9215150","Kegalle","Galigamuwa","Naberiyawa","66",2110,980,1130
"9215155","Kegalle","Galigamuwa","Narangoda","67",1282,600,682
"9215160","Kegalle","Galigamuwa","Alawala","67A",936,454,482
"9215165","Kegalle","Galigamuwa","Holombuwa","67B",940,447,493
"9215170","Kegalle","Galigamuwa","Boyagoda","65B",1512,740,772
"9215175","Kegalle","Galigamuwa","Arandara","64A",2387,1148,1239
"9215180","Kegalle","Galigamuwa","Kiridana","64B",1037,487,550
"9215185","Kegalle","Galigamuwa","Kinigama","64",1109,543,566
"9215190","Kegalle","Galigamuwa","Damunupola","68A",1541,713,828
"9215195","Kegalle","Galigamuwa","Lahupana","60B",1239,606,633
"9215200","Kegalle","Galigamuwa","Pothukoladeniya","61B",1576,755,821
"9215205","Kegalle","Galigamuwa","Pindeniya","65",955,445,510
"9215210","Kegalle","Galigamuwa","Udugama","65A",1155,531,624
"9215215","Kegalle","Galigamuwa","Nadeniya","65C",957,472,485
"9215220","Kegalle","Galigamuwa","Atala","63C",2160,1051,1109
"9215225","Kegalle","Galigamuwa","Hapudeniya","61C",1211,589,622
"9215230","Kegalle","Galigamuwa","Kurunegoda","63B",1553,730,823
"9215235","Kegalle","Galigamuwa","Ruggahathenna","63A",1133,557,576
"9215240","Kegalle","Galigamuwa","Ampe","63",1799,886,913
"9215245","Kegalle","Galigamuwa","Hathnapitiya","62B",1047,507,540
"9215250","Kegalle","Galigamuwa","Karagala","62A",782,353,429
"9215255","Kegalle","Galigamuwa","Aruggammana","62",1287,618,669
"9218005","Kegalle","Warakapola","Waddeniya","77",1634,813,821
"9218010","Kegalle","Warakapola","Kalugala","79A",823,383,440
"9218015","Kegalle","Warakapola","Weniwellakaduwa","77A",1275,607,668
"9218020","Kegalle","Warakapola","Kodapaluwa","77B",2059,958,1101
"9218025","Kegalle","Warakapola","Opatha","78B",1775,855,920
"9218030","Kegalle","Warakapola","Paspolakanda","78C",836,413,423
"9218035","Kegalle","Warakapola","Thulhiriya","82A",1861,894,967
"9218040","Kegalle","Warakapola","Parakramagama","82D",887,425,462
"9218045","Kegalle","Warakapola","Nangalla","82C",3205,1490,1715
"9218050","Kegalle","Warakapola","Ragalkanda","78",798,378,420
"9218055","Kegalle","Warakapola","Heliyagoda","78A",763,376,387
"9218060","Kegalle","Warakapola","Metiyagane","79C",948,469,479
"9218065","Kegalle","Warakapola","Thalgama","79B",1222,582,640
"9218070","Kegalle","Warakapola","Egalla","79",1349,654,695
"9218075","Kegalle","Warakapola","Kumbalgama","81A",912,432,480
"9218080","Kegalle","Warakapola","Akwatta","81",725,358,367
"9218085","Kegalle","Warakapola","Pinnagoda Kanda","81B",763,354,409
"9218090","Kegalle","Warakapola","Gasnawa","82B",1390,634,756
"9218095","Kegalle","Warakapola","Mangedara","82",2270,1086,1184
"9218100","Kegalle","Warakapola","Ambepussa","83A",3497,1732,1765
"9218105","Kegalle","Warakapola","Warakapola","92A",4267,2066,2201
"9218110","Kegalle","Warakapola","Mahena Colony","83C",1240,591,649
"9218115","Kegalle","Warakapola","Mahena","83B",2337,1125,1212
"9218120","Kegalle","Warakapola","Tholangamuwa","83",2753,1307,1446
"9218125","Kegalle","Warakapola","Nape","84B",1117,536,581
"9218130","Kegalle","Warakapola","Morawaka","80",2080,1004,1076
"9218135","Kegalle","Warakapola","Mampita","80A",2325,1088,1237
"9218140","Kegalle","Warakapola","Nelumdeniya","85B",1707,801,906
"9218145","Kegalle","Warakapola","Othnapitiya","84A",1301,610,691
"9218150","Kegalle","Warakapola","Boorunnawa","84",1122,534,588
"9218160","Kegalle","Warakapola","Delgamuwa","83D",918,425,493
"9218165","Kegalle","Warakapola","Thumbaliyadda","92C",1481,690,791
"9218170","Kegalle","Warakapola","Ganithapura","92B",3783,1927,1856
"9218175","Kegalle","Warakapola","Ethnawala","94A",2405,1146,1259
"9218180","Kegalle","Warakapola","Dummaladeniya","94C",2377,1171,1206
"9218185","Kegalle","Warakapola","Puhulegama","96B",715,343,372
"9218190","Kegalle","Warakapola","Godawela","96",1659,780,879
"9218195","Kegalle","Warakapola","Penihela","96C",837,370,467
"9218200","Kegalle","Warakapola","Thambugala","96A",1101,528,573
"9218205","Kegalle","Warakapola","Thalgahadeniya","95B",730,360,370
"9218210","Kegalle","Warakapola","Niwatuwa","94B",1415,684,731
"9218215","Kegalle","Warakapola","Kukulpane","92",2034,971,1063
"9218220","Kegalle","Warakapola","Thalliyadda","91C",1159,569,590
"9218225","Kegalle","Warakapola","Dorawaka Pallebage","91B",1563,741,822
"9218230","Kegalle","Warakapola","Yaddehimulla","91D",1540,745,795
"9218235","Kegalle","Warakapola","Kohombadeniya","91A",1016,478,538
"9218240","Kegalle","Warakapola","Ihala Lenagala","86A",1152,550,602
"9218245","Kegalle","Warakapola","Dedigama","85",1378,653,725
"9218250","Kegalle","Warakapola","Pitadeniya","85C",1898,903,995
"9218255","Kegalle","Warakapola","Thunthota","85A",1059,483,576
"9218260","Kegalle","Warakapola","Imbulovita","85D",402,199,203
"9218265","Kegalle","Warakapola","Menikkadawara","86",1615,808,807
"9218270","Kegalle","Warakapola","Maha Pallegama","87",1689,800,889
"9218275","Kegalle","Warakapola","Kinivita","87C",1190,571,619
"9218280","Kegalle","Warakapola","Hapugoda","93D",512,240,272
"9218285","Kegalle","Warakapola","Dorawaka Udabage","91",1547,729,818
"9218290","Kegalle","Warakapola","Weragoda","93",1620,752,868
"9218295","Kegalle","Warakapola","Palamure","93B",1794,869,925
"9218300","Kegalle","Warakapola","Bopitiya","94",1467,711,756
"9218305","Kegalle","Warakapola","Algama Ihalagama","95D",925,445,480
"9218310","Kegalle","Warakapola","Algama","95",1865,898,967
"9218315","Kegalle","Warakapola","Madurupitiya","95A",1016,468,548
"9218320","Kegalle","Warakapola","Kandegama","95C",966,451,515
"9218325","Kegalle","Warakapola","Uduwaka","97",2056,998,1058
"9218330","Kegalle","Warakapola","Hallawa","93A",738,365,373
"9218335","Kegalle","Warakapola","Ebidigala","93C",769,386,383
"9218340","Kegalle","Warakapola","Alpitiya","89",949,449,500
"9218345","Kegalle","Warakapola","Kivuldeniya","89B",1558,754,804
"9218350","Kegalle","Warakapola","Kudapallegama","87B",1145,548,597
"9218355","Kegalle","Warakapola","Thambadiya","87A",1106,538,568
"9218360","Kegalle","Warakapola","Elamaldeniya","88B",694,322,372
"9218365","Kegalle","Warakapola","Malmaduwa","88",706,340,366
"9218370","Kegalle","Warakapola","Polgampala","88A",1077,496,581
"9218375","Kegalle","Warakapola","Weragala","90",1381,647,734
"9218380","Kegalle","Warakapola","Pallepelpita","88C",1136,555,581
"9218385","Kegalle","Warakapola","Pahala Lenagala","90A",1169,562,607
"9218390","Kegalle","Warakapola","Welhella","89A",1554,764,790
"9221005","Kegalle","Ruwanwella","Dunumala","99C",1623,755,868
"9221010","Kegalle","Ruwanwella","Galapitamada","99B",1133,538,595
"9221015","Kegalle","Ruwanwella","Walgampatha","98",906,437,469
"9221020","Kegalle","Ruwanwella","Kadigamuwa","99D",1726,842,884
"9221025","Kegalle","Ruwanwella","Mahakanda","98B",1125,545,580
"9221030","Kegalle","Ruwanwella","Lenagala","98A",1161,567,594
"9221035","Kegalle","Ruwanwella","Lewangama North","99",1164,573,591
"9221040","Kegalle","Ruwanwella","Lewangama South","99A",2021,939,1082
"9221045","Kegalle","Ruwanwella","Morathota","101B",1011,486,525
"9221050","Kegalle","Ruwanwella","Waharaka","101",1800,828,972
"9221055","Kegalle","Ruwanwella","Daluwalana","101A",1847,898,949
"9221060","Kegalle","Ruwanwella","Wahakula","101C",1456,685,771
"9221065","Kegalle","Ruwanwella","Dannoruwa","104C",1711,828,883
"9221070","Kegalle","Ruwanwella","Nivunhella","100A",1739,821,918
"9221075","Kegalle","Ruwanwella","Imbulana","100",2574,1213,1361
"9221080","Kegalle","Ruwanwella","Siyambalawala","100B",1662,816,846
"9221085","Kegalle","Ruwanwella","Pethangoda","100C",1951,959,992
"9221090","Kegalle","Ruwanwella","Kannattota","109",2739,1247,1492
"9221095","Kegalle","Ruwanwella","Gonaramba","109A",2512,1179,1333
"9221100","Kegalle","Ruwanwella","Doranuwa","105B",2865,1347,1518
"9221105","Kegalle","Ruwanwella","Bopetta","104A",1141,549,592
"9221110","Kegalle","Ruwanwella","Morawatta","104",2252,1059,1193
"9221115","Kegalle","Ruwanwella","Mahalla","104B",2208,1075,1133
"9221120","Kegalle","Ruwanwella","Gonagala North","103C",1525,756,769
"9221125","Kegalle","Ruwanwella","Indurana","101D",1312,625,687
"9221130","Kegalle","Ruwanwella","Puranpotta","102D",1297,622,675
"9221135","Kegalle","Ruwanwella","Batuvita","102E",559,269,290
"9221140","Kegalle","Ruwanwella","Amithirigala North","102",1410,694,716
"9221145","Kegalle","Ruwanwella","Amithirigala South","102A",1036,474,562
"9221150","Kegalle","Ruwanwella","Gonagala West","103D",1132,557,575
"9221155","Kegalle","Ruwanwella","Mapitigama","103B",1779,888,891
"9221160","Kegalle","Ruwanwella","Moraliya","103A",1869,957,912
"9221165","Kegalle","Ruwanwella","Ruwanwella","105A",3579,1749,1830
"9221170","Kegalle","Ruwanwella","Wendala","105",2670,1250,1420
"9221175","Kegalle","Ruwanwella","Mahadeniya","102F",755,363,392
"9221180","Kegalle","Ruwanwella","Udakanugala","102C",1165,574,591
"9221185","Kegalle","Ruwanwella","Palle Kanugala","102B",1826,868,958
"9221190","Kegalle","Ruwanwella","Medagoda","103",1672,822,850
"9224005","Kegalle","Bulathkohupitiya","Kanangamuwa","60C",1139,529,610
"9224010","Kegalle","Bulathkohupitiya","Getiyamulla","61",1120,527,593
"9224015","Kegalle","Bulathkohupitiya","Higgoda","60A",810,385,425
"9224020","Kegalle","Bulathkohupitiya","Puspane","60D",2407,1160,1247
"9224025","Kegalle","Bulathkohupitiya","Kabagamuwa","60",1359,656,703
"9224030","Kegalle","Bulathkohupitiya","Alawathura","61A",2385,1114,1271
"9224035","Kegalle","Bulathkohupitiya","Ambuwakka","62C",1258,561,697
"9224040","Kegalle","Bulathkohupitiya","Haloluwa","108A",1856,898,958
"9224045","Kegalle","Bulathkohupitiya","Wegalla","128B",2576,1248,1328
"9224050","Kegalle","Bulathkohupitiya","Lewala","129A",3797,1864,1933
"9224055","Kegalle","Bulathkohupitiya","Bulathkohupitiya","129B",1841,897,944
"9224060","Kegalle","Bulathkohupitiya","Rangalla","129",1796,845,951
"9224065","Kegalle","Bulathkohupitiya","Nevismiyar Ihala","129D",2898,1367,1531
"9224070","Kegalle","Bulathkohupitiya","Uduwa","130",1698,794,904
"9224075","Kegalle","Bulathkohupitiya","Dedugala","131C",1220,596,624
"9224080","Kegalle","Bulathkohupitiya","Pelempitiya","131B",1479,715,764
"9224085","Kegalle","Bulathkohupitiya","Neluwakkana","131",667,310,357
"9224090","Kegalle","Bulathkohupitiya","Udapotha","128E",1818,861,957
"9224095","Kegalle","Bulathkohupitiya","Kendawa","128A",2341,1118,1223
"9224100","Kegalle","Bulathkohupitiya","Narangala","128C",1529,785,744
"9224105","Kegalle","Bulathkohupitiya","Urumeewala","129C",1246,583,663
"9224110","Kegalle","Bulathkohupitiya","Punehela","128",1144,544,600
"9224115","Kegalle","Bulathkohupitiya","Panapitiya","107D",2653,1254,1399
"9224120","Kegalle","Bulathkohupitiya","Ampagala","107A",2550,1216,1334
"9224125","Kegalle","Bulathkohupitiya","Thelkumuduwala","107",1169,552,617
"9224130","Kegalle","Bulathkohupitiya","Kiriporuwa","107C",1372,643,729
"9224135","Kegalle","Bulathkohupitiya","Ambamalla","128D",967,468,499
"9227005","Kegalle","Yatiyanthota","Mattamagoda","108",4953,2316,2637
"9227010","Kegalle","Yatiyanthota","Galpatha","107B",2408,1125,1283
"9227015","Kegalle","Yatiyanthota","Kabulumulla","106B",3435,1672,1763
"9227020","Kegalle","Yatiyanthota","Garagoda Pahala","115C",2453,1117,1336
"9227025","Kegalle","Yatiyanthota","Garagoda Ihala","115D",1364,672,692
"9227030","Kegalle","Yatiyanthota","Yatiyanthota","106",3012,1463,1549
"9227035","Kegalle","Yatiyanthota","Mahavila","106C",1611,790,821
"9227040","Kegalle","Yatiyanthota","Parussella","106A",2897,1407,1490
"9227045","Kegalle","Yatiyanthota","Jayavinda Gama","132B",2745,1330,1415
"9227050","Kegalle","Yatiyanthota","Welihelathenna","135A",1864,891,973
"9227055","Kegalle","Yatiyanthota","Malalpola","132A",1583,782,801
"9227060","Kegalle","Yatiyanthota","Dombepola","132",2124,1086,1038
"9227065","Kegalle","Yatiyanthota","Amanawala","131A",1596,792,804
"9227070","Kegalle","Yatiyanthota","Berannawa","131D",1143,558,585
"9227075","Kegalle","Yatiyanthota","Seepoth","131E",1712,830,882
"9227080","Kegalle","Yatiyanthota","Mahabage","134A",1215,586,629
"9227085","Kegalle","Yatiyanthota","Dunukedeniya","134E",1086,507,579
"9227090","Kegalle","Yatiyanthota","Malwatta","134C",1422,701,721
"9227095","Kegalle","Yatiyanthota","Kirikohuthenna","134I",1300,615,685
"9227100","Kegalle","Yatiyanthota","Neluwathukanda","133B",1137,526,611
"9227105","Kegalle","Yatiyanthota","Polpitiya","135B",1122,528,594
"9227110","Kegalle","Yatiyanthota","Weeragalla","135C",1178,579,599
"9227115","Kegalle","Yatiyanthota","Nawata","135D",1181,567,614
"9227120","Kegalle","Yatiyanthota","Meegasthenna","115E",2262,1107,1155
"9227125","Kegalle","Yatiyanthota","Pelellegama","115F",2155,1063,1092
"9227130","Kegalle","Yatiyanthota","Hakbellawaka","135E",1770,866,904
"9227135","Kegalle","Yatiyanthota","Ganepalla","135",2011,994,1017
"9227140","Kegalle","Yatiyanthota","Theligama","133A",2043,976,1067
"9227145","Kegalle","Yatiyanthota","Gonagamuwa","133",1584,759,825
"9227150","Kegalle","Yatiyanthota","Kithulgala North","134",1637,785,852
"9227155","Kegalle","Yatiyanthota","Kalukohuthenna","134D",1602,767,835
"9227160","Kegalle","Yatiyanthota","Kithulgala South","134B",1491,692,799
"9230005","Kegalle","Dehiovita","Kurupetta","116A",1652,805,847
"9230010","Kegalle","Dehiovita","Daigala","117",755,361,394
"9230015","Kegalle","Dehiovita","Eluwana","116E",1266,615,651
"9230020","Kegalle","Dehiovita","Magammana","116",1520,730,790
"9230025","Kegalle","Dehiovita","Kanangama","116C",3029,1452,1577
"9230030","Kegalle","Dehiovita","Walpola","115",4310,2079,2231
"9230035","Kegalle","Dehiovita","Boralankada","115B",2519,1247,1272
"9230040","Kegalle","Dehiovita","Dikella","119A",3600,1780,1820
"9230045","Kegalle","Dehiovita","Kahanavita","115A",1441,686,755
"9230050","Kegalle","Dehiovita","Dehiovita","119B",3819,1877,1942
"9230055","Kegalle","Dehiovita","Atulugamwela","116F",932,464,468
"9230060","Kegalle","Dehiovita","Atulugama","116B",1703,825,878
"9230065","Kegalle","Dehiovita","Kelegama","117A",1075,507,568
"9230070","Kegalle","Dehiovita","Napawala","117B",2695,1310,1385
"9230075","Kegalle","Dehiovita","Uduvila","118C",1922,938,984
"9230080","Kegalle","Dehiovita","Epalapitiya","118",2753,1316,1437
"9230085","Kegalle","Dehiovita","Pahala Thaldoowa","118B",4445,2202,2243
"9230090","Kegalle","Dehiovita","Ihala Thaldoowa","118A",2580,1262,1318
"9230095","Kegalle","Dehiovita","Debegama","116D",2106,1026,1080
"9230100","Kegalle","Dehiovita","Thimbiripola","118D",2962,1415,1547
"9230105","Kegalle","Dehiovita","Algoda","119",1760,843,917
"9230110","Kegalle","Dehiovita","Hinguralakanda East","120",1056,522,534
"9230115","Kegalle","Dehiovita","Batangala","123",2692,1272,1420
"9230120","Kegalle","Dehiovita","Viharakanda","124B",1453,705,748
"9230125","Kegalle","Dehiovita","Galabalana Kanda","124C",1512,731,781
"9230130","Kegalle","Dehiovita","Maniyangama","124",1643,801,842
"9230135","Kegalle","Dehiovita","Madola","125",3406,1541,1865
"9230140","Kegalle","Dehiovita","Welangalla","125A",2584,1304,1280
"9230145","Kegalle","Dehiovita","Bomaluwa","124A",1136,530,606
"9230150","Kegalle","Dehiovita","Rangegama","122A",2466,1182,1284
"9230155","Kegalle","Dehiovita","Panawala","122",2107,1027,1080
"9230160","Kegalle","Dehiovita","Hinguralakanda West","120A",1791,829,962
"9230165","Kegalle","Dehiovita","Pukunuwala","122C",1688,837,851
"9230170","Kegalle","Dehiovita","Godagampala","121C",1996,997,999
"9230175","Kegalle","Dehiovita","Ambalampitiya","121D",1529,715,814
"9230180","Kegalle","Dehiovita","Madagammana","122B",793,389,404
"9230185","Kegalle","Dehiovita","Pannila","121A",1637,783,854
"9230190","Kegalle","Dehiovita","Imbulpitiya","121",1548,754,794
"9230195","Kegalle","Dehiovita","Elavulla","121B",1434,708,726
"9233005","Kegalle","Deraniyagala","Ballahela","110",788,371,417
"9233010","Kegalle","Deraniyagala","Behenella","110C",1389,666,723
"9233015","Kegalle","Deraniyagala","Nilwala","110A",1541,723,818
"9233020","Kegalle","Deraniyagala","Dodawatta","110D",1797,876,921
"9233025","Kegalle","Deraniyagala","Basnagala","111C",2041,969,1072
"9233030","Kegalle","Deraniyagala","Keerihena","111B",952,442,510
"9233035","Kegalle","Deraniyagala","Udabage","111",2095,1035,1060
"9233040","Kegalle","Deraniyagala","Wattegedara","114D",4409,2095,2314
"9233045","Kegalle","Deraniyagala","Deraniyagala","114",2715,1311,1404
"9233050","Kegalle","Deraniyagala","Lassegama","114C",1941,951,990
"9233055","Kegalle","Deraniyagala","Anhettigama","111A",1220,565,655
"9233060","Kegalle","Deraniyagala","Panakoora","112D",1169,582,587
"9233065","Kegalle","Deraniyagala","Pandaha","112B",1547,806,741
"9233070","Kegalle","Deraniyagala","Polgaswatta","110B",1355,694,661
"9233075","Kegalle","Deraniyagala","Maliboda","112",1942,993,949
"9233080","Kegalle","Deraniyagala","Poddenikanda","112C",2323,1124,1199
"9233085","Kegalle","Deraniyagala","Nakkavita","112A",1273,599,674
"9233090","Kegalle","Deraniyagala","Miyanavita","114G",2216,1047,1169
"9233095","Kegalle","Deraniyagala","Deraniyagala South","114E",2748,1257,1491
"9233100","Kegalle","Deraniyagala","Rasnakkanda","114B",1465,706,759
"9233105","Kegalle","Deraniyagala","Udapola","114A",1994,965,1029
"9233110","Kegalle","Deraniyagala","Demeda","114F",971,483,488
"9233115","Kegalle","Deraniyagala","Kosgahakanda","113A",2336,1119,1217
"9233120","Kegalle","Deraniyagala","Yatiwala","113B",1882,922,960
"9233125","Kegalle","Deraniyagala","Magala","113",1076,559,517
"9233130","Kegalle","Deraniyagala","Dikellakanda","112E",684,356,328
"3103005","Galle","Benthota","Pahurumulla","1",557,332,225
"3103010","Galle","Benthota","Sinharoopagama","3B",1154,565,589
"3103015","Galle","Benthota","Yathramulla","3",877,447,430
"3103020","Galle","Benthota","Kommala","3C",1480,720,760
"3103025","Galle","Benthota","Bodhimaluwa","3A",1086,546,540
"3103030","Galle","Benthota","Dope","5",2500,1190,1310
"3103035","Galle","Benthota","Angagoda","2",1093,533,560
"3103040","Galle","Benthota","Warahena","2A",789,413,376
"3103045","Galle","Benthota","Kahagalla","5A",662,321,341
"3103050","Galle","Benthota","Hunganthota Wadumulla","3D",1031,493,538
"3103055","Galle","Benthota","Dedduwa","6",1810,837,973
"3103060","Galle","Benthota","Athuruwella","8C",829,395,434
"3103065","Galle","Benthota","Galbada","8A",978,466,512
"3103070","Galle","Benthota","Galagama","11C",735,357,378
"3103075","Galle","Benthota","Mullegoda","11A",685,334,351
"3103080","Galle","Benthota","Sooriyagama","12D",1046,482,564
"3103085","Galle","Benthota","Haburugala","12",1172,562,610
"3103090","Galle","Benthota","Thunduwa West","12C",1024,493,531
"3103095","Galle","Benthota","Thunduwa East","12B",887,402,485
"3103100","Galle","Benthota","Thotakanatta","12A",847,400,447
"3103105","Galle","Benthota","Elakaka","12E",739,352,387
"3103110","Galle","Benthota","Ethungagoda","14E",1624,796,828
"3103115","Galle","Benthota","Gonagalapura","11",1425,662,763
"3103120","Galle","Benthota","Olaganduwa","8B",1071,495,576
"3103125","Galle","Benthota","Yalegama","8",1036,502,534
"3103130","Galle","Benthota","Kaikawala","9",1194,569,625
"3103135","Galle","Benthota","Habakkala","9C",941,442,499
"3103140","Galle","Benthota","Etawalawatta West","9B",605,300,305
"3103145","Galle","Benthota","Etawalawatta East","9A",838,406,432
"3103150","Galle","Benthota","Dombagahawatta","11D",579,262,317
"3103155","Galle","Benthota","Akadegoda","10B",979,456,523
"3103160","Galle","Benthota","Kahawegammedda","10",1567,736,831
"3103165","Galle","Benthota","Warakamulla","10A",875,415,460
"3103170","Galle","Benthota","Kandemulla","10C",948,480,468
"3103175","Galle","Benthota","Galthuduwa","11B",545,256,289
"3103180","Galle","Benthota","Kolaniya","11E",1203,569,634
"3103185","Galle","Benthota","Miriswatta","14A",1606,772,834
"3103190","Galle","Benthota","Viyandoowa","12F",712,343,369
"3103195","Galle","Benthota","Mahagoda","14",1563,744,819
"3103200","Galle","Benthota","Pilekumbura","14D",694,342,352
"3103205","Galle","Benthota","Mahavila West","14C",836,434,402
"3103210","Galle","Benthota","Mahavila East","14B",685,353,332
"3103215","Galle","Benthota","Moragoda","13A",643,280,363
"3103220","Galle","Benthota","Ranthotuvila","13",576,258,318
"3103225","Galle","Benthota","Malawala","13B",523,269,254
"3103230","Galle","Benthota","Ihala Malawala","40D",875,428,447
"3103235","Galle","Benthota","Kotuwabendahena","40A",371,186,185
"3103240","Galle","Benthota","Kuda Uragaha","40C",648,323,325
"3103245","Galle","Benthota","Maha Uragaha","40",1087,516,571
"3103250","Galle","Benthota","Delkabalagoda","40E",1227,599,628
"3103255","Galle","Benthota","Hipanwatta","40B",518,251,267
"3106005","Galle","Balapitiya","Doowemodara","15",1536,728,808
"3106010","Galle","Balapitiya","Nanathota Palatha","16D",2692,1286,1406
"3106015","Galle","Balapitiya","Pelegas Palatha","16A",1550,738,812
"3106020","Galle","Balapitiya","Wathurawela","16B",1262,617,645
"3106025","Galle","Balapitiya","Boraluketiya","16C",1746,867,879
"3106030","Galle","Balapitiya","Pathiraja Pedesa","24D",1105,548,557
"3106035","Galle","Balapitiya","Polathu Palatha","24A",935,460,475
"3106040","Galle","Balapitiya","Katuvila","24B",796,393,403
"3106045","Galle","Balapitiya","Mahapitiya","17B",783,395,388
"3106050","Galle","Balapitiya","Nape","16",1291,607,684
"3106055","Galle","Balapitiya","Kudagodagama","17C",627,291,336
"3106060","Galle","Balapitiya","Hegalla-Piyagama","17",1149,503,646
"3106065","Galle","Balapitiya","Godapitiya","17D",347,168,179
"3106070","Galle","Balapitiya","Kosgoda","17A",1191,570,621
"3106075","Galle","Balapitiya","Ahungalla","18",1510,730,780
"3106080","Galle","Balapitiya","Middaramulla","18A",1461,684,777
"3106085","Galle","Balapitiya","Bogahapitiya","24C",1343,671,672
"3106090","Galle","Balapitiya","Galvehera","24",1128,506,622
"3106095","Galle","Balapitiya","Pathirajagama","24E",1731,820,911
"3106100","Galle","Balapitiya","Madoowa","23",658,294,364
"3106105","Galle","Balapitiya","Kadiragonna","19C",946,451,495
"3106110","Galle","Balapitiya","Makumbura","19B",1054,500,554
"3106115","Galle","Balapitiya","Wathuregama","19A",953,440,513
"3106120","Galle","Balapitiya","Wellabada","19",743,344,399
"3106125","Galle","Balapitiya","Pathegangoda","20A",2301,1076,1225
"3106130","Galle","Balapitiya","Weliwathugoda","21A",1462,693,769
"3106135","Galle","Balapitiya","Brahmanawatta North","20",2084,994,1090
"3106140","Galle","Balapitiya","Brahmanawatta South","20B",1712,811,901
"3106145","Galle","Balapitiya","Galmangoda","21",2175,981,1194
"3106150","Galle","Balapitiya","Wandadoowa","90",967,474,493
"3106155","Galle","Balapitiya","Heenatiya North","21B",892,416,476
"3106160","Galle","Balapitiya","Mahaladoowa","21D",709,348,361
"3106165","Galle","Balapitiya","Seenigoda","87D",2387,1113,1274
"3106170","Galle","Balapitiya","Heenatiya South","21C",825,393,432
"3106175","Galle","Balapitiya","Mahakarawa","90A",853,399,454
"3106180","Galle","Balapitiya","Elathota","21E",1103,533,570
"3106185","Galle","Balapitiya","Balapitiya","89",1855,922,933
"3106190","Galle","Balapitiya","Berathuduwa","89B",1172,531,641
"3106195","Galle","Balapitiya","Andadola","87B",2306,1120,1186
"3106200","Galle","Balapitiya","Petiwatta","87H",1563,719,844
"3106205","Galle","Balapitiya","Wathugedara","87C",2204,1044,1160
"3106210","Galle","Balapitiya","Paragahathota","87",1479,685,794
"3106215","Galle","Balapitiya","Wathugedara South","87A",796,375,421
"3106220","Galle","Balapitiya","Kurunduwatta","87F",1178,526,652
"3106225","Galle","Balapitiya","Walagedara","89A",1592,765,827
"3106230","Galle","Balapitiya","Randombe North","88B",1496,712,784
"3106235","Galle","Balapitiya","Wadumulla","87E",1423,675,748
"3106240","Galle","Balapitiya","Viharagoda","87G",1125,525,600
"3106245","Galle","Balapitiya","Kandegoda","88A",1086,525,561
"3106250","Galle","Balapitiya","Bogahawatta","88C",1016,467,549
"3106255","Galle","Balapitiya","Randombe South","88",1134,544,590
"3109005","Galle","Karandeniya","Walinguruketiya","39J",1706,842,864
"3109010","Galle","Karandeniya","Uragasmanhandiya North","39A",1449,699,750
"3109015","Galle","Karandeniya","Galpottawala","39H",628,306,322
"3109020","Galle","Karandeniya","Meegaspitiya","39B",1589,792,797
"3109025","Galle","Karandeniya","Mendorawala","39E",734,352,382
"3109030","Galle","Karandeniya","Uragasmanhandiya South","39",1744,850,894
"3109035","Galle","Karandeniya","Yatagala","39D",2208,1095,1113
"3109040","Galle","Karandeniya","Uragasmanhandiya East","39C",1634,793,841
"3109045","Galle","Karandeniya","Mabingoda","39G",985,493,492
"3109050","Galle","Karandeniya","Hipankanda","41A",1560,801,759
"3109055","Galle","Karandeniya","Siripura","41D",1176,566,610
"3109060","Galle","Karandeniya","Beligaswella","41E",605,308,297
"3109065","Galle","Karandeniya","Halgahawella","39F",1171,567,604
"3109070","Galle","Karandeniya","Lenagal Palatha","41C",1684,801,883
"3109075","Galle","Karandeniya","Magala North","41",890,422,468
"3109080","Galle","Karandeniya","Kaluwalagoda","41B",853,404,449
"3109085","Galle","Karandeniya","Diyapitagallana","41F",966,479,487
"3109090","Galle","Karandeniya","Angulugalla","95A",1853,869,984
"3109095","Galle","Karandeniya","Magala South","95",2571,1248,1323
"3109100","Galle","Karandeniya","Pehembiyakanda","95B",1405,677,728
"3109105","Galle","Karandeniya","Unagaswela","91D",2436,1173,1263
"3109110","Galle","Karandeniya","Madakumbura","92A",1513,698,815
"3109115","Galle","Karandeniya","Thalgahawatta","92D",1745,862,883
"3109120","Galle","Karandeniya","Mandakanda","92B",2071,996,1075
"3109125","Galle","Karandeniya","Anganaketiya","93C",3849,1841,2008
"3109130","Galle","Karandeniya","Borakanda","92",1847,844,1003
"3109135","Galle","Karandeniya","Mahaedanda","92F",1014,485,529
"3109140","Galle","Karandeniya","Karandeniya North","91",1966,946,1020
"3109145","Galle","Karandeniya","Randenigama","91B",1669,783,886
"3109150","Galle","Karandeniya","Mahagoda","91E",1113,520,593
"3109155","Galle","Karandeniya","Karandeniya South","91A",936,452,484
"3109160","Galle","Karandeniya","Dangahavila","91C",1040,459,581
"3109165","Galle","Karandeniya","Egodawela","91F",2169,1065,1104
"3109170","Galle","Karandeniya","Diviyagahawela","92C",2587,1258,1329
"3109175","Galle","Karandeniya","Kirinuge","92E",968,473,495
"3109180","Galle","Karandeniya","Kiripedda","93A",863,404,459
"3109185","Galle","Karandeniya","Galagoda Atta","93D",1525,746,779
"3109190","Galle","Karandeniya","Ihala Kiripedda","93B",1315,630,685
"3109195","Galle","Karandeniya","Kurundugaha Hethekma","93",3066,1499,1567
"3109200","Galle","Karandeniya","Jayabima","93E",1395,677,718
"3112005","Galle","Elpitiya","Avittawa","29A",949,467,482
"3112010","Galle","Elpitiya","Pahala Omatta","28",1022,446,576
"3112015","Galle","Elpitiya","Omatta","28C",1079,513,566
"3112020","Galle","Elpitiya","Metiviliya","30A",1087,515,572
"3112025","Galle","Elpitiya","Himbutugoda","31D",1047,476,571
"3112030","Galle","Elpitiya","Indipalegoda","30B",1753,902,851
"3112035","Galle","Elpitiya","Dikhena","31C",1214,588,626
"3112040","Galle","Elpitiya","Delpona","30C",580,265,315
"3112045","Galle","Elpitiya","Ihala Omatta","28A",1213,589,624
"3112050","Galle","Elpitiya","Digala Nagahathenna","28B",1745,843,902
"3112055","Galle","Elpitiya","Opatha","29B",970,455,515
"3112060","Galle","Elpitiya","Goluwamulla North","29C",963,453,510
"3112065","Galle","Elpitiya","Goluwamulla West","29D",749,337,412
"3112070","Galle","Elpitiya","Goluwamulla","29",972,468,504
"3112075","Galle","Elpitiya","Atakohota","25H",1426,661,765
"3112080","Galle","Elpitiya","Elpitiya North","25",1458,729,729
"3112085","Galle","Elpitiya","Elpitiya East","25C",646,326,320
"3112090","Galle","Elpitiya","Poojagallena","25K",765,386,379
"3112095","Galle","Elpitiya","Ketandola Udovita","31G",2079,982,1097
"3112100","Galle","Elpitiya","Sittaragoda","31H",473,236,237
"3112105","Galle","Elpitiya","Amugoda","31",1413,667,746
"3112110","Galle","Elpitiya","Kellapatha","31E",935,437,498
"3112115","Galle","Elpitiya","Thalagaspe","31B",1085,536,549
"3112120","Galle","Elpitiya","Thalagaspe West","31J",732,349,383
"3112125","Galle","Elpitiya","Wallambagala North","27E",1101,525,576
"3112130","Galle","Elpitiya","Elpitiya South","25B",1407,686,721
"3112135","Galle","Elpitiya","Elpitiya Central","25G",1723,961,762
"3112140","Galle","Elpitiya","Nawadagala","25A",1670,787,883
"3112145","Galle","Elpitiya","Batuwanhena","25D",3029,1423,1606
"3112150","Galle","Elpitiya","Igala","26A",1750,828,922
"3112155","Galle","Elpitiya","Igala East","26D",2383,1177,1206
"3112160","Galle","Elpitiya","Pelendagoda","25E",936,437,499
"3112165","Galle","Elpitiya","Wallambagala","27A",1157,558,599
"3112170","Galle","Elpitiya","Ambana","94",1165,564,601
"3112175","Galle","Elpitiya","Ambana North","94L",725,348,377
"3112180","Galle","Elpitiya","Pituwala South","27D",794,369,425
"3112185","Galle","Elpitiya","Pituwala North","27C",1082,496,586
"3112190","Galle","Elpitiya","Kudagala Kadirandola","26C",1584,768,816
"3112195","Galle","Elpitiya","Igala Thalawa East","26E",1165,539,626
"3112200","Galle","Elpitiya","Igala Thalawa","26B",3212,1481,1731
"3112205","Galle","Elpitiya","Ella","26G",2298,1102,1196
"3112210","Galle","Elpitiya","Ella Thanabaddegama","26",1374,623,751
"3112215","Galle","Elpitiya","Mahawela Abhayapura","27B",658,317,341
"3112220","Galle","Elpitiya","Pituwala West","27",672,313,359
"3112225","Galle","Elpitiya","Eramulla","94E",1765,863,902
"3112230","Galle","Elpitiya","Pinikahana","94A",1834,900,934
"3112235","Galle","Elpitiya","Kahadoowa","94D",956,458,498
"3112240","Galle","Elpitiya","Thibbotuwawa","94J",904,474,430
"3112245","Galle","Elpitiya","Wathuruvila","94C",1352,615,737
"3112250","Galle","Elpitiya","Rekadahena","94H",744,365,379
"3112255","Galle","Elpitiya","Kahadoowa South","94K",931,465,466
"3115005","Galle","Niyagama","Pitigala North","30B",1442,699,743
"3115010","Galle","Niyagama","Uhanovita","33E",658,322,336
"3115015","Galle","Niyagama","Hattaka","33",1085,553,532
"3115020","Galle","Niyagama","Kaluarachchigoda","30E",1287,633,654
"3115025","Galle","Niyagama","Pitigala","30",1424,679,745
"3115030","Galle","Niyagama","Karawwa","30D",1252,596,656
"3115035","Galle","Niyagama","Boraluwahena","33B",1206,603,603
"3115040","Galle","Niyagama","Bangamukanda","33D",595,286,309
"3115045","Galle","Niyagama","Godamuna North","33C",886,428,458
"3115050","Galle","Niyagama","Marthupitiya","32A",976,441,535
"3115055","Galle","Niyagama","Godamuna South","33A",1055,509,546
"3115060","Galle","Niyagama","Liyanagamakanda","34A/1",777,380,397
"3115065","Galle","Niyagama","Usbim Colony","34A/2",677,330,347
"3115070","Galle","Niyagama","Bambarawana","34A",789,383,406
"3115075","Galle","Niyagama","Mattaka","34",993,456,537
"3115080","Galle","Niyagama","Weihena","32",1307,651,656
"3115085","Galle","Niyagama","Amaragama","31B/2",1680,822,858
"3115090","Galle","Niyagama","Naranovita","31B",1136,546,590
"3115095","Galle","Niyagama","Porawagama","35",1311,664,647
"3115100","Galle","Niyagama","Kimbulawala","32B",840,390,450
"3115105","Galle","Niyagama","Poddiwala West","34B",1001,474,527
"3115110","Galle","Niyagama","Poddiwala East","34C",964,465,499
"3115115","Galle","Niyagama","Maraggoda","35A",1525,753,772
"3115120","Galle","Niyagama","Duwegoda","35C",1339,632,707
"3115125","Galle","Niyagama","Porawagama South","35B",1319,658,661
"3115130","Galle","Niyagama","Wattehena","37A",1137,549,588
"3115135","Galle","Niyagama","Manampita","37A/2",900,428,472
"3115140","Galle","Niyagama","Niyagama","38",1425,689,736
"3115145","Galle","Niyagama","Niyagama West","38A",576,265,311
"3115150","Galle","Niyagama","Polpelaketiya","37B",1176,587,589
"3115155","Galle","Niyagama","Horangalla West","37/3",396,209,187
"3115160","Galle","Niyagama","Horangalla Thalawa","37",1045,529,516
"3115165","Galle","Niyagama","Horangalla (Akulavila)","37/2",674,325,349
"3115170","Galle","Niyagama","Niyagama South","38B",721,345,376
"3118005","Galle","Thawalama","Ela Ihala","230B",1652,815,837
"3118010","Galle","Thawalama","Ela Ihala North","230E",759,370,389
"3118015","Galle","Thawalama","Kumburegoda","230C",1081,529,552
"3118020","Galle","Thawalama","Habarakada East","230",1067,539,528
"3118025","Galle","Thawalama","Habarakada West","230A",1011,491,520
"3118030","Galle","Thawalama","Kudugalpala","230D",1192,613,579
"3118035","Galle","Thawalama","Batahena","227A",359,190,169
"3118040","Galle","Thawalama","Thawalama North","227",1336,648,688
"3118045","Galle","Thawalama","Thawalama Mookalana","227C",928,457,471
"3118050","Galle","Thawalama","Thawalama South","227B",1101,518,583
"3118055","Galle","Thawalama","Hiniduma North","226",2371,1183,1188
"3118060","Galle","Thawalama","Hiniduma West","226B",633,323,310
"3118065","Galle","Thawalama","Hiniduma South","226A",965,475,490
"3118070","Galle","Thawalama","Malgalla","228",1460,689,771
"3118075","Galle","Thawalama","Halvitigala Colony Step  1","228B",486,237,249
"3118080","Galle","Thawalama","Halvitigala Step  2","228D",632,295,337
"3118085","Galle","Thawalama","Dammala Colony","228E",671,342,329
"3118090","Galle","Thawalama","Thalangalla East","228F",1429,709,720
"3118095","Galle","Thawalama","Thalangalla West","228G",354,176,178
"3118100","Galle","Thawalama","Malhathawa","226C",759,366,393
"3118105","Galle","Thawalama","Panangala West","225A",753,374,379
"3118110","Galle","Thawalama","Panangala North","225C",439,218,221
"3118115","Galle","Thawalama","Panangala East","225",700,358,342
"3118120","Galle","Thawalama","Thalangalla","228A",376,185,191
"3118125","Galle","Thawalama","Dammala","228C",712,358,354
"3118130","Galle","Thawalama","Opatha North","229D",780,401,379
"3118135","Galle","Thawalama","Opatha West","229C",864,401,463
"3118140","Galle","Thawalama","Koralegama","224A",687,319,368
"3118145","Galle","Thawalama","Eppala","224",754,366,388
"3118150","Galle","Thawalama","Gallandala","225B",574,269,305
"3118155","Galle","Thawalama","Opatha South","229E",1157,537,620
"3118160","Galle","Thawalama","Opatha East","229",622,317,305
"3118165","Galle","Thawalama","Weerapana North","229F",1104,514,590
"3118170","Galle","Thawalama","Weerapana West","229B",937,440,497
"3118175","Galle","Thawalama","Weerapana South","229G",1243,603,640
"3118180","Galle","Thawalama","Weerapana East","229A",661,332,329
"3121005","Galle","Neluwa","Danawala","232C",1136,588,548
"3121010","Galle","Neluwa","Mavita West","232E",769,383,386
"3121015","Galle","Neluwa","Batuwangala West","233A",800,401,399
"3121020","Galle","Neluwa","Kosmulla","233D",597,317,280
"3121025","Galle","Neluwa","Thambalagama","234D",239,117,122
"3121030","Galle","Neluwa","Ehelapitiya","233C",739,360,379
"3121035","Galle","Neluwa","Batuwangala","233",899,464,435
"3121040","Galle","Neluwa","Mavita East","232A",1022,503,519
"3121045","Galle","Neluwa","Koswatta","232G",539,261,278
"3121050","Galle","Neluwa","Ebalagedara North","231A",957,445,512
"3121055","Galle","Neluwa","Embalegedara South","231C",487,253,234
"3121060","Galle","Neluwa","Mawanana","231",983,482,501
"3121065","Galle","Neluwa","Neluwa","232",1218,640,578
"3121070","Galle","Neluwa","Pahala Maddegama","233B",645,323,322
"3121075","Galle","Neluwa","Maddegama East","233F",616,316,300
"3121080","Galle","Neluwa","Happitiya","234B",1278,650,628
"3121085","Galle","Neluwa","Madugeta","234",356,168,188
"3121090","Galle","Neluwa","Warukandeniya","234C",682,349,333
"3121095","Galle","Neluwa","Lankagama","234A",661,338,323
"3121100","Galle","Neluwa","Dellawa","237",624,318,306
"3121105","Galle","Neluwa","Miyanawathura","236",581,306,275
"3121110","Galle","Neluwa","Pannimulla","235B",864,432,432
"3121115","Galle","Neluwa","Ihala Maddegama","233E",632,326,306
"3121120","Galle","Neluwa","Medagama","232D",1380,661,719
"3121125","Galle","Neluwa","Pahala Gigummaduwa","231D",961,489,472
"3121130","Galle","Neluwa","Ihala Gigummaduwa","231B",1757,886,871
"3121135","Galle","Neluwa","Lelwala","232B",643,309,334
"3121140","Galle","Neluwa","Ihala Lelwala","232F",1164,577,587
"3121145","Galle","Neluwa","Panagoda","235",912,461,451
"3121150","Galle","Neluwa","Dewalegama West","235C",626,319,307
"3121155","Galle","Neluwa","Dewalegama East","235A",1273,654,619
"3121160","Galle","Neluwa","Millawa West","238B",582,280,302
"3121165","Galle","Neluwa","Ihala Millawa","238A",743,384,359
"3121170","Galle","Neluwa","Pahala Millawa","238",1275,634,641
"3124005","Galle","Nagoda","Thalgaswala","215C",2239,1045,1194
"3124010","Galle","Nagoda","Marakanda","214D",745,356,389
"3124015","Galle","Nagoda","Malamura","214A",828,393,435
"3124020","Galle","Nagoda","Aluth Thanayamgoda Pahala West","215B",879,426,453
"3124025","Galle","Nagoda","Mapalagama","215A",882,421,461
"3124030","Galle","Nagoda","Aluth Thanayamgoda Pahala","215",912,420,492
"3124035","Galle","Nagoda","Aluth Thanayamgoda Ihala South","214C",411,187,224
"3124040","Galle","Nagoda","Aluth Thanayamgoda Ihala","214",740,359,381
"3124045","Galle","Nagoda","Ketagoda South","214B",646,300,346
"3124050","Galle","Nagoda","Ketagoda North","214E",553,274,279
"3124055","Galle","Nagoda","Parana Thanayamgoda","213",632,306,326
"3124060","Galle","Nagoda","Parana Thanayamgoda Central","213B",1160,550,610
"3124065","Galle","Nagoda","Parana Thanayamgoda Pahala","213A",983,456,527
"3124070","Galle","Nagoda","Gonalagoda East","217B",575,284,291
"3124075","Galle","Nagoda","Gonalagoda","217",495,226,269
"3124080","Galle","Nagoda","Gammeddegoda","217A",940,447,493
"3124085","Galle","Nagoda","Gammeddegoda South","217C",924,436,488
"3124090","Galle","Nagoda","Nagoda Ihala","216A",737,330,407
"3124095","Galle","Nagoda","Nagoda","216",952,487,465
"3124100","Galle","Nagoda","Kurupanawa","216B",779,370,409
"3124105","Galle","Nagoda","Gonadeniya","210A",993,465,528
"3124110","Galle","Nagoda","Ukovita North","218C",935,470,465
"3124115","Galle","Nagoda","Udugama West","218",899,449,450
"3124120","Galle","Nagoda","Udugama North","219C",1061,541,520
"3124125","Galle","Nagoda","Homadola","219A",2202,1081,1121
"3124130","Galle","Nagoda","Udugama East","219",910,457,453
"3124135","Galle","Nagoda","Udugama","218B",1121,540,581
"3124140","Galle","Nagoda","Ukovita","218D",1280,635,645
"3124145","Galle","Nagoda","Gonadeniya South","210E",955,460,495
"3124150","Galle","Nagoda","Udalamatta East","210C",772,362,410
"3124155","Galle","Nagoda","Udalamatta North","210",1316,616,700
"3124160","Galle","Nagoda","Keppitiyagoda","212",1644,783,861
"3124165","Galle","Nagoda","Udawelivitiya","194",400,197,203
"3124170","Galle","Nagoda","Udawelivitithalawa East","194C",822,389,433
"3124175","Galle","Nagoda","Udawelivitithalawa","194A",904,455,449
"3124180","Galle","Nagoda","Udawelivitiya West","194B",614,290,324
"3124185","Galle","Nagoda","Keppitiyagoda North","212A",1101,509,592
"3124190","Galle","Nagoda","Budapanagama","211A",858,416,442
"3124195","Galle","Nagoda","Unanvitiya","211",603,292,311
"3124200","Galle","Nagoda","Unanvitiya East","211B",738,363,375
"3124205","Galle","Nagoda","Urala North","222",936,467,469
"3124210","Galle","Nagoda","Urala Pahala","222C",938,468,470
"3124215","Galle","Nagoda","Yatalamatta","209",1654,801,853
"3124220","Galle","Nagoda","Yatalamatta East","209A",1429,684,745
"3124225","Galle","Nagoda","Udalamatta South","210B",1196,589,607
"3124230","Galle","Nagoda","Udugama South","218A",1096,505,591
"3124235","Galle","Nagoda","Udugama Central","219B",1503,740,763
"3124240","Galle","Nagoda","Aluthwatta","219D",2208,1102,1106
"3124245","Galle","Nagoda","Hangaranwala","210D",1424,692,732
"3124250","Galle","Nagoda","Yatalamatta West","209B",1551,731,820
"3124255","Galle","Nagoda","Urala Central","222B",904,430,474
"3124260","Galle","Nagoda","Urala South","222A",1161,561,600
"3124265","Galle","Nagoda","Urala East","222D",689,323,366
"3127005","Galle","Baddegama","Wavulagala","199B",890,409,481
"3127010","Galle","Baddegama","Halpathota Central","199A",2674,1279,1395
"3127015","Galle","Baddegama","Halpathota","199",814,412,402
"3127020","Galle","Baddegama","Baddegama Town","184B",1102,541,561
"3127025","Galle","Baddegama","Baddegama North","184",920,448,472
"3127030","Galle","Baddegama","Nayapamula","184A",738,352,386
"3127035","Galle","Baddegama","Kotagoda","184C",677,326,351
"3127040","Galle","Baddegama","Hemmeliya","188",1131,556,575
"3127045","Galle","Baddegama","Ellakanda Wathurawa","186C",1079,516,563
"3127050","Galle","Baddegama","Baddegama East","186",920,448,472
"3127055","Galle","Baddegama","Yahaladoowa","186B",596,297,299
"3127060","Galle","Baddegama","Baddegama South","198A",2487,1171,1316
"3127065","Galle","Baddegama","Gothatuwa","198B",1069,514,555
"3127070","Galle","Baddegama","Majuwana","202",614,292,322
"3127075","Galle","Baddegama","Weweldeniya","201C",492,244,248
"3127080","Galle","Baddegama","Keradewala","201",737,343,394
"3127085","Galle","Baddegama","Madoldoowa","201B",553,273,280
"3127090","Galle","Baddegama","Bataketiya","201D",578,272,306
"3127095","Galle","Baddegama","Ganegama North","198",1002,506,496
"3127100","Galle","Baddegama","Sandarawala","220B",735,348,387
"3127105","Galle","Baddegama","Boralukada","187",795,353,442
"3127110","Galle","Baddegama","Mahahengoda","187B",1230,607,623
"3127115","Galle","Baddegama","Weihena","186D",1380,651,729
"3127120","Galle","Baddegama","Mahalapitiya","188A",1031,472,559
"3127125","Galle","Baddegama","Polgahavila","191B",710,358,352
"3127130","Galle","Baddegama","Indurupathvila","186A",1170,553,617
"3127135","Galle","Baddegama","Thilaka Udagama","187C",514,251,263
"3127140","Galle","Baddegama","Pilagoda","187A",473,230,243
"3127145","Galle","Baddegama","Ganegama East","220A",1841,838,1003
"3127150","Galle","Baddegama","Ganegama South","220",1068,509,559
"3127155","Galle","Baddegama","Ganegama West","220C",810,385,425
"3127160","Galle","Baddegama","Lelkada","202A",762,348,414
"3127165","Galle","Baddegama","Ginimellagaha West","201A",1498,699,799
"3127170","Galle","Baddegama","Ginimellagaha East","203",1059,488,571
"3127175","Galle","Baddegama","Dodangoda","203B",433,204,229
"3127180","Galle","Baddegama","Thelikada","204",1102,551,551
"3127185","Galle","Baddegama","Walpita North","206",1525,741,784
"3127190","Galle","Baddegama","Keembiela","206C",1446,724,722
"3127195","Galle","Baddegama","Kohombanadeniya","208C",1540,734,806
"3127200","Galle","Baddegama","Kasideniya","208A",1020,473,547
"3127205","Galle","Baddegama","Kirindalahena","191D",636,307,329
"3127210","Galle","Baddegama","Pahala Lelwala","191",1347,645,702
"3127215","Galle","Baddegama","Ihala Lelwala","190",1272,610,662
"3127220","Galle","Baddegama","Kumbalamalahena","190A",691,313,378
"3127225","Galle","Baddegama","Wanduramba","221",1208,581,627
"3127230","Galle","Baddegama","Gulugahakanda","221B",1215,578,637
"3127235","Galle","Baddegama","Panvila","190B",923,450,473
"3127240","Galle","Baddegama","Kokawala","191A",1329,625,704
"3127245","Galle","Baddegama","Pahala Keembiya","208",593,279,314
"3127250","Galle","Baddegama","Warakapitikanda","208B",611,282,329
"3127255","Galle","Baddegama","Adurathvila","206E",2080,1021,1059
"3127260","Galle","Baddegama","Walpita South","206A",1127,538,589
"3127265","Galle","Baddegama","Balagoda","206B",884,432,452
"3127270","Galle","Baddegama","Ginimellagaha South","203A",1038,512,526
"3127275","Galle","Baddegama","Pituwalgoda","203C",559,263,296
"3127280","Galle","Baddegama","Thelikada Nagaraya","204A",446,199,247
"3127285","Galle","Baddegama","Horagampita Central","205A",854,386,468
"3127290","Galle","Baddegama","Gonapura","206D",1176,554,622
"3127295","Galle","Baddegama","Horagampita","205",734,336,398
"3127300","Galle","Baddegama","Meda Keembiya","200",1671,773,898
"3127305","Galle","Baddegama","Deiyandara","191 C",1145,524,621
"3127310","Galle","Baddegama","Wanduramba South","221A",1164,569,595
"3127315","Galle","Baddegama","Thalawa","189B",723,356,367
"3127320","Galle","Baddegama","Mabotuwana","189",2020,943,1077
"3127325","Galle","Baddegama","Nattewela","189A",1409,652,757
"3127330","Galle","Baddegama","Thiruwanaketiya","200C",857,434,423
"3127335","Galle","Baddegama","Pitiharawa","200B",1263,589,674
"3127340","Galle","Baddegama","Meda Keembiya East","200A",1480,682,798
"3127345","Galle","Baddegama","Ihala Keembiya South","207A",1719,817,902
"3127350","Galle","Baddegama","Ihala Keembiya","207",1619,791,828
"3130005","Galle","Welivitiya-Divithura","Ethkandura","223",2112,1018,1094
"3130010","Galle","Welivitiya-Divithura","Old Colony","223C",1682,799,883
"3130015","Galle","Welivitiya-Divithura","Thanabaddegama","223B",1190,564,626
"3130020","Galle","Welivitiya-Divithura","Maddevila","193B",1217,587,630
"3130025","Galle","Welivitiya-Divithura","Miriswatta","193F",769,400,369
"3130030","Galle","Welivitiya-Divithura","Nambara Atta","193C",1070,488,582
"3130035","Galle","Welivitiya-Divithura","Divithura East","223A",1704,755,949
"3130040","Galle","Welivitiya-Divithura","Polgahavila","94B",1463,682,781
"3130045","Galle","Welivitiya-Divithura","Divithura","193",1519,741,778
"3130050","Galle","Welivitiya-Divithura","Ampegama","192",3557,1695,1862
"3130055","Galle","Welivitiya-Divithura","Hamingala","193D",1321,667,654
"3130060","Galle","Welivitiya-Divithura","Nugethota","193E",1493,691,802
"3130065","Galle","Welivitiya-Divithura","Agaliya","197",1419,683,736
"3130070","Galle","Welivitiya-Divithura","Divithura South","193A",1973,938,1035
"3130075","Galle","Welivitiya-Divithura","Galahenkanda","192A",1985,944,1041
"3130080","Galle","Welivitiya-Divithura","Kuttiyawatta","94C",599,277,322
"3130085","Galle","Welivitiya-Divithura","Pathawelivitiya North","196B",1043,507,536
"3130090","Galle","Welivitiya-Divithura","Waduwelivitiya North","196C",1376,664,712
"3130095","Galle","Welivitiya-Divithura","Pathawelivitiya","196",803,388,415
"3130100","Galle","Welivitiya-Divithura","Waduwelivitiya","196A",1052,500,552
"3133005","Galle","Ambalangoda","Heppumulla","83A",1132,537,595
"3133010","Galle","Ambalangoda","Patabendimulla","85",1948,897,1051
"3133015","Galle","Ambalangoda","Karittakanda","83",1282,586,696
"3133020","Galle","Ambalangoda","Kaluwadumulla","86A",1343,642,701
"3133025","Galle","Ambalangoda","Okanda","86E",680,341,339
"3133030","Galle","Ambalangoda","Keraminiya","86B",1704,821,883
"3133035","Galle","Ambalangoda","Polwatta","86",1479,685,794
"3133040","Galle","Ambalangoda","Thalgasgoda","86D",2471,1227,1244
"3133045","Galle","Ambalangoda","Thilakapura","81A",2982,1456,1526
"3133050","Galle","Ambalangoda","Thanipolgahalanga","75J",1027,499,528
"3133055","Galle","Ambalangoda","Batapola Central","75B",4210,2014,2196
"3133060","Galle","Ambalangoda","Kondagala","75K",1316,631,685
"3133065","Galle","Ambalangoda","Batapola North","75C",2142,1032,1110
"3133070","Galle","Ambalangoda","Kobeithuduwa","75I",1635,796,839
"3133075","Galle","Ambalangoda","Godahena","81",1556,740,816
"3133080","Galle","Ambalangoda","Poramba","86C",1600,742,858
"3133085","Galle","Ambalangoda","Vilegoda","84",1596,740,856
"3133090","Galle","Ambalangoda","Paniyandoowa","84A",1522,688,834
"3133095","Galle","Ambalangoda","Hirewatta","82A",1426,687,739
"3133100","Galle","Ambalangoda","Maha Ambalangoda","82",1807,841,966
"3133105","Galle","Ambalangoda","Batadoowa","75F",1265,602,663
"3133110","Galle","Ambalangoda","Batapola West","75",1360,644,716
"3133115","Galle","Ambalangoda","Batapola South","75D",1393,659,734
"3133120","Galle","Ambalangoda","Dorala","75G",1221,569,652
"3133125","Galle","Ambalangoda","Batapola East","75A",2042,1001,1041
"3133130","Galle","Ambalangoda","Polhunnawa","75H",1914,981,933
"3133135","Galle","Ambalangoda","Nawagama","75E",1605,793,812
"3133140","Galle","Ambalangoda","Nindana","74",1314,641,673
"3133145","Galle","Ambalangoda","Lewdoowa","74A",1205,584,621
"3133150","Galle","Ambalangoda","Udakerewa","73B",1349,649,700
"3133155","Galle","Ambalangoda","Domanvila","74B",697,331,366
"3133160","Galle","Ambalangoda","Diddeliya","73A",1627,805,822
"3133165","Galle","Ambalangoda","Eranavila","73D",1189,580,609
"3133170","Galle","Ambalangoda","Meetiyagoda","73",2200,1048,1152
"3133175","Galle","Ambalangoda","Metiwala","68",880,412,468
"3133180","Galle","Ambalangoda","Walakada","68B",842,401,441
"3134005","Galle","Gonapinuwala","Karuwalabedda","73C",645,312,333
"3134010","Galle","Gonapinuwala","Manampita","66A",1464,714,750
"3134015","Galle","Gonapinuwala","Dangaragaha Udumulla","66G",547,265,282
"3134020","Galle","Gonapinuwala","Banwelgodella","66C",1086,509,577
"3134025","Galle","Gonapinuwala","Eriyagahamulla","66H",334,144,190
"3134030","Galle","Gonapinuwala","Aluthwala","66",1170,539,631
"3134035","Galle","Gonapinuwala","Mahagangoda","66F",875,406,469
"3134040","Galle","Gonapinuwala","Kirindiela","68A",1122,520,602
"3134045","Galle","Gonapinuwala","Thilakagama","66E",1318,627,691
"3134050","Galle","Gonapinuwala","Henagoda","66D",1109,530,579
"3134055","Galle","Gonapinuwala","Gonapeenuwala Central","60B",1838,869,969
"3134060","Galle","Gonapinuwala","Woodland Watta","60C",1604,737,867
"3134065","Galle","Gonapinuwala","Berathuduwa","66B",562,244,318
"3134070","Galle","Gonapinuwala","Hikkaduwa East","59A",1335,691,644
"3134075","Galle","Gonapinuwala","Arachchikanda","59A/1",2424,1149,1275
"3134080","Galle","Gonapinuwala","Gonapeenuwala East","60",1004,473,531
"3134085","Galle","Gonapinuwala","Gonapeenuwala West","60A",1304,623,681
"3134090","Galle","Gonapinuwala","Dodamkahavila","60D",1583,712,871
"3134095","Galle","Gonapinuwala","Kaluwagaha Colony","60E",431,197,234
"3136005","Galle","Hikkaduwa","Urawatta","80",983,502,481
"3136010","Galle","Hikkaduwa","Dewagoda West","80C",619,299,320
"3136015","Galle","Hikkaduwa","Dewagoda East","80B",1235,588,647
"3136020","Galle","Hikkaduwa","Deldoowa","80D",367,183,184
"3136025","Galle","Hikkaduwa","Idanthota","80A",1914,889,1025
"3136030","Galle","Hikkaduwa","Kuleegoda West","78",710,339,371
"3136035","Galle","Hikkaduwa","Galagoda East","78A",2633,1265,1368
"3136040","Galle","Hikkaduwa","Galagoda West","78C",734,368,366
"3136045","Galle","Hikkaduwa","Kuleegoda East","78B",741,369,372
"3136050","Galle","Hikkaduwa","Wellabada","79",1280,654,626
"3136055","Galle","Hikkaduwa","Usmudulawa","79A",1640,768,872
"3136060","Galle","Hikkaduwa","Wenamulla","77",1106,547,559
"3136065","Galle","Hikkaduwa","Dimbuldoowa","77B",992,483,509
"3136070","Galle","Hikkaduwa","Andurangoda","77A",893,435,458
"3136075","Galle","Hikkaduwa","Galdoowa","72A",764,385,379
"3136080","Galle","Hikkaduwa","Akurala","76",900,437,463
"3136085","Galle","Hikkaduwa","Akurala North","76B",304,156,148
"3136090","Galle","Hikkaduwa","Akurala South","76A",301,145,156
"3136095","Galle","Hikkaduwa","Uduwaragoda North","71A",494,229,265
"3136100","Galle","Hikkaduwa","Uduwaragoda South","71",520,250,270
"3136105","Galle","Hikkaduwa","Kahawa","69",1494,699,795
"3136110","Galle","Hikkaduwa","Weragoda","72",933,445,488
"3136115","Galle","Hikkaduwa","Delmar Colony","72C",486,251,235
"3136120","Galle","Hikkaduwa","Harannagala","72B",326,151,175
"3136125","Galle","Hikkaduwa","Godagama South","70",309,148,161
"3136130","Galle","Hikkaduwa","Godagama North","70A",393,178,215
"3136135","Galle","Hikkaduwa","Daluwathumulla","67C",516,246,270
"3136140","Galle","Hikkaduwa","Thelwatta","67",1012,489,523
"3136145","Galle","Hikkaduwa","Pereliya North","67A",574,271,303
"3136150","Galle","Hikkaduwa","Pereliya South","67B",212,115,97
"3136155","Galle","Hikkaduwa","Seenigama","64A",422,212,210
"3136160","Galle","Hikkaduwa","Seenigama East","64",645,326,319
"3136165","Galle","Hikkaduwa","Malawenna","65",1812,855,957
"3136170","Galle","Hikkaduwa","Kalupe","62",1499,710,789
"3136175","Galle","Hikkaduwa","Udumulla","62A",1936,950,986
"3136180","Galle","Hikkaduwa","Medagoda","62B",757,368,389
"3136185","Galle","Hikkaduwa","Werellana","63",401,204,197
"3136190","Galle","Hikkaduwa","Thotagamuwa","61",1078,525,553
"3136195","Galle","Hikkaduwa","Wellawatta","59D",1250,626,624
"3136200","Galle","Hikkaduwa","Hikkaduwa Nagarikaya","59A",1149,560,589
"3136205","Galle","Hikkaduwa","Wavulagoda West","58",510,247,263
"3136210","Galle","Hikkaduwa","Wavulagoda East","58A",680,331,349
"3136215","Galle","Hikkaduwa","Hikkaduwa West","59",1435,695,740
"3136220","Galle","Hikkaduwa","Nakanda","59E",563,302,261
"3136225","Galle","Hikkaduwa","Hikkaduwa Central","59B",1241,592,649
"3136230","Galle","Hikkaduwa","Nalagasdeniya","59C",1296,618,678
"3136235","Galle","Hikkaduwa","Millagoda","57B",747,372,375
"3136240","Galle","Hikkaduwa","Pannamgoda","57A",693,333,360
"3136245","Galle","Hikkaduwa","Wewala","57",547,260,287
"3136250","Galle","Hikkaduwa","Narigama Wellabada","56A",1283,618,665
"3136255","Galle","Hikkaduwa","Narigama","56",382,167,215
"3136260","Galle","Hikkaduwa","Kuda Wewala","56B",915,434,481
"3136265","Galle","Hikkaduwa","Delgahadoowa","55B",1128,542,586
"3136270","Galle","Hikkaduwa","Katukoliha","55",1160,536,624
"3136275","Galle","Hikkaduwa","Thiranagama","54",706,339,367
"3136280","Galle","Hikkaduwa","Wellabada - Thiranagama","54A",629,299,330
"3136285","Galle","Hikkaduwa","Patuwatha","53",1189,585,604
"3136290","Galle","Hikkaduwa","Gammaduwatta","53A",1093,495,598
"3136295","Galle","Hikkaduwa","Hennathota","53B",1182,551,631
"3136300","Galle","Hikkaduwa","Pinkanda","55A",943,438,505
"3136305","Galle","Hikkaduwa","Handaudumulla","55C",1187,554,633
"3136310","Galle","Hikkaduwa","Thotavila","48A",1478,727,751
"3136315","Galle","Hikkaduwa","Mawadavila","49A",1612,751,861
"3136320","Galle","Hikkaduwa","Panvila Pahalagoda","49B",3049,1458,1591
"3136325","Galle","Hikkaduwa","Rejjipura","45E",1975,945,1030
"3136330","Galle","Hikkaduwa","Imbula","49",1815,845,970
"3136335","Galle","Hikkaduwa","Katudampe","48",1409,664,745
"3136340","Galle","Hikkaduwa","Dodandugoda","52A",1180,559,621
"3136345","Galle","Hikkaduwa","Modara Patuwatha","52",1942,940,1002
"3136350","Galle","Hikkaduwa","Dodandoowa","51",1180,528,652
"3136355","Galle","Hikkaduwa","Uduhalpitiya","51A",865,399,466
"3136360","Galle","Hikkaduwa","Karawegoda","50",603,262,341
"3136365","Galle","Hikkaduwa","Devinigoda","50A",1636,774,862
"3136370","Galle","Hikkaduwa","Bopagoda","50B",2016,944,1072
"3136375","Galle","Hikkaduwa","Kandegoda","46B",867,438,429
"3136380","Galle","Hikkaduwa","Ranapanadeniya","46A",1355,624,731
"3136385","Galle","Hikkaduwa","Mahahegoda","45",1051,490,561
"3136390","Galle","Hikkaduwa","Medawala","45B",435,209,226
"3136395","Galle","Hikkaduwa","Hegoda","45D",1182,591,591
"3136400","Galle","Hikkaduwa","Palanthriyagoda","45C",547,274,273
"3136405","Galle","Hikkaduwa","Maliduwa","45A",929,443,486
"3136410","Galle","Hikkaduwa","Rathna Udagama","44D",1116,537,579
"3136415","Galle","Hikkaduwa","Ganegoda","44B",1834,915,919
"3136420","Galle","Hikkaduwa","Rathgama Hegoda","46",824,448,376
"3136425","Galle","Hikkaduwa","Palliyapitiya","46C",922,434,488
"3136430","Galle","Hikkaduwa","Gammeddegoda","47",1055,524,531
"3136435","Galle","Hikkaduwa","Gammeddegoda East","47B",568,253,315
"3136440","Galle","Hikkaduwa","Gammeddegoda-Rajgama","47A",713,339,374
"3136445","Galle","Hikkaduwa","Owakanda","47C",1026,478,548
"3136450","Galle","Hikkaduwa","Kapumulugoda","44C",2650,1240,1410
"3136455","Galle","Hikkaduwa","Dolikanda","44E",958,461,497
"3136460","Galle","Hikkaduwa","Boossa","44",1604,784,820
"3136465","Galle","Hikkaduwa","Rupeewala","44A",841,375,466
"3136470","Galle","Hikkaduwa","Kedala","43A",1897,1113,784
"3136475","Galle","Hikkaduwa","Pitiwella South","42A",530,254,276
"3136480","Galle","Hikkaduwa","Pitiwella North","42",811,395,416
"3136485","Galle","Hikkaduwa","Kadurupe","43",1591,761,830
"3139005","Galle","Galle Four Gravets","Ukwatta East","108",662,311,351
"3139010","Galle","Galle Four Gravets","Ukwatta West","108B",1084,547,537
"3139015","Galle","Galle Four Gravets","Maha Hapugala","108A",3414,1671,1743
"3139020","Galle","Galle Four Gravets","Kurunduwatta","106",4200,1961,2239
"3139025","Galle","Galle Four Gravets","Welipitimodara","105",2891,1377,1514
"3139030","Galle","Galle Four Gravets","Ginthota West","103",1385,649,736
"3139035","Galle","Galle Four Gravets","Ginthota East","103A",1282,591,691
"3139040","Galle","Galle Four Gravets","Piyadigama","107",2155,1014,1141
"3139045","Galle","Galle Four Gravets","Bope North","107A",1010,491,519
"3139050","Galle","Galle Four Gravets","Bope East","119A",1915,952,963
"3139055","Galle","Galle Four Gravets","Kumbalwella North","96J",850,395,455
"3139060","Galle","Galle Four Gravets","Madawalamulla North","98A",3555,1701,1854
"3139065","Galle","Galle Four Gravets","Madawalamulla South","98",1216,560,656
"3139070","Galle","Galle Four Gravets","Deddugoda North","101C",2887,1334,1553
"3139075","Galle","Galle Four Gravets","Deddugoda South","101A",2730,1396,1334
"3139080","Galle","Galle Four Gravets","Maitipe","101",1875,868,1007
"3139085","Galle","Galle Four Gravets","Welipatha","101D",2043,980,1063
"3139090","Galle","Galle Four Gravets","Maligaspe","101E",983,479,504
"3139095","Galle","Galle Four Gravets","Dangedara East","97D",3222,1551,1671
"3139100","Galle","Galle Four Gravets","Dangedara West","98D",1834,821,1013
"3139105","Galle","Galle Four Gravets","Bataganvila","98B",1301,608,693
"3139110","Galle","Galle Four Gravets","Galwadugoda","96B",2960,1371,1589
"3139115","Galle","Galle Four Gravets","Richmond Kanda","96E",940,465,475
"3139120","Galle","Galle Four Gravets","Bope West","119",1758,877,881
"3139125","Galle","Galle Four Gravets","Siyambalagahawatta","102C",2220,1071,1149
"3139130","Galle","Galle Four Gravets","Dadalla East","102A",1370,676,694
"3139135","Galle","Galle Four Gravets","Dadalla West","102",1770,842,928
"3139140","Galle","Galle Four Gravets","Walawwatta","102B",1640,785,855
"3139145","Galle","Galle Four Gravets","Kumbalwella South","96",2083,990,1093
"3139150","Galle","Galle Four Gravets","Mahamodara","96A",1447,654,793
"3139155","Galle","Galle Four Gravets","Osanagoda","96I",1834,895,939
"3139160","Galle","Galle Four Gravets","Kandewatta","96F",2949,1322,1627
"3139165","Galle","Galle Four Gravets","Sanghamittapura","98C",998,470,528
"3139170","Galle","Galle Four Gravets","Madapathala","97B",2177,1011,1166
"3139175","Galle","Galle Four Gravets","Pokunawatta","97C",829,395,434
"3139180","Galle","Galle Four Gravets","Milidduwa","101B",3790,1808,1982
"3139185","Galle","Galle Four Gravets","Ettiligoda South","130",3054,1425,1629
"3139190","Galle","Galle Four Gravets","Makuluwa","99C",4602,2169,2433
"3139195","Galle","Galle Four Gravets","Pettigalawatta","99B",1237,596,641
"3139200","Galle","Galle Four Gravets","Thalapitiya","99A",5514,2648,2866
"3139205","Galle","Galle Four Gravets","Kongaha","97",1443,708,735
"3139210","Galle","Galle Four Gravets","Weliwatta","97A",2241,1073,1168
"3139215","Galle","Galle Four Gravets","Minuwangoda","96H",409,186,223
"3139220","Galle","Galle Four Gravets","Kaluwella","96C",2223,1414,809
"3139225","Galle","Galle Four Gravets","Cheena Koratuwa","96G",1051,531,520
"3139230","Galle","Galle Four Gravets","Fort","96D",1068,469,599
"3139235","Galle","Galle Four Gravets","Magalla","99",1869,865,1004
"3139240","Galle","Galle Four Gravets","Dewathura","99D",1355,625,730
"3139245","Galle","Galle Four Gravets","Katugoda","100",3326,1645,1681
"3139250","Galle","Galle Four Gravets","Dewata","100A",1098,553,545
"3142005","Galle","Bope-Poddala","Poddala","117",566,266,300
"3142010","Galle","Bope-Poddala","Pannamaga","117B",1088,473,615
"3142015","Galle","Bope-Poddala","Mulana West","111G",711,339,372
"3142020","Galle","Bope-Poddala","Mulana East","111F",607,291,316
"3142025","Galle","Bope-Poddala","Panvila","111B",1147,531,616
"3142030","Galle","Bope-Poddala","Narawala","111",544,261,283
"3142035","Galle","Bope-Poddala","Walawatta","111C",693,338,355
"3142040","Galle","Bope-Poddala","Magadeniya","111A",1846,889,957
"3142045","Galle","Bope-Poddala","Baswatta","111D",960,460,500
"3142050","Galle","Bope-Poddala","Addaragoda","111E",698,339,359
"3142055","Galle","Bope-Poddala","Meepawala","117A",1015,470,545
"3142060","Galle","Bope-Poddala","Penideniya","117C",605,280,325
"3142065","Galle","Bope-Poddala","Opatha","127B",976,462,514
"3142070","Galle","Bope-Poddala","Wakwella","121",1693,796,897
"3142075","Galle","Bope-Poddala","Niladeniya","123A",1978,1008,970
"3142080","Galle","Bope-Poddala","Hapugala","123",1516,787,729
"3142085","Galle","Bope-Poddala","Beraliyadola","123D",1273,629,644
"3142090","Galle","Bope-Poddala","Silvagewatta","124B",697,347,350
"3142095","Galle","Bope-Poddala","Uluvitike","127",954,448,506
"3142100","Galle","Bope-Poddala","Holuwagoda","126C",880,416,464
"3142105","Galle","Bope-Poddala","Labudoowa","114",1385,657,728
"3142110","Galle","Bope-Poddala","Kurunda Kanda","114B",1020,504,516
"3142115","Galle","Bope-Poddala","Kurunda","114C",658,323,335
"3142120","Galle","Bope-Poddala","Thotagoda","114A",866,410,456
"3142125","Galle","Bope-Poddala","Galketiya","126B",936,443,493
"3142130","Galle","Bope-Poddala","Godakanda","126",1407,686,721
"3142135","Galle","Bope-Poddala","Bangalawatta","127D",805,363,442
"3142140","Galle","Bope-Poddala","Bokaramullagoda","127C",738,333,405
"3142145","Galle","Bope-Poddala","Thunhiripana","124A",1663,807,856
"3142150","Galle","Bope-Poddala","Abeysundarawatta","123C",1480,731,749
"3142155","Galle","Bope-Poddala","Watareka East","120",2245,1035,1210
"3142160","Galle","Bope-Poddala","Pelawatta","123B",1370,634,736
"3142165","Galle","Bope-Poddala","Mampitiya","120A",1442,678,764
"3142170","Galle","Bope-Poddala","Kalegana South","125",1054,485,569
"3142175","Galle","Bope-Poddala","Kalegana North","125A",1035,508,527
"3142180","Galle","Bope-Poddala","Kithulampitiya","124",1759,832,927
"3142185","Galle","Bope-Poddala","Kahadoowawatta","124C",847,401,446
"3142190","Galle","Bope-Poddala","Navinna","127E",1238,577,661
"3142195","Galle","Bope-Poddala","Hirimburagama","127A",1479,712,767
"3142200","Galle","Bope-Poddala","Karapitiya","126A",2308,985,1323
"3142205","Galle","Bope-Poddala","Ambagahawatta","114D",1156,543,613
"3142210","Galle","Bope-Poddala","Kapuhempala","115",1347,628,719
"3142215","Galle","Bope-Poddala","Kerenvila","115A",656,307,349
"3142220","Galle","Bope-Poddala","Paliwathugoda","115B",990,451,539
"3145005","Galle","Akmeemana","Thalgasyaya","118A",1726,811,915
"3145010","Galle","Akmeemana","Niyagama","118B",1319,633,686
"3145015","Galle","Akmeemana","Ambagahavila","109E",1006,515,491
"3145020","Galle","Akmeemana","Ihalagoda East","109A",3560,1564,1996
"3145025","Galle","Akmeemana","Amalgama","109D",1284,642,642
"3145030","Galle","Akmeemana","Ketandola","155C",822,382,440
"3145035","Galle","Akmeemana","Hiyare North","155",899,443,456
"3145040","Galle","Akmeemana","Kandahena","155H",494,237,257
"3145045","Galle","Akmeemana","Welihena","155G",687,346,341
"3145050","Galle","Akmeemana","Kadurugashena","155F",1259,616,643
"3145055","Galle","Akmeemana","Hiyare East","155D",1191,582,609
"3145060","Galle","Akmeemana","Ihala Hiyare","155E",1345,635,710
"3145065","Galle","Akmeemana","Hiyare South","155A",951,447,504
"3145070","Galle","Akmeemana","Etambagasmulla","109G",697,336,361
"3145075","Galle","Akmeemana","Ihalagoda Colony","109F",1427,688,739
"3145080","Galle","Akmeemana","Ihalagoda South","109B",1668,776,892
"3145085","Galle","Akmeemana","Ihalagoda West","109",1110,524,586
"3145090","Galle","Akmeemana","Akmeemana","118C",994,504,490
"3145095","Galle","Akmeemana","Ganegoda","118",889,417,472
"3145100","Galle","Akmeemana","Ganegoda West","118D",662,303,359
"3145105","Galle","Akmeemana","Kirindagoda","112C",554,265,289
"3145110","Galle","Akmeemana","Badungoda Colony","109H",786,370,416
"3145115","Galle","Akmeemana","Badungoda","109C",1182,550,632
"3145120","Galle","Akmeemana","Pinnadoowa Colony","110C",1151,547,604
"3145125","Galle","Akmeemana","Weliketiya","110B",936,437,499
"3145130","Galle","Akmeemana","Halgasmulla","155B",1314,638,676
"3145135","Galle","Akmeemana","Amukotuwa","152A",1976,978,998
"3145140","Galle","Akmeemana","Nivithipitigoda","152C",859,410,449
"3145145","Galle","Akmeemana","Thalahitiyawa","152B",1260,615,645
"3145150","Galle","Akmeemana","Ankokkawala","110",1320,631,689
"3145155","Galle","Akmeemana","Pinnadoowa","110A",1834,863,971
"3145160","Galle","Akmeemana","Manavila","112",1441,671,770
"3145165","Galle","Akmeemana","Walahanduwa","112A",1539,718,821
"3145170","Galle","Akmeemana","Yakgaha","112B",921,424,497
"3145175","Galle","Akmeemana","Meegoda","135A",1257,603,654
"3145180","Galle","Akmeemana","Pilana","152",1517,761,756
"3145185","Galle","Akmeemana","Pedinnoruwa","135",873,413,460
"3145190","Galle","Akmeemana","Melegoda","135B",1578,729,849
"3145195","Galle","Akmeemana","Bambaragoda","134D",2457,1165,1292
"3145200","Galle","Akmeemana","Anangoda","113C",1305,607,698
"3145205","Galle","Akmeemana","Hinidumgoda","130C",1275,587,688
"3145210","Galle","Akmeemana","Kerenvila Colony","130F",1174,562,612
"3145215","Galle","Akmeemana","Haliwala","130B",2963,1451,1512
"3145220","Galle","Akmeemana","Ettiligoda North","130A",886,397,489
"3145225","Galle","Akmeemana","Ambalanwatta","130E",1187,549,638
"3145230","Galle","Akmeemana","Jambuketiya","130D",951,439,512
"3145235","Galle","Akmeemana","Batadoowa","113",1975,913,1062
"3145240","Galle","Akmeemana","Kaduruduwa","134B",1651,780,871
"3145245","Galle","Akmeemana","Panagamuwa","134A",1004,497,507
"3145250","Galle","Akmeemana","Galgamuwa","135C",1339,646,693
"3145255","Galle","Akmeemana","Divulana Colony","135D",814,377,437
"3145260","Galle","Akmeemana","Handugoda","135E",1088,542,546
"3145265","Galle","Akmeemana","Kalahe","134",897,427,470
"3145270","Galle","Akmeemana","Wanchawala","134E",798,369,429
"3145275","Galle","Akmeemana","Attaragoda","134C",728,338,390
"3145280","Galle","Akmeemana","Nugadoowa","113B",2251,1093,1158
"3145285","Galle","Akmeemana","Batadoowa West","113A",1317,590,727
"3145290","Galle","Akmeemana","Thalpegoda","133E",779,376,403
"3145295","Galle","Akmeemana","Yatagama","133B",751,376,375
"3145300","Galle","Akmeemana","Rathkindagoda","133D",1077,502,575
"3145305","Galle","Akmeemana","Metaramba","133",1417,646,771
"3145310","Galle","Akmeemana","Thalpe North","133A",682,321,361
"3145315","Galle","Akmeemana","Nagahawatta","133C",722,332,390
"3148005","Galle","Yakkalamulla","Nawala","177B",1091,529,562
"3148010","Galle","Yakkalamulla","Thellambura North","177E",512,265,247
"3148015","Galle","Yakkalamulla","Nakiyadeniya","179A",2584,1250,1334
"3148020","Galle","Yakkalamulla","Nakiyadeniya North","179C",1124,504,620
"3148025","Galle","Yakkalamulla","Wattehena","179B",649,324,325
"3148030","Galle","Yakkalamulla","Wathogala","179D",950,447,503
"3148035","Galle","Yakkalamulla","Moraketiya","178B",1612,808,804
"3148040","Galle","Yakkalamulla","Gahalakoladeniya","178F",1042,509,533
"3148045","Galle","Yakkalamulla","Udumalagala","179",1038,488,550
"3148050","Galle","Yakkalamulla","Ihala Nakiyadeniya","179E",862,407,455
"3148055","Galle","Yakkalamulla","Pahala Thellambura","177",1138,545,593
"3148060","Galle","Yakkalamulla","Ihala Thellambura","177A",1372,650,722
"3148065","Galle","Yakkalamulla","Nevungala","176A",1072,534,538
"3148070","Galle","Yakkalamulla","Nevungala South","176D",800,373,427
"3148075","Galle","Yakkalamulla","Kottawa","176",1283,621,662
"3148080","Galle","Yakkalamulla","Thellambura South","177F",874,406,468
"3148085","Galle","Yakkalamulla","Yakkalamulla East","177D",704,350,354
"3148090","Galle","Yakkalamulla","Nabadawa","178A",1296,653,643
"3148095","Galle","Yakkalamulla","Yatamalagala","178D",648,312,336
"3148100","Galle","Yakkalamulla","Ihala Karagoda","178E",800,384,416
"3148105","Galle","Yakkalamulla","Magedara North","182B",668,326,342
"3148110","Galle","Yakkalamulla","Magedara East","182D",1555,773,782
"3148115","Galle","Yakkalamulla","Ella Ihala","182C",1517,749,768
"3148120","Galle","Yakkalamulla","Magedara","182",773,382,391
"3148125","Galle","Yakkalamulla","Uduwella","182A",1144,564,580
"3148130","Galle","Yakkalamulla","Karagoda","178",923,453,470
"3148135","Galle","Yakkalamulla","Pahala Karagoda","178C",749,382,367
"3148140","Galle","Yakkalamulla","Polpagoda","180",984,457,527
"3148145","Galle","Yakkalamulla","Beranagoda","180A",1485,729,756
"3148150","Galle","Yakkalamulla","Yakkalamulla","177C",1392,673,719
"3148155","Galle","Yakkalamulla","Kottawa East","176C",1049,469,580
"3148160","Galle","Yakkalamulla","Kottawa West","176B",1713,846,867
"3148165","Galle","Yakkalamulla","Thalgampala North","183B",969,471,498
"3148170","Galle","Yakkalamulla","Udubettawa","183A",723,347,376
"3148175","Galle","Yakkalamulla","Udubettawa West","183C",790,383,407
"3148180","Galle","Yakkalamulla","Thalgampala","183",961,436,525
"3148185","Galle","Yakkalamulla","Hiriyamalkumbura","180C",933,448,485
"3148190","Galle","Yakkalamulla","Polpagoda West","180B",956,442,514
"3148195","Galle","Yakkalamulla","Kaludiyawala","180D",642,314,328
"3148200","Galle","Yakkalamulla","Badungala","181C",765,358,407
"3148205","Galle","Yakkalamulla","Rathamalaketiya","182E",712,351,361
"3148210","Galle","Yakkalamulla","Welendawa","181B",1211,567,644
"3148215","Galle","Yakkalamulla","Pahala Walpola","181A",1094,515,579
"3148220","Galle","Yakkalamulla","Ihala Walpala","181",787,379,408
"3151005","Galle","Imaduwa","Pituwalahena","174D",508,242,266
"3151010","Galle","Imaduwa","Mayakaduwa","174A",829,384,445
"3151015","Galle","Imaduwa","Kabaragala","153D",1108,538,570
"3151020","Galle","Imaduwa","Danduwana","153A",511,233,278
"3151025","Galle","Imaduwa","Hatangala","154A",494,249,245
"3151030","Galle","Imaduwa","Bedipita","154D",1061,517,544
"3151035","Galle","Imaduwa","Puswelkada","174B",802,387,415
"3151040","Galle","Imaduwa","Ihala Kombala","174C",825,414,411
"3151045","Galle","Imaduwa","Kombala","174",831,397,434
"3151050","Galle","Imaduwa","Imaduwa Athireka","172A",733,355,378
"3151055","Galle","Imaduwa","Paragoda","173",1215,538,677
"3151060","Galle","Imaduwa","Wathawana","173C",939,432,507
"3151065","Galle","Imaduwa","Hawpe North","175B",1048,493,555
"3151070","Galle","Imaduwa","Hawpe","175",1560,746,814
"3151075","Galle","Imaduwa","Angulugaha","154",1244,621,623
"3151080","Galle","Imaduwa","Rangoda","153B",563,275,288
"3151085","Galle","Imaduwa","Dorape","153",943,435,508
"3151090","Galle","Imaduwa","Welikonda","153C",1107,505,602
"3151095","Galle","Imaduwa","Pelawatta","154C",1093,525,568
"3151100","Galle","Imaduwa","Polhena","154B",1717,805,912
"3151105","Galle","Imaduwa","Kahanda","167",976,454,522
"3151110","Galle","Imaduwa","Kahanda Athireka 1","167A",859,395,464
"3151115","Galle","Imaduwa","Godaudamandiya","175C",736,341,395
"3151120","Galle","Imaduwa","Mawella","175A",409,203,206
"3151125","Galle","Imaduwa","Deegoda Athireka 01","173B",783,365,418
"3151130","Galle","Imaduwa","Imaduwa","172",1114,554,560
"3151135","Galle","Imaduwa","Hettigoda","169A",1072,496,576
"3151140","Galle","Imaduwa","Deegoda","173A",781,377,404
"3151145","Galle","Imaduwa","Kalugalagoda","171B",528,249,279
"3151150","Galle","Imaduwa","Ihala Mawella","175D",760,358,402
"3151155","Galle","Imaduwa","Thittagalla East","166",1111,524,587
"3151160","Galle","Imaduwa","Ampavila","166D",1233,587,646
"3151165","Galle","Imaduwa","Malalgodapitiya","171",567,282,285
"3151170","Galle","Imaduwa","Dikkumbura","165",1645,788,857
"3151175","Galle","Imaduwa","Kodagoda South","169",932,444,488
"3151180","Galle","Imaduwa","Kodagoda East","171A",1221,574,647
"3151185","Galle","Imaduwa","Horadugoda","168",1160,536,624
"3151190","Galle","Imaduwa","Ellalagoda","170A",845,413,432
"3151195","Galle","Imaduwa","Andugoda","170",1643,766,877
"3151200","Galle","Imaduwa","Panugalgoda","165B",1547,735,812
"3151205","Galle","Imaduwa","Indurannavila","165A",1929,932,997
"3151210","Galle","Imaduwa","Atanikitha","166B",2915,1392,1523
"3151215","Galle","Imaduwa","Thittagalla West","166A",983,433,550
"3154005","Galle","Habaraduwa","Yaddehimulla","137B",584,317,267
"3154010","Galle","Habaraduwa","Bonavistawa","137C",1152,564,588
"3154015","Galle","Habaraduwa","Unawatuna West","137",813,364,449
"3154020","Galle","Habaraduwa","Unawatuna East","136",1838,860,978
"3154025","Galle","Habaraduwa","Maharamba","136A",843,407,436
"3154030","Galle","Habaraduwa","Dalawella","132A",677,329,348
"3154035","Galle","Habaraduwa","Unawatuna Central","137A",928,448,480
"3154040","Galle","Habaraduwa","Thalpe South","132",823,402,421
"3154045","Galle","Habaraduwa","Heenatigala South","148",830,411,419
"3154050","Galle","Habaraduwa","Wellethota","148B",1660,801,859
"3154055","Galle","Habaraduwa","Halloluwagoda","143A",971,459,512
"3154060","Galle","Habaraduwa","Handugoda","143B",794,390,404
"3154065","Galle","Habaraduwa","Dodampe","143",788,375,413
"3154070","Galle","Habaraduwa","Attaragoda","142A",1131,518,613
"3154075","Galle","Habaraduwa","Thalpe East","148A",1200,580,620
"3154080","Galle","Habaraduwa","Kahawennagama","148C",1240,598,642
"3154085","Galle","Habaraduwa","Morampitigoda","144B",1125,544,581
"3154090","Galle","Habaraduwa","Uragasgoda","144F",816,400,416
"3154095","Galle","Habaraduwa","Pitidoowa","142",1067,501,566
"3154100","Galle","Habaraduwa","Meepe","151A",1713,820,893
"3154105","Galle","Habaraduwa","Bogahamulugoda","151C",743,364,379
"3154110","Galle","Habaraduwa","Happawana","151",685,317,368
"3154115","Galle","Habaraduwa","Annasiwathugoda","151B",959,446,513
"3154120","Galle","Habaraduwa","Harumalgoda West","149",1490,709,781
"3154125","Galle","Habaraduwa","Lanumodara","151D",1359,651,708
"3154130","Galle","Habaraduwa","Liyanagoda","144",879,445,434
"3154135","Galle","Habaraduwa","Katukurunda","144C",1832,850,982
"3154140","Galle","Habaraduwa","Harumalgoda Central","149B",1151,538,613
"3154145","Galle","Habaraduwa","Godawatta","149C",1366,673,693
"3154150","Galle","Habaraduwa","Harumalgoda East","149A",1856,888,968
"3154155","Galle","Habaraduwa","Koggala Athireka I","144D",1474,664,810
"3154160","Galle","Habaraduwa","Koggala Athireka II","144E",1800,807,993
"3154165","Galle","Habaraduwa","Koggala","144A",900,385,515
"3154170","Galle","Habaraduwa","Kathaluwa West","162",754,370,384
"3154175","Galle","Habaraduwa","Atadahewathugoda","162A",986,448,538
"3154180","Galle","Habaraduwa","Kathaluwa East","164",1283,598,685
"3154185","Galle","Habaraduwa","Welhengoda","164D",852,381,471
"3154190","Galle","Habaraduwa","Kathaluwa Central","164B",824,364,460
"3154195","Galle","Habaraduwa","Alawathuthisgoda","164G",751,357,394
"3154200","Galle","Habaraduwa","Pelessa","166C",1208,597,611
"3154205","Galle","Habaraduwa","Korahedigoda","159B",1510,708,802
"3154210","Galle","Habaraduwa","Ahangama Nakanda","159",1320,621,699
"3154215","Galle","Habaraduwa","Kalapuwa","159D",560,265,295
"3154220","Galle","Habaraduwa","Ahangamgoda","159C",921,430,491
"3154225","Galle","Habaraduwa","Danduhela","164C",986,488,498
"3154230","Galle","Habaraduwa","Meegahagoda","164A",1271,618,653
"3154235","Galle","Habaraduwa","Kahawathugoda","164E",1431,666,765
"3154240","Galle","Habaraduwa","Meliyagoda","164F",1599,802,797
"3154245","Galle","Habaraduwa","Piyadigama West","161",1000,476,524
"3154250","Galle","Habaraduwa","Wadugegoda","161B",573,281,292
"3154255","Galle","Habaraduwa","Karandugoda","161A",816,370,446
"3154260","Galle","Habaraduwa","Kalahegoda","160B",375,175,200
"3154265","Galle","Habaraduwa","Dommannegoda","160A",1125,508,617
"3154270","Galle","Habaraduwa","Piyadigama East","160",606,293,313
"3154275","Galle","Habaraduwa","Ahangama Central","157",1021,492,529
"3154280","Galle","Habaraduwa","Digaredda","159A",621,309,312
"3154285","Galle","Habaraduwa","Thaldoowa","156B",871,398,473
"3154290","Galle","Habaraduwa","Ahangama East","156",933,444,489
"3154295","Galle","Habaraduwa","Goviyapana","156A",705,309,396
"3203005","Matara","Pitabeddara","Kalubovitiyana","259",928,459,469
"3203010","Matara","Pitabeddara","Galabada","259D",1093,538,555
"3203015","Matara","Pitabeddara","Ambewela","259C",1444,750,694
"3203020","Matara","Pitabeddara","Dangala West","259B",1483,749,734
"3203025","Matara","Pitabeddara","Banagala East","260",1445,706,739
"3203030","Matara","Pitabeddara","Dangala East","259A",1546,751,795
"3203035","Matara","Pitabeddara","Banagala West","260A",1147,553,594
"3203040","Matara","Pitabeddara","Edandukitha West","258C",902,442,460
"3203045","Matara","Pitabeddara","Edandukitha East","258A",941,474,467
"3203050","Matara","Pitabeddara","Alapaladeniya South","258B",1068,519,549
"3203055","Matara","Pitabeddara","Alapaladeniya North","258",1140,575,565
"3203060","Matara","Pitabeddara","Kiriwelkele North","261F",2082,1011,1071
"3203065","Matara","Pitabeddara","Rambukana West","262G",1388,693,695
"3203070","Matara","Pitabeddara","Kodikaragoda West","262C",1512,741,771
"3203075","Matara","Pitabeddara","Kodikaragoda East","262H",1323,635,688
"3203080","Matara","Pitabeddara","Weliwa","262A",1983,969,1014
"3203085","Matara","Pitabeddara","Rambukana East","262B",1160,544,616
"3203090","Matara","Pitabeddara","Thalapekumbura","261G",1439,707,732
"3203095","Matara","Pitabeddara","Kudagalahena","261H",1333,639,694
"3203100","Matara","Pitabeddara","Kiriwelkele South","261C",1366,661,705
"3203105","Matara","Pitabeddara","Derangala","261B",1809,882,927
"3203110","Matara","Pitabeddara","Thennahena","261E",1347,641,706
"3203115","Matara","Pitabeddara","Gorakawela","261",1272,589,683
"3203120","Matara","Pitabeddara","Siyambalagoda West","263",1295,613,682
"3203125","Matara","Pitabeddara","Kosnilgoda","262D",1482,712,770
"3203130","Matara","Pitabeddara","Aluwana","262E",982,474,508
"3203135","Matara","Pitabeddara","Paradupalla","262F",637,323,314
"3203140","Matara","Pitabeddara","Mahapothuvila","263D",1227,625,602
"3203145","Matara","Pitabeddara","Dankoluwa","265A",2151,1080,1071
"3203150","Matara","Pitabeddara","Pitabeddara","261A",1399,686,713
"3203155","Matara","Pitabeddara","Kaduruwana","261D",1658,788,870
"3203160","Matara","Pitabeddara","Dehigaspa","265",1054,518,536
"3203165","Matara","Pitabeddara","Kotagala","266",979,451,528
"3203170","Matara","Pitabeddara","Siyambalagoda East","263A",737,380,357
"3203175","Matara","Pitabeddara","Wanasinkanda","263F",602,306,296
"3203180","Matara","Pitabeddara","Diyadawa","263C",1107,543,564
"3203185","Matara","Pitabeddara","Ihala Ainagama","263E",857,424,433
"3203190","Matara","Pitabeddara","Elamaldeniya","266A",1276,602,674
"3203195","Matara","Pitabeddara","Wathurakumbura","265C",1284,620,664
"3203200","Matara","Pitabeddara","Puwakbadovita","265B",1308,665,643
"3206005","Matara","Kotapola","Mederipitiya","240",1049,525,524
"3206010","Matara","Kotapola","Keeriwalagama","241G",1581,819,762
"3206015","Matara","Kotapola","Kiriweldola","241A",1721,848,873
"3206020","Matara","Kotapola","Kandilpana","241H",3181,1603,1578
"3206025","Matara","Kotapola","Viharahena","244",2757,1327,1430
"3206030","Matara","Kotapola","Adaradeniya","244C",1811,891,920
"3206035","Matara","Kotapola","Ihalagama","243B",1970,928,1042
"3206040","Matara","Kotapola","Bateyaya","241C",1544,745,799
"3206045","Matara","Kotapola","Pussawela","241F",1231,605,626
"3206050","Matara","Kotapola","Pallegama North","241",2440,1188,1252
"3206055","Matara","Kotapola","Pathawala Nadakanda","241D",1418,701,717
"3206060","Matara","Kotapola","Poddana","240C",1513,762,751
"3206065","Matara","Kotapola","Kolawenigama","240A",2101,1051,1050
"3206070","Matara","Kotapola","Pallegama South","241B",2230,1064,1166
"3206075","Matara","Kotapola","Deniyaya West","243A",1623,766,857
"3206080","Matara","Kotapola","Deniyaya","243",2224,1137,1087
"3206085","Matara","Kotapola","Kalugalahena","244B",2668,1260,1408
"3206090","Matara","Kotapola","Thenipita","244A",2951,1376,1575
"3206095","Matara","Kotapola","Mugunumulla","242C",844,422,422
"3206100","Matara","Kotapola","Nawalahena","242D",1110,528,582
"3206105","Matara","Kotapola","Kotapola North","242",2660,1290,1370
"3206110","Matara","Kotapola","Nishshankapura","241E",1383,627,756
"3206115","Matara","Kotapola","Beliattakumbura","240B",1604,792,812
"3206120","Matara","Kotapola","Morawaka","257",2851,1366,1485
"3206125","Matara","Kotapola","Porupitiya","257B",1018,507,511
"3206130","Matara","Kotapola","Waralla","256",1316,625,691
"3206135","Matara","Kotapola","Koodaludeniya","256C",1111,526,585
"3206140","Matara","Kotapola","Kotapola South","242A",1776,856,920
"3206145","Matara","Kotapola","Usamalagoda","242F",1342,656,686
"3206150","Matara","Kotapola","Lindagawahena","242G",1752,855,897
"3206155","Matara","Kotapola","Kosmodara","242E",1593,835,758
"3206160","Matara","Kotapola","Ilukpitiya","242B",1014,510,504
"3206165","Matara","Kotapola","Horagala East","256A",732,377,355
"3206170","Matara","Kotapola","Horagala West","256D",1693,833,860
"3206175","Matara","Kotapola","Uvaragala","256B",694,329,365
"3206180","Matara","Kotapola","Pelawatta","257A",1653,838,815
"3206185","Matara","Kotapola","Paragala","263B",1096,545,551
"3209005","Matara","Pasgoda","Batandura South","251E",1446,723,723
"3209010","Matara","Pasgoda","Batandura North","251A",932,468,464
"3209015","Matara","Pasgoda","Thalapalakanda","250C",1443,691,752
"3209020","Matara","Pasgoda","Kekundeniya","250B",1883,913,970
"3209025","Matara","Pasgoda","Ketawala","246A",1650,799,851
"3209030","Matara","Pasgoda","Ginnaliya North","246C",1401,692,709
"3209035","Matara","Pasgoda","Pattigala","246E",1884,897,987
"3209040","Matara","Pasgoda","Beralapanathara South","250A",1244,610,634
"3209045","Matara","Pasgoda","Beralapanathara North","250",1847,923,924
"3209050","Matara","Pasgoda","Wijayagama","250D",1285,633,652
"3209055","Matara","Pasgoda","Pathavita","250E",1217,596,621
"3209060","Matara","Pasgoda","Kirilipana","251",1702,867,835
"3209065","Matara","Pasgoda","Moragala","251B",1172,570,602
"3209070","Matara","Pasgoda","Keeripitiya East","249",1430,684,746
"3209075","Matara","Pasgoda","Urubokka","249A",2631,1287,1344
"3209080","Matara","Pasgoda","Ginnaliya West","246B",1298,631,667
"3209085","Matara","Pasgoda","Ginnaliya South","246D",1164,559,605
"3209090","Matara","Pasgoda","Ginnaliya East","246",1015,503,512
"3209095","Matara","Pasgoda","Mekiliyathenna","249B",1726,833,893
"3209100","Matara","Pasgoda","Heegoda","249C",1996,956,1040
"3209105","Matara","Pasgoda","Keeripitiya West","249D",1222,594,628
"3209110","Matara","Pasgoda","Pothdeniya","255A",1188,581,607
"3209115","Matara","Pasgoda","Mologgamuwa North","251C",958,442,516
"3209120","Matara","Pasgoda","Mologgamuwa South","251D",928,464,464
"3209125","Matara","Pasgoda","Bengamuwa West","255B",1329,645,684
"3209130","Matara","Pasgoda","Bengamuwa East","255",1497,710,787
"3209135","Matara","Pasgoda","Dampahala West","253A",1501,730,771
"3209140","Matara","Pasgoda","Hulankanda","253B",1453,687,766
"3209145","Matara","Pasgoda","Dampahala East","253",1940,932,1008
"3209150","Matara","Pasgoda","Pasgoda","254",2662,1307,1355
"3209155","Matara","Pasgoda","Bengamuwa South","255C",1220,574,646
"3209160","Matara","Pasgoda","Denkandaliya","268D",707,355,352
"3209165","Matara","Pasgoda","Panakaduwa West","267A",1073,548,525
"3209170","Matara","Pasgoda","Rotumba East","268A",637,300,337
"3209175","Matara","Pasgoda","Napathella","268C",715,348,367
"3209180","Matara","Pasgoda","Andaluwa","254A",1044,517,527
"3209185","Matara","Pasgoda","Ehelakanda","270A",1175,569,606
"3209190","Matara","Pasgoda","Galketikanda","268B",873,441,432
"3209195","Matara","Pasgoda","Rotumba West","268",924,450,474
"3209200","Matara","Pasgoda","Panakaduwa East","267",1309,648,661
"3209205","Matara","Pasgoda","Gomila","270B",1345,627,718
"3209210","Matara","Pasgoda","Puwakgahahena","270C",1057,506,551
"3209215","Matara","Pasgoda","Mawarala","270",2037,986,1051
"3212005","Matara","Mulatiyana","Gombaddala North","271A",881,430,451
"3212010","Matara","Mulatiyana","Kudapana","271B",833,423,410
"3212015","Matara","Mulatiyana","Ketapalakanda","273C",1064,516,548
"3212020","Matara","Mulatiyana","Gammedagama","273A",908,439,469
"3212025","Matara","Mulatiyana","Ketiyape North","273",898,456,442
"3212030","Matara","Mulatiyana","Athapattukanda","276B",1091,540,551
"3212035","Matara","Mulatiyana","Parapamulla East","276",1059,512,547
"3212040","Matara","Mulatiyana","Ketiyape South","273B",778,373,405
"3212045","Matara","Mulatiyana","Galetumba","275C",819,417,402
"3212050","Matara","Mulatiyana","Neralampitiya","272A",976,462,514
"3212055","Matara","Mulatiyana","Mulatiyana","272",1162,574,588
"3212060","Matara","Mulatiyana","Diddenipotha North","302B",680,319,361
"3212065","Matara","Mulatiyana","Beragama North","303B",1424,693,731
"3212070","Matara","Mulatiyana","Gombaddala South","271",1301,612,689
"3212075","Matara","Mulatiyana","Beragama West","303A",1397,654,743
"3212080","Matara","Mulatiyana","Beragama South","303C",1168,551,617
"3212085","Matara","Mulatiyana","Makandura West","301",1359,641,718
"3212090","Matara","Mulatiyana","Beragama East","303",1107,545,562
"3212095","Matara","Mulatiyana","Diddenipotha East","302",638,297,341
"3212100","Matara","Mulatiyana","Diddenipotha South","302A",1014,475,539
"3212105","Matara","Mulatiyana","Seenipella West","275A",1224,592,632
"3212110","Matara","Mulatiyana","Maduwala","275D",1241,611,630
"3212115","Matara","Mulatiyana","Seenipella East","275B",921,462,459
"3212120","Matara","Mulatiyana","Deiyandara","275",1906,912,994
"3212125","Matara","Mulatiyana","Parapamulla West","276A",711,335,376
"3212130","Matara","Mulatiyana","Parapamulla South","276C",629,304,325
"3212135","Matara","Mulatiyana","Dewalegama West","277A",1085,508,577
"3212140","Matara","Mulatiyana","Dewalegama East","277",874,414,460
"3212145","Matara","Mulatiyana","Batadola","279",1299,620,679
"3212150","Matara","Mulatiyana","Kithsiripura","279B",969,437,532
"3212155","Matara","Mulatiyana","Radawela West","278A",686,327,359
"3212160","Matara","Mulatiyana","Belpamulla","275E",818,401,417
"3212165","Matara","Mulatiyana","Bamunugama West","300B",1234,589,645
"3212170","Matara","Mulatiyana","Makandura East","301B",1257,590,667
"3212175","Matara","Mulatiyana","Ransegoda East","301C",943,429,514
"3212180","Matara","Mulatiyana","Meepavita","299B",1004,487,517
"3212185","Matara","Mulatiyana","Mudaligedara","299C",873,409,464
"3212190","Matara","Mulatiyana","Rathkekulawa","299E",1593,755,838
"3212195","Matara","Mulatiyana","Ransegoda North","301A",1606,748,858
"3212200","Matara","Mulatiyana","Ransegoda South","299A",1349,695,654
"3212205","Matara","Mulatiyana","Ransegoda West","299D",764,355,409
"3212210","Matara","Mulatiyana","Koramburuwana","299",799,375,424
"3212215","Matara","Mulatiyana","Horapavita South","300C",948,456,492
"3212220","Matara","Mulatiyana","Horapavita North","300A",1120,520,600
"3212225","Matara","Mulatiyana","Bamunugama East","300",823,390,433
"3212230","Matara","Mulatiyana","Radawela East","278",804,379,425
"3212235","Matara","Mulatiyana","Pallawela","279C",904,455,449
"3212240","Matara","Mulatiyana","Pitawalgamuwa","279A",1320,632,688
"3215005","Matara","Athuraliya","Kehelwala","304A",478,232,246
"3215010","Matara","Athuraliya","Urumutta","304",1471,693,778
"3215015","Matara","Athuraliya","Urumutta South","304B",913,447,466
"3215020","Matara","Athuraliya","Dematapassa","305B",1512,748,764
"3215025","Matara","Athuraliya","Divithura","305A",979,481,498
"3215030","Matara","Athuraliya","Welihena","305",1332,642,690
"3215035","Matara","Athuraliya","Hawpe","306C",1322,643,679
"3215040","Matara","Athuraliya","Thalahagama West","306A",1063,496,567
"3215045","Matara","Athuraliya","Wenagama","306B",1742,849,893
"3215050","Matara","Athuraliya","Thalahagama East","306",1966,962,1004
"3215055","Matara","Athuraliya","Uggashena","313D",1426,688,738
"3215060","Matara","Athuraliya","Vilpita West","313A",1201,586,615
"3215065","Matara","Athuraliya","Kanahalagama","308B",1180,569,611
"3215070","Matara","Athuraliya","Godapitiya","308A",1735,800,935
"3215075","Matara","Athuraliya","Maragoda","308C",979,445,534
"3215080","Matara","Athuraliya","Panadugama","308",1300,609,691
"3215085","Matara","Athuraliya","Thibbotuwawa North","310A",748,326,422
"3215090","Matara","Athuraliya","Walagepiyadda","313C",1081,498,583
"3215095","Matara","Athuraliya","Vilpita East 1","313",569,271,298
"3215100","Matara","Athuraliya","Vilpita East 11","313B",1432,573,859
"3215105","Matara","Athuraliya","Yahamulla","314B",945,468,477
"3215110","Matara","Athuraliya","Namburukanda","314C",496,240,256
"3215115","Matara","Athuraliya","Ihala Athuraliya","314",850,411,439
"3215120","Matara","Athuraliya","Balakawala","310B",1157,564,593
"3215125","Matara","Athuraliya","Thibbotuwawa","310",1796,872,924
"3215130","Matara","Athuraliya","Athuraliya West","314D",833,394,439
"3215135","Matara","Athuraliya","Athuraliya East","314A",573,280,293
"3215140","Matara","Athuraliya","Pahala Athuraliya","315",1225,604,621
"3218005","Matara","Akuressa","Diganahena","366B",515,262,253
"3218010","Matara","Akuressa","Lenama North","363F",1728,824,904
"3218015","Matara","Akuressa","Hulandawa","363E",617,309,308
"3218020","Matara","Akuressa","Maramba North","363A",1203,581,622
"3218025","Matara","Akuressa","Peddapitiya North","363D",1073,500,573
"3218030","Matara","Akuressa","Idikatudeniya","363H",655,293,362
"3218035","Matara","Akuressa","Lenama South","363B",712,347,365
"3218040","Matara","Akuressa","Udupitiya","363G",543,263,280
"3218045","Matara","Akuressa","Weliketiya","367A",1202,564,638
"3218050","Matara","Akuressa","Dediyagala","366A",1564,786,778
"3218055","Matara","Akuressa","Vilagama","367B",491,246,245
"3218060","Matara","Akuressa","Ehelape","367",1587,772,815
"3218065","Matara","Akuressa","Dolamawatha","368B",1535,738,797
"3218070","Matara","Akuressa","Kohugoda","368D",1128,573,555
"3218075","Matara","Akuressa","Ihala Maliduwa","368A",1149,560,589
"3218080","Matara","Akuressa","Ketanvila","366",1376,658,718
"3218085","Matara","Akuressa","Nawalagoda","367D",919,426,493
"3218090","Matara","Akuressa","Ellewela","367C",1242,609,633
"3218095","Matara","Akuressa","Minipogoda","362A",768,390,378
"3218100","Matara","Akuressa","Peddapitiya South","363C",1025,518,507
"3218105","Matara","Akuressa","Maramba South","363",894,432,462
"3218110","Matara","Akuressa","Ganhela","362",1016,505,511
"3218115","Matara","Akuressa","Asmagoda","362B",603,284,319
"3218120","Matara","Akuressa","Higgoda","364A",1687,809,878
"3218125","Matara","Akuressa","Diyalape","364",1130,580,550
"3218130","Matara","Akuressa","Eramudugoda","365",1289,620,669
"3218135","Matara","Akuressa","Manikgoda","365A",782,379,403
"3218140","Matara","Akuressa","Pahala Maliduwa","368",1436,676,760
"3218145","Matara","Akuressa","Bopitiya","368C",1421,703,718
"3218150","Matara","Akuressa","Iluppella","361B",1804,858,946
"3218155","Matara","Akuressa","Imbulgoda","361C",1249,628,621
"3218160","Matara","Akuressa","Poramba","361A",1582,760,822
"3218165","Matara","Akuressa","Akuressa","360",1178,589,589
"3218170","Matara","Akuressa","Yakabedda","360A",2023,987,1036
"3218175","Matara","Akuressa","Galabadahena","360C",966,468,498
"3218180","Matara","Akuressa","Ihala Kiyanduwa","360B",1168,557,611
"3218185","Matara","Akuressa","Melewwa","359C",1183,566,617
"3218190","Matara","Akuressa","Paraduwa North","359",1104,541,563
"3218195","Matara","Akuressa","Paraduwa East","359B",984,462,522
"3218200","Matara","Akuressa","Paraduwa South","359A",1106,520,586
"3218205","Matara","Akuressa","Henegama","370",1356,645,711
"3218210","Matara","Akuressa","Henegama West","370A",1544,727,817
"3218215","Matara","Akuressa","Gallala","371A",1225,620,605
"3218220","Matara","Akuressa","Nimalawa East","371B",629,295,334
"3218225","Matara","Akuressa","Nimalawa","371",1537,760,777
"3218230","Matara","Akuressa","Paragahawatta","370B",984,450,534
"3221005","Matara","Welipitiya","Wahala Kananke North","373",995,448,547
"3221010","Matara","Welipitiya","Nivithiwelbokka","373A",1340,621,719
"3221015","Matara","Welipitiya","Poramba Kananke North","372",1375,646,729
"3221020","Matara","Welipitiya","Puhulahena","372C",1030,500,530
"3221025","Matara","Welipitiya","Poramba Kananke South","372A",1757,825,932
"3221030","Matara","Welipitiya","Wahala Kananke South","373B",1406,640,766
"3221035","Matara","Welipitiya","Nalawana","372B",731,336,395
"3221040","Matara","Welipitiya","Penetiyana West","394B",1408,673,735
"3221045","Matara","Welipitiya","Penetiyana East","394A",771,348,423
"3221050","Matara","Welipitiya","Wellana","394",923,451,472
"3221055","Matara","Welipitiya","Udukawa North","392B",1429,685,744
"3221060","Matara","Welipitiya","Udukawa South","392A",1982,980,1002
"3221065","Matara","Welipitiya","Hallala","375",1095,525,570
"3221070","Matara","Welipitiya","Bathalahena","375E",933,442,491
"3221075","Matara","Welipitiya","Kokmaduwa North","375C",715,347,368
"3221080","Matara","Welipitiya","Sahabandu Kokmaduwa","375B",889,406,483
"3221085","Matara","Welipitiya","Jamburegoda East","377",472,229,243
"3221090","Matara","Welipitiya","Padili Kokmaduwa","375A",1133,507,626
"3221095","Matara","Welipitiya","Beraleliya","375D",1375,656,719
"3221100","Matara","Welipitiya","Jayawickramapura","397C",1345,647,698
"3221105","Matara","Welipitiya","Warakapitiya North","399",1446,675,771
"3221110","Matara","Welipitiya","Warakapitiya East","399C",929,452,477
"3221115","Matara","Welipitiya","Warakapitiya South","399B",1322,625,697
"3221120","Matara","Welipitiya","Meeruppa","397B",1467,678,789
"3221125","Matara","Welipitiya","Uruvitiya","397A",1231,579,652
"3221130","Matara","Welipitiya","Watagedaramulla","397",1855,865,990
"3221135","Matara","Welipitiya","Moonamalpe","392",1314,615,699
"3221140","Matara","Welipitiya","Welipitiya","396A",3348,1595,1753
"3221145","Matara","Welipitiya","Palalla","377A",2082,986,1096
"3221150","Matara","Welipitiya","Jamburegoda West","377B",743,344,399
"3221155","Matara","Welipitiya","Ibbawala","376",550,255,295
"3221160","Matara","Welipitiya","Vilegoda","376A",957,484,473
"3221165","Matara","Welipitiya","Borala","378A",1377,655,722
"3221170","Matara","Welipitiya","Maduragoda","391C",2164,1035,1129
"3221175","Matara","Welipitiya","Kapuwatta","396",1209,595,614
"3221180","Matara","Welipitiya","Denipitiya Central","391B",2427,1169,1258
"3221185","Matara","Welipitiya","Denipitiya West","391A",1696,779,917
"3221190","Matara","Welipitiya","Denipitiya East","391",2877,1376,1501
"3224005","Matara","Malimbada","Elgiriya","355A",951,425,526
"3224010","Matara","Malimbada","Pahala Kiyaduwa","355B",1022,485,537
"3224015","Matara","Malimbada","Maragoda","357A",1126,543,583
"3224020","Matara","Malimbada","Kekunawela","357",691,329,362
"3224025","Matara","Malimbada","Kadduwa","356A",588,277,311
"3224030","Matara","Malimbada","Dampella","356",876,415,461
"3224035","Matara","Malimbada","Horagoda East","355",1025,465,560
"3224040","Matara","Malimbada","Horagoda West","355C",1198,562,636
"3224045","Matara","Malimbada","Horagoda South","355D",1035,480,555
"3224050","Matara","Malimbada","Kadukanna","353",1468,702,766
"3224055","Matara","Malimbada","Welandagoda","356B",892,415,477
"3224060","Matara","Malimbada","Uninduwela","353B",758,341,417
"3224065","Matara","Malimbada","Thelijjavila","353A",1878,873,1005
"3224070","Matara","Malimbada","Nape","355E",485,228,257
"3224075","Matara","Malimbada","Akurugoda North","400C",1392,642,750
"3224080","Matara","Malimbada","Akurugoda East","400",1654,791,863
"3224085","Matara","Malimbada","Kirimetimulla South","351B",2457,1132,1325
"3224090","Matara","Malimbada","Kirimetimulla North","351A",993,477,516
"3224095","Matara","Malimbada","Malimbada West","351",1881,893,988
"3224100","Matara","Malimbada","Katuwangoda","350A",801,377,424
"3224105","Matara","Malimbada","Malimbada East","402A",1557,731,826
"3224110","Matara","Malimbada","Malimbada North","350",1546,701,845
"3224115","Matara","Malimbada","Malimbada South","402",867,405,462
"3224120","Matara","Malimbada","Galpamuna","402B",1231,574,657
"3224125","Matara","Malimbada","Akurugoda South","400B",1770,866,904
"3224130","Matara","Malimbada","Akurugoda West","400A",972,467,505
"3224135","Matara","Malimbada","Sulthanagoda West","403",986,454,532
"3224140","Matara","Malimbada","Sulthanagoda East","403B",1370,666,704
"3224145","Matara","Malimbada","Sulthanagoda South","403A",1386,653,733
"3227005","Matara","Kamburupitiya","Gathara West","320B",932,444,488
"3227010","Matara","Kamburupitiya","Gathara North","320",768,351,417
"3227015","Matara","Kamburupitiya","Gathara East","320A",1275,609,666
"3227020","Matara","Kamburupitiya","Beragammulla","323D",1053,514,539
"3227025","Matara","Kamburupitiya","Eriyathota","323C",1343,683,660
"3227030","Matara","Kamburupitiya","Ganegama","323A",618,316,302
"3227035","Matara","Kamburupitiya","Narandeniya East","323B",692,355,337
"3227040","Matara","Kamburupitiya","Narandeniya West","323",631,290,341
"3227045","Matara","Kamburupitiya","Malana","321",1059,481,578
"3227050","Matara","Kamburupitiya","Magamure","330B",881,415,466
"3227055","Matara","Kamburupitiya","Sapugoda","330A",1541,757,784
"3227060","Matara","Kamburupitiya","Lenabatuwa","317C",1182,558,624
"3227065","Matara","Kamburupitiya","Bibulewela","317A",863,440,423
"3227070","Matara","Kamburupitiya","Godawa","318A",1366,660,706
"3227075","Matara","Kamburupitiya","Pitakatuwana","318",1009,491,518
"3227080","Matara","Kamburupitiya","Kamburupitiya","330",1653,817,836
"3227085","Matara","Kamburupitiya","Ullala East","321A",1856,902,954
"3227090","Matara","Kamburupitiya","Thumbe","321D",833,404,429
"3227095","Matara","Kamburupitiya","Karaputugala North","324A",837,404,433
"3227100","Matara","Kamburupitiya","Karaputugala South","324",876,411,465
"3227105","Matara","Kamburupitiya","Ullala Masmulla","321B",1194,592,602
"3227110","Matara","Kamburupitiya","Ullala West","321C",1369,673,696
"3227115","Matara","Kamburupitiya","Mapalana Mangin Ihala","331D",1272,606,666
"3227120","Matara","Kamburupitiya","Mapalana Mangin Pahala","331",1345,619,726
"3227125","Matara","Kamburupitiya","Seewelgama","318B",1769,840,929
"3227130","Matara","Kamburupitiya","Ihala Vitiyala North","348A",943,432,511
"3227135","Matara","Kamburupitiya","Karagoda Uyangoda 1 Atha East","317B",1327,622,705
"3227140","Matara","Kamburupitiya","Karagoda Uyangoda 1 Atha West","317",1001,467,534
"3227145","Matara","Kamburupitiya","Karagoda Uyangoda 2 West","316A",855,413,442
"3227150","Matara","Kamburupitiya","Karagoda Uyangoda 2 East","316",855,399,456
"3227155","Matara","Kamburupitiya","Ihala Vitiyala West","348C",724,325,399
"3227160","Matara","Kamburupitiya","Ihala Vitiyala South","348",735,343,392
"3227165","Matara","Kamburupitiya","Ihala Vitiyala East","348B",981,459,522
"3227170","Matara","Kamburupitiya","Akurugoda","331A",870,408,462
"3227175","Matara","Kamburupitiya","Kahagala","331B",1177,536,641
"3227180","Matara","Kamburupitiya","Kahagala South","331C",938,457,481
"3227185","Matara","Kamburupitiya","Urapola East","346A",661,317,344
"3227190","Matara","Kamburupitiya","Palolpitiya","346B",1057,522,535
"3227195","Matara","Kamburupitiya","Urapola West","346",628,285,343
"3230005","Matara","Hakmana","Denagama East","280",1035,501,534
"3230010","Matara","Hakmana","Denagama North","280C",1083,522,561
"3230015","Matara","Hakmana","Denagama West","280A",798,369,429
"3230020","Matara","Hakmana","Badabadda","280B",1343,648,695
"3230025","Matara","Hakmana","Meeella","281",1184,562,622
"3230030","Matara","Hakmana","Pananwela East","282A",757,339,418
"3230035","Matara","Hakmana","Pananwela West","282",526,244,282
"3230040","Matara","Hakmana","Kohuliyadda","286B",771,398,373
"3230045","Matara","Hakmana","Kebiliyapola North","284",387,184,203
"3230050","Matara","Hakmana","Wepathaira North","283",772,373,399
"3230055","Matara","Hakmana","Wepathaira West","283B",654,306,348
"3230060","Matara","Hakmana","Kandegoda","293D",616,302,314
"3230065","Matara","Hakmana","Narawelpita East","297E",1013,495,518
"3230070","Matara","Hakmana","Narawelpita North","297A",1416,678,738
"3230075","Matara","Hakmana","Ellewela East","297C",882,435,447
"3230080","Matara","Hakmana","Ellewela West","297B",1389,681,708
"3230085","Matara","Hakmana","Narawelpita South","297",903,410,493
"3230090","Matara","Hakmana","Beruwela","293C",868,405,463
"3230095","Matara","Hakmana","Muruthamuraya","293",669,304,365
"3230100","Matara","Hakmana","Muruthamuraya West","293B",764,371,393
"3230105","Matara","Hakmana","Muruthamuraya East","293A",778,362,416
"3230110","Matara","Hakmana","Wepathaira South","283A",1037,517,520
"3230115","Matara","Hakmana","Kebiliyapola South","284A",1030,502,528
"3230120","Matara","Hakmana","Gangodagama","286",922,434,488
"3230125","Matara","Hakmana","Pottewela","286A",756,363,393
"3230130","Matara","Hakmana","Lalpe","294B",1317,620,697
"3230135","Matara","Hakmana","Gammedapitiya","286C",914,420,494
"3230140","Matara","Hakmana","Udupeellegoda East","294",1076,497,579
"3230145","Matara","Hakmana","Udupeellegoda West","294A",1190,558,632
"3230150","Matara","Hakmana","Kongala East","295",639,311,328
"3230155","Matara","Hakmana","Kongala South","295C",1021,480,541
"3230160","Matara","Hakmana","Kongala Central","295B",905,423,482
"3230165","Matara","Hakmana","Kongala West","295A",955,394,561
"3230170","Matara","Hakmana","Narawelpita West","297D",1278,599,679
"3233005","Matara","Kirinda Puhulwella","Ovitigamuwa South","328",1012,454,558
"3233010","Matara","Kirinda Puhulwella","Ovitigamuwa North","328A",945,430,515
"3233015","Matara","Kirinda Puhulwella","Malwathugoda","326C",1021,497,524
"3233020","Matara","Kirinda Puhulwella","Galkanda","326B",609,290,319
"3233025","Matara","Kirinda Puhulwella","Kirinda Mangin Pahala","326",963,462,501
"3233030","Matara","Kirinda Puhulwella","Kirinda Mangin Ihala North","325",800,389,411
"3233035","Matara","Kirinda Puhulwella","Hettiyawala West","325F",745,356,389
"3233040","Matara","Kirinda Puhulwella","Hettiyawala North","325G",970,447,523
"3233045","Matara","Kirinda Puhulwella","Boraluketiya","290A",560,275,285
"3233050","Matara","Kirinda Puhulwella","Karathota","290",832,387,445
"3233055","Matara","Kirinda Puhulwella","Naradda","290B",742,339,403
"3233060","Matara","Kirinda Puhulwella","Kumbalgoda","290C",681,317,364
"3233065","Matara","Kirinda Puhulwella","Hettiyawala East","325A",793,382,411
"3233070","Matara","Kirinda Puhulwella","Hettiyawala South","325E",801,384,417
"3233075","Matara","Kirinda Puhulwella","Wavulanbokka","325H",687,332,355
"3233080","Matara","Kirinda Puhulwella","Puhulwella East","326A",742,342,400
"3233085","Matara","Kirinda Puhulwella","Puhulwella West","326D",926,445,481
"3233090","Matara","Kirinda Puhulwella","Kirinda Mangin Ihala South","325B",854,410,444
"3233095","Matara","Kirinda Puhulwella","Kirinda Mangin Ihala Central","325D",1132,536,596
"3233100","Matara","Kirinda Puhulwella","Kirinda Mangin Ihala East","325C",859,404,455
"3233105","Matara","Kirinda Puhulwella","Wathukolakanda East","327D",924,442,482
"3233110","Matara","Kirinda Puhulwella","Walakanda South","327C",628,298,330
"3233115","Matara","Kirinda Puhulwella","Walakanda West","327",816,411,405
"3233120","Matara","Kirinda Puhulwella","Walakanda East","327B",608,290,318
"3233125","Matara","Kirinda Puhulwella","Wathukolakanda North","327A",641,287,354
"3236005","Matara","Thihagoda","Pahala Vitiyala West","343B",937,426,511
"3236010","Matara","Thihagoda","Pahala Vitiyala Central","343A",951,436,515
"3236015","Matara","Thihagoda","Pahala Vitiyala East","343",698,325,373
"3236020","Matara","Thihagoda","Polathugoda","344B",959,479,480
"3236025","Matara","Thihagoda","Batuvita 1","344A",1042,474,568
"3236030","Matara","Thihagoda","Batuvita 2","344D",1000,459,541
"3236035","Matara","Thihagoda","Medauyangoda","334A",1360,624,736
"3236040","Matara","Thihagoda","Akkara Panaha","334C",714,341,373
"3236045","Matara","Thihagoda","Yatiyana","334",1103,534,569
"3236050","Matara","Thihagoda","Kottawatta","334B",609,303,306
"3236055","Matara","Thihagoda","Komangoda 2","344C",646,304,342
"3236060","Matara","Thihagoda","Komangoda 1","344",466,225,241
"3236065","Matara","Thihagoda","Thihagoda East","335B",993,467,526
"3236070","Matara","Thihagoda","Thihagoda","335",848,421,427
"3236075","Matara","Thihagoda","Kithalagama East 2","347A",384,179,205
"3236080","Matara","Thihagoda","Kithalagama East 3","347B",639,294,345
"3236085","Matara","Thihagoda","Kithalagama Central","349B",1009,488,521
"3236090","Matara","Thihagoda","Narangala","349A",975,482,493
"3236095","Matara","Thihagoda","Wellethota","342",1299,624,675
"3236100","Matara","Thihagoda","Kithalagama West","349",794,407,387
"3236105","Matara","Thihagoda","Kithalagama East 1","347",458,216,242
"3236110","Matara","Thihagoda","Naimbala 1","336",579,271,308
"3236115","Matara","Thihagoda","Kapudoowa","335A",727,326,401
"3236120","Matara","Thihagoda","Kapudoowa East","335C",600,270,330
"3236125","Matara","Thihagoda","Uduwa West","333B",611,264,347
"3236130","Matara","Thihagoda","Uduwa East","333",780,369,411
"3236135","Matara","Thihagoda","Galbada","333A",611,272,339
"3236140","Matara","Thihagoda","Naimbala 2","336B",1103,534,569
"3236145","Matara","Thihagoda","Bandattara 2","336C",813,379,434
"3236150","Matara","Thihagoda","Watagedara East","337C",755,357,398
"3236155","Matara","Thihagoda","Attudawa","341",681,305,376
"3236160","Matara","Thihagoda","Attudawa West","341A",918,435,483
"3236165","Matara","Thihagoda","Watagedara","337A",1000,483,517
"3236170","Matara","Thihagoda","Nadugala 2","337B",895,433,462
"3236175","Matara","Thihagoda","Nadugala 1","337",1072,539,533
"3236180","Matara","Thihagoda","Bandattara 1","336A",928,440,488
"3236185","Matara","Thihagoda","Elambathalagoda","340B",502,221,281
"3236190","Matara","Thihagoda","Palatuwa","340",897,429,468
"3236195","Matara","Thihagoda","Unella","340A",1018,502,516
"3236200","Matara","Thihagoda","Dematahettigoda","340C",1161,570,591
"3239005","Matara","Weligama","Midigama North","381A",1752,844,908
"3239010","Matara","Weligama","Pathegama","379",1232,624,608
"3239015","Matara","Weligama","Moodugamuwa West","378B",1316,614,702
"3239020","Matara","Weligama","Moodugamuwa East","378",912,416,496
"3239025","Matara","Weligama","Kohunugamuwa","389",1368,627,741
"3239030","Matara","Weligama","Walana","379B",1703,809,894
"3239035","Matara","Weligama","Wekada","381B",3522,1706,1816
"3239040","Matara","Weligama","Denuwala","381C",1228,609,619
"3239045","Matara","Weligama","Midigama West","381",1587,756,831
"3239050","Matara","Weligama","Midigama East","380",1150,550,600
"3239055","Matara","Weligama","Hetti Weediya","382B",2397,1126,1271
"3239060","Matara","Weligama","Aluth Weediya","385A",3223,1638,1585
"3239065","Matara","Weligama","Polwatta","388",2166,1061,1105
"3239070","Matara","Weligama","Nidangala","399A",943,443,500
"3239075","Matara","Weligama","Kotavila West","404B",1399,659,740
"3239080","Matara","Weligama","Kotavila North","404A",1363,657,706
"3239085","Matara","Weligama","Kamburugamuwa North","408",2849,1345,1504
"3239090","Matara","Weligama","Kotavila South","404",1838,864,974
"3239095","Matara","Weligama","Henwala East","405C",1070,501,569
"3239100","Matara","Weligama","Polwathumodara","388A",1152,549,603
"3239105","Matara","Weligama","Pelena North","387C",1320,634,686
"3239110","Matara","Weligama","Pelena West","387A",1568,700,868
"3239115","Matara","Weligama","Galbokka East","385",1675,924,751
"3239120","Matara","Weligama","Galbokka West","385B",1225,599,626
"3239125","Matara","Weligama","Paranakade","382A",1380,654,726
"3239130","Matara","Weligama","Walliwala East","386",2424,1187,1237
"3239135","Matara","Weligama","Pitidoowa","379A",1364,662,702
"3239140","Matara","Weligama","Gurubebila","380A",1786,848,938
"3239145","Matara","Weligama","Walliwala West","386A",1218,589,629
"3239150","Matara","Weligama","Walliwala South","386B",1207,573,634
"3239155","Matara","Weligama","Maha Weediya","382",1459,697,762
"3239160","Matara","Weligama","Pelena South","387B",1190,597,593
"3239165","Matara","Weligama","Henwala West","405D",976,480,496
"3239170","Matara","Weligama","Garanduwa","408B",1189,570,619
"3239175","Matara","Weligama","Mirissa Udumulla","405B",1244,598,646
"3239180","Matara","Weligama","Mirissa Udupila","405A",1700,809,891
"3239185","Matara","Weligama","Mirissa North","405",1366,659,707
"3239190","Matara","Weligama","Mirissa South 2","406A",1682,851,831
"3239195","Matara","Weligama","Kapparathota South","386C",1339,659,680
"3239200","Matara","Weligama","Kapparathota North","386D",1894,894,1000
"3239205","Matara","Weligama","Mirissa South 1","406",1223,597,626
"3239210","Matara","Weligama","Bandaramulla","407A",1617,805,812
"3239215","Matara","Weligama","Thal Aramba North","407B",1748,849,899
"3239220","Matara","Weligama","Thudella","408D",833,383,450
"3239225","Matara","Weligama","Kamburugamuwa South","408C",1426,685,741
"3239230","Matara","Weligama","Kamburugamuwa West","408A",820,387,433
"3239235","Matara","Weligama","Thal Aramba East","407C",674,328,346
"3239240","Matara","Weligama","Thal Aramba South","407",1126,541,585
"3242005","Matara","Matara Four Gravets","Deeyagaha East","446A",1096,525,571
"3242010","Matara","Matara Four Gravets","Kekanadura East","447B",1784,844,940
"3242015","Matara","Matara Four Gravets","Kokawala","443B",746,350,396
"3242020","Matara","Matara Four Gravets","Parawahera East","443C",1182,553,629
"3242025","Matara","Matara Four Gravets","Parawahera North","443",1287,588,699
"3242030","Matara","Matara Four Gravets","Kekanadura North","447C",683,332,351
"3242035","Matara","Matara Four Gravets","Kekanadura Central","447A",1915,887,1028
"3242040","Matara","Matara Four Gravets","Deeyagaha West","446",1115,536,579
"3242045","Matara","Matara Four Gravets","Navimana North","428",523,246,277
"3242050","Matara","Matara Four Gravets","Pahalagoda","428B",923,437,486
"3242055","Matara","Matara Four Gravets","Navimana South","427",1817,839,978
"3242060","Matara","Matara Four Gravets","Thudawa East","420C",1246,580,666
"3242065","Matara","Matara Four Gravets","Thudawa North","420B",775,358,417
"3242070","Matara","Matara Four Gravets","Thudawa South","420",1494,738,756
"3242075","Matara","Matara Four Gravets","Sudarshi Place","420D",1663,800,863
"3242090","Matara","Matara Four Gravets","Godagama","419",2174,1016,1158
"3242095","Matara","Matara Four Gravets","Eduwa - Madurudoowa","419A",1030,483,547
"3242100","Matara","Matara Four Gravets","Kanattagoda North","423B",1530,731,799
"3242105","Matara","Matara Four Gravets","Wewahamandoowa","423A",2634,1283,1351
"3242115","Matara","Matara Four Gravets","Isadeen Town","414C",2593,1288,1305
"3242120","Matara","Matara Four Gravets","Weliweriya West","415A",1350,675,675
"3242125","Matara","Matara Four Gravets","Weliweriya East","417E",2952,1320,1632
"3242130","Matara","Matara Four Gravets","Walpala","417C",2534,1197,1337
"3242135","Matara","Matara Four Gravets","Weragampita","417H",3060,1448,1612
"3242140","Matara","Matara Four Gravets","Ruwan Ella","428A",1699,811,888
"3242145","Matara","Matara Four Gravets","Kekanadura West","447",721,335,386
"3242150","Matara","Matara Four Gravets","Kekanadura South","447D",2835,1406,1429
"3242155","Matara","Matara Four Gravets","Parawahera South","443A",1721,788,933
"3242160","Matara","Matara Four Gravets","Thalpavila North","430A",3181,1488,1693
"3242165","Matara","Matara Four Gravets","Nakuttiya","430B",1197,583,614
"3242170","Matara","Matara Four Gravets","Veherahena","426B",2827,1361,1466
"3242175","Matara","Matara Four Gravets","Makavita","426C",1294,604,690
"3242180","Matara","Matara Four Gravets","Weradoowa","425A",1123,542,581
"3242185","Matara","Matara Four Gravets","Uyanwatta","417G",2235,1060,1175
"3242190","Matara","Matara Four Gravets","Uyanwatta North","417D",2302,1045,1257
"3242195","Matara","Matara Four Gravets","Kadeweediya East","417A",2064,954,1110
"3242200","Matara","Matara Four Gravets","Kadeweediya West","417F",1771,827,944
"3242205","Matara","Matara Four Gravets","Welegoda East","414",3616,1720,1896
"3242210","Matara","Matara Four Gravets","Welegoda West","409E",1973,922,1051
"3242215","Matara","Matara Four Gravets","Mathotagama","409D",1946,983,963
"3242220","Matara","Matara Four Gravets","Walgama North","409B",2316,1108,1208
"3242225","Matara","Matara Four Gravets","Kanattegoda South","423",1071,498,573
"3242230","Matara","Matara Four Gravets","Madiha West","411A",2044,972,1072
"3242235","Matara","Matara Four Gravets","Walgama","409A",2569,1267,1302
"3242240","Matara","Matara Four Gravets","Walgama Meda","409C",1955,906,1049
"3242245","Matara","Matara Four Gravets","Walgama South","411C",1971,915,1056
"3242250","Matara","Matara Four Gravets","Madiha East","411B",965,474,491
"3242255","Matara","Matara Four Gravets","Polhena","412",2256,1104,1152
"3242260","Matara","Matara Four Gravets","Pamburana","412B",2610,1266,1344
"3242265","Matara","Matara Four Gravets","Noope","415",934,422,512
"3242270","Matara","Matara Four Gravets","Kadeweediya South","417B",1356,687,669
"3242275","Matara","Matara Four Gravets","Thotamuna","412A",1584,731,853
"3242280","Matara","Matara Four Gravets","Fort","416C",1082,696,386
"3242285","Matara","Matara Four Gravets","Kotuwegoda North","416",1204,580,624
"3242290","Matara","Matara Four Gravets","Eliyakanda North","416D",1417,801,616
"3242295","Matara","Matara Four Gravets","Meddawatta","425",1671,756,915
"3242300","Matara","Matara Four Gravets","Rassandeniya","425B",2695,1332,1363
"3242305","Matara","Matara Four Gravets","Wewa Ihalagoda","429A",1612,740,872
"3242310","Matara","Matara Four Gravets","Thalpavila South","430",920,429,491
"3242315","Matara","Matara Four Gravets","Gandarawatta","429B",883,403,480
"3242320","Matara","Matara Four Gravets","Meddawatta South","425C",1954,479,1475
"3242325","Matara","Matara Four Gravets","Eliyakanda South","416A",1726,905,821
"3242330","Matara","Matara Four Gravets","Kotuwegoda South","416B",1134,489,645
"3245005","Matara","Devinuwara","Kadawedduwa West","449A",1420,665,755
"3245010","Matara","Devinuwara","Kadawedduwa East","449B",806,384,422
"3245015","Matara","Devinuwara","Walbulugahahena","449D",1007,472,535
"3245020","Matara","Devinuwara","Aparekka North","449C",690,373,317
"3245025","Matara","Devinuwara","Uda Aparekka East","448A",1303,600,703
"3245030","Matara","Devinuwara","Uda Aparekka","448",1664,773,891
"3245035","Matara","Devinuwara","Palle Aparekka","449",936,430,506
"3245040","Matara","Devinuwara","Agarawala","448C",700,340,360
"3245045","Matara","Devinuwara","Beddegammedda","448B",898,399,499
"3245050","Matara","Devinuwara","Pathegama East","445A",422,188,234
"3245055","Matara","Devinuwara","Pathegama North","445",481,216,265
"3245060","Matara","Devinuwara","Naotunna","442",1042,493,549
"3245065","Matara","Devinuwara","Naotunna North","442C",782,357,425
"3245070","Matara","Devinuwara","Thalalla North","439",1217,588,629
"3245075","Matara","Devinuwara","Thalalla East","438B",875,413,462
"3245080","Matara","Devinuwara","Thalalla South","438",1424,651,773
"3245085","Matara","Devinuwara","Naotunna Central","442A",715,342,373
"3245090","Matara","Devinuwara","Naotunna South","442B",815,366,449
"3245095","Matara","Devinuwara","Thalalla Central","438A",1403,645,758
"3245100","Matara","Devinuwara","Delgalla","436A",941,420,521
"3245105","Matara","Devinuwara","Kapugama North","436B",1769,849,920
"3245110","Matara","Devinuwara","Kapugama West","435",925,458,467
"3245115","Matara","Devinuwara","Gandarawatta South","435A",1105,544,561
"3245120","Matara","Devinuwara","Kapugama Central","436C",1247,575,672
"3245125","Matara","Devinuwara","Kapugama East","436",4004,1892,2112
"3245130","Matara","Devinuwara","Gandara East","437A",1396,698,698
"3245135","Matara","Devinuwara","Thalalla","438C",1355,652,703
"3245140","Matara","Devinuwara","Gandara South","437B",1036,494,542
"3245145","Matara","Devinuwara","Gandara Central","437C",1137,534,603
"3245150","Matara","Devinuwara","Gandara West","437",2170,1039,1131
"3245155","Matara","Devinuwara","Devinuwara North","432",2589,1267,1322
"3245160","Matara","Devinuwara","Devinuwara Central","432A",1024,500,524
"3245165","Matara","Devinuwara","Devinuwara Nugegoda","433D",1497,678,819
"3245170","Matara","Devinuwara","Devinuwara West","433A",574,275,299
"3245175","Matara","Devinuwara","Devinuwara East","433B",1025,485,540
"3245180","Matara","Devinuwara","Devinuwara Wawwa","433E",1348,677,671
"3245185","Matara","Devinuwara","Devinuwara Pradeepagara Pedesa","433H",1213,569,644
"3245190","Matara","Devinuwara","Devinuwara","433C",478,238,240
"3245195","Matara","Devinuwara","Devinuwara Welegoda","433G",877,440,437
"3245200","Matara","Devinuwara","Devinuwara Sinhasana Pedesa","433F",936,431,505
"3245205","Matara","Devinuwara","Devinuwara South","433",1007,490,517
"3248005","Matara","Dickwella","Urugamuwa North","457A",481,220,261
"3248010","Matara","Dickwella","Bodarakanda","456B",769,370,399
"3248015","Matara","Dickwella","Urugamuwa East","456",827,408,419
"3248020","Matara","Dickwella","Urugamuwa Central","457B",802,378,424
"3248025","Matara","Dickwella","Urugamuwa West","456A",643,309,334
"3248030","Matara","Dickwella","Dandeniya North","450",1061,482,579
"3248035","Matara","Dickwella","Urugamuwa South","457",811,369,442
"3248040","Matara","Dickwella","Rannawala","455C",773,358,415
"3248045","Matara","Dickwella","Urugamuwa","456C",805,387,418
"3248050","Matara","Dickwella","Wehella","455",1051,467,584
"3248055","Matara","Dickwella","Wehella North","455A",699,322,377
"3248060","Matara","Dickwella","Dandeniya South","450A",784,368,416
"3248065","Matara","Dickwella","Bambarenda North","450B",1533,729,804
"3248070","Matara","Dickwella","Pohosathugoda","441B",651,292,359
"3248075","Matara","Dickwella","Rathmale","450C",945,436,509
"3248080","Matara","Dickwella","Bambarenda Central","450D",1583,733,850
"3248085","Matara","Dickwella","Wehella South","455B",556,274,282
"3248090","Matara","Dickwella","Wattegama","451",1135,560,575
"3248095","Matara","Dickwella","Wattegama North","451A",1212,558,654
"3248100","Matara","Dickwella","Walasgala West","452C",830,400,430
"3248105","Matara","Dickwella","Walasgala East","452B",1690,787,903
"3248110","Matara","Dickwella","Wevurukannala","452A",1147,543,604
"3248115","Matara","Dickwella","Dickwella North","452",1907,906,1001
"3248120","Matara","Dickwella","Dodampahala North","453B",1355,637,718
"3248125","Matara","Dickwella","Dodampahala East","453A",2223,1082,1141
"3248130","Matara","Dickwella","Dodampahala Central","453C",1334,676,658
"3248135","Matara","Dickwella","Dodampahala West","453",1437,701,736
"3248140","Matara","Dickwella","Dodampahala South","453D",1992,960,1032
"3248145","Matara","Dickwella","Dickwella East","452F",1260,613,647
"3248150","Matara","Dickwella","Dickwella Central","452D",1262,589,673
"3248155","Matara","Dickwella","Dickwella Muslim Yonakapura East","454",1350,626,724
"3248160","Matara","Dickwella","Dickwella Muslim Yonakapura West","454A",702,325,377
"3248165","Matara","Dickwella","Dickwella South","452E",1159,561,598
"3248170","Matara","Dickwella","Wattegama South","451B",1904,928,976
"3248175","Matara","Dickwella","Batheegama East","451C",1150,541,609
"3248180","Matara","Dickwella","Batheegama Central","451D",1964,919,1045
"3248185","Matara","Dickwella","Batheegama West","451E",1031,496,535
"3248190","Matara","Dickwella","Bambarenda East","441C",892,418,474
"3248195","Matara","Dickwella","Bambarenda South","441",1478,721,757
"3248200","Matara","Dickwella","Bambarenda West","441A",1020,473,547
"3248205","Matara","Dickwella","Belideniya","444B",952,432,520
"3248210","Matara","Dickwella","Pathegama Central","444C",1072,531,541
"3248215","Matara","Dickwella","Pathegama South","444",1928,873,1055
"3248220","Matara","Dickwella","Beliwatta","444A",1289,601,688
"3248225","Matara","Dickwella","Suduwella","440A",905,467,438
"3248230","Matara","Dickwella","Kottagoda","440",594,303,291
"3248235","Matara","Dickwella","Godauda","440C",456,225,231
"3248240","Matara","Dickwella","Lunukalapuwa","440B",1268,608,660
"3303005","Hambantota","Sooriyawewa","Ihala Kumbukwewa","100",581,296,285
"3303010","Hambantota","Sooriyawewa","Mahagalwewa","101",1226,620,606
"3303015","Hambantota","Sooriyawewa","Meegaha Jadura","102",1285,662,623
"3303020","Hambantota","Sooriyawewa","Ranmuduwewa","99",1104,571,533
"3303025","Hambantota","Sooriyawewa","Weliwewa","98",1187,604,583
"3303030","Hambantota","Sooriyawewa","Suravirugama","104",2576,1309,1267
"3303035","Hambantota","Sooriyawewa","Samajasewapura","105",2674,1352,1322
"3303040","Hambantota","Sooriyawewa","Weeriyagama","115",2018,1034,984
"3303045","Hambantota","Sooriyawewa","Hathporuwa","114",2624,1319,1305
"3303050","Hambantota","Sooriyawewa","Weniwel Ara","108",2180,1149,1031
"3303055","Hambantota","Sooriyawewa","Aliolu Ara","113",2168,1092,1076
"3303060","Hambantota","Sooriyawewa","Sooriyawewa Town","103",4124,2080,2044
"3303065","Hambantota","Sooriyawewa","Viharagala","106",3109,1536,1573
"3303070","Hambantota","Sooriyawewa","Beddewewa","112",2209,1097,1112
"3303075","Hambantota","Sooriyawewa","Mahawelikada Ara","111",2121,1036,1085
"3303080","Hambantota","Sooriyawewa","Andarawewa","109",2793,1428,1365
"3303085","Hambantota","Sooriyawewa","Namadagaswewa","110",1740,877,863
"3303090","Hambantota","Sooriyawewa","Mahapelessa","107",1616,848,768
"3303095","Hambantota","Sooriyawewa","Bediganthota","132",1782,896,886
"3303100","Hambantota","Sooriyawewa","Habarattawala","137",1080,539,541
"3303105","Hambantota","Sooriyawewa","Wediwewa","136",2905,1531,1374
"3306005","Hambantota","Lunugamvehera","Maha Aluth Gam Ara","47",839,469,370
"3306010","Hambantota","Lunugamvehera","Angunakolawewa","45",276,141,135
"3306015","Hambantota","Lunugamvehera","Veheragala","46",327,182,145
"3306020","Hambantota","Lunugamvehera","Ranawarnawa","55",1440,739,701
"3306025","Hambantota","Lunugamvehera","Dewramvehera","53",1147,573,574
"3306030","Hambantota","Lunugamvehera","Bogahawewa","54",702,378,324
"3306035","Hambantota","Lunugamvehera","Padavigama","51",1579,796,783
"3306040","Hambantota","Lunugamvehera","Punchiappujandura","52",919,453,466
"3306045","Hambantota","Lunugamvehera","Lunugamvehera New Town","56",2237,1111,1126
"3306050","Hambantota","Lunugamvehera","Seenimunna","57",1131,548,583
"3306055","Hambantota","Lunugamvehera","Kendagasmankada","58",1873,949,924
"3306060","Hambantota","Lunugamvehera","Mahanagapura","59",1081,543,538
"3306065","Hambantota","Lunugamvehera","Muwanwewa","60",614,303,311
"3306070","Hambantota","Lunugamvehera","Weeravil Ara","50",304,161,143
"3306075","Hambantota","Lunugamvehera","Ittanwekada","61",743,385,358
"3306080","Hambantota","Lunugamvehera","Mattala","48",769,413,356
"3306085","Hambantota","Lunugamvehera","Pahala Mattala","49",852,605,247
"3306090","Hambantota","Lunugamvehera","Mihindupura","63",1021,512,509
"3306095","Hambantota","Lunugamvehera","Abhayapura","62",624,317,307
"3306100","Hambantota","Lunugamvehera","Singhapura","64",713,349,364
"3306105","Hambantota","Lunugamvehera","Senapura","65",679,339,340
"3306110","Hambantota","Lunugamvehera","Agbopura","70",1157,575,582
"3306115","Hambantota","Lunugamvehera","Karambawewa","69",935,457,478
"3306120","Hambantota","Lunugamvehera","Rambukwewa","79",1426,704,722
"3306125","Hambantota","Lunugamvehera","Keerthipura","80",414,203,211
"3306130","Hambantota","Lunugamvehera","Samanpura","68",462,230,232
"3306135","Hambantota","Lunugamvehera","Ranasiripura","67",1043,535,508
"3306140","Hambantota","Lunugamvehera","Weeravila","66",1073,556,517
"3306145","Hambantota","Lunugamvehera","Weligatta","78",287,149,138
"3306150","Hambantota","Lunugamvehera","Beralihela","73",792,411,381
"3306155","Hambantota","Lunugamvehera","Dutugemunupura","71",927,466,461
"3306160","Hambantota","Lunugamvehera","Jayagama","72",945,486,459
"3306165","Hambantota","Lunugamvehera","Parakramapura","74",448,218,230
"3306170","Hambantota","Lunugamvehera","Saddhathissapura","75",878,442,436
"3306175","Hambantota","Lunugamvehera","Saddhathissapura New Town","76",252,128,124
"3306180","Hambantota","Lunugamvehera","Saliyapura","77",650,352,298
"3309005","Hambantota","Thissamaharama","Kawanthissapura","42",2173,1083,1090
"3309010","Hambantota","Thissamaharama","Kirinda","19",3614,2034,1580
"3309015","Hambantota","Thissamaharama","Uddhakandara","14",1958,982,976
"3309020","Hambantota","Thissamaharama","Joolpallama","43",2642,1338,1304
"3309025","Hambantota","Thissamaharama","Weerahela","44",2550,1285,1265
"3309030","Hambantota","Thissamaharama","Vijithapura","40",1853,911,942
"3309035","Hambantota","Thissamaharama","Ellagala","32",1937,953,984
"3309040","Hambantota","Thissamaharama","Anjaligala","31",1076,513,563
"3309045","Hambantota","Thissamaharama","Pannagamuwa","29",1761,866,895
"3309050","Hambantota","Thissamaharama","Dambewelena","30",1066,505,561
"3309055","Hambantota","Thissamaharama","Mahindapura","33",1556,745,811
"3309060","Hambantota","Thissamaharama","Gemunupura","38",1298,639,659
"3309065","Hambantota","Thissamaharama","Ekamuthugama","41",1334,668,666
"3309070","Hambantota","Thissamaharama","Sandungama","39",1178,571,607
"3309075","Hambantota","Thissamaharama","Debarawewa","37",1348,669,679
"3309080","Hambantota","Thissamaharama","Kachcheriyagama","3",919,451,468
"3309085","Hambantota","Thissamaharama","Sandagiripura","10",1748,906,842
"3309090","Hambantota","Thissamaharama","Mahasenpura","11",2360,1204,1156
"3309095","Hambantota","Thissamaharama","Shuddha Nagaraya","8",844,421,423
"3309100","Hambantota","Thissamaharama","Medawelena","2",1504,743,761
"3309105","Hambantota","Thissamaharama","Rohanapura","5",1081,540,541
"3309110","Hambantota","Thissamaharama","Senapura","6",1714,819,895
"3309115","Hambantota","Thissamaharama","Gangasiripura","4",1956,947,1009
"3309120","Hambantota","Thissamaharama","Polgahawelena","36",998,511,487
"3309125","Hambantota","Thissamaharama","Randunu Watta","35",1044,523,521
"3309130","Hambantota","Thissamaharama","Molakepoopathana","34",1176,594,582
"3309135","Hambantota","Thissamaharama","Thissapura","28",2543,1475,1068
"3309140","Hambantota","Thissamaharama","Uduvila","25",1263,629,634
"3309145","Hambantota","Thissamaharama","Rubberwatta","7",1422,712,710
"3309150","Hambantota","Thissamaharama","Thissamaharama","1",1397,699,698
"3309155","Hambantota","Thissamaharama","Gotabhayapura","12",2007,1008,999
"3309160","Hambantota","Thissamaharama","Rana Keliya","13",1021,517,504
"3309165","Hambantota","Thissamaharama","Viharamahadevipura","18",2171,1079,1092
"3309170","Hambantota","Thissamaharama","Yodhakandiya","15",1624,794,830
"3309175","Hambantota","Thissamaharama","Welipothewala","16",1137,550,587
"3309180","Hambantota","Thissamaharama","Halmillawa","17",655,324,331
"3309185","Hambantota","Thissamaharama","Rathnelumwalayaya","9",1394,679,715
"3309190","Hambantota","Thissamaharama","Gonagamuwa","27",1028,503,525
"3309195","Hambantota","Thissamaharama","Saliyapura","26",1002,489,513
"3309200","Hambantota","Thissamaharama","Nedigamvila","22",1210,607,603
"3309205","Hambantota","Thissamaharama","Wijayapura","24",1369,688,681
"3309210","Hambantota","Thissamaharama","Konwelena","23",1364,664,700
"3309215","Hambantota","Thissamaharama","Magama","20",1027,505,522
"3309220","Hambantota","Thissamaharama","Andaragasyaya","21",2284,1135,1149
"3312005","Hambantota","Hambantota","Elalla","97",1333,751,582
"3312010","Hambantota","Hambantota","Ketenwewa","96",698,417,281
"3312015","Hambantota","Hambantota","Thammennawa","86",1730,886,844
"3312020","Hambantota","Hambantota","Badagiriya","85",1209,586,623
"3312025","Hambantota","Hambantota","Yahangala East","88",942,474,468
"3312030","Hambantota","Hambantota","Joolgamuwa","84",1109,542,567
"3312035","Hambantota","Hambantota","Yahangala West","87",1034,499,535
"3312040","Hambantota","Hambantota","Keliyapura","91",1866,937,929
"3312045","Hambantota","Hambantota","Gonnoruwa","95",1192,671,521
"3312050","Hambantota","Hambantota","Bellagaswewa","120",1029,616,413
"3312055","Hambantota","Hambantota","Galwewa","118",2328,1133,1195
"3312060","Hambantota","Hambantota","Siyambalagasvila South","117",1462,710,752
"3312065","Hambantota","Hambantota","Siyambalagasvila North","116",1129,565,564
"3312070","Hambantota","Hambantota","Udaberagama","119",1647,812,835
"3312075","Hambantota","Hambantota","Arawanamulla","122",1566,747,819
"3312080","Hambantota","Hambantota","Pahala Beragama","121",1449,740,709
"3312085","Hambantota","Hambantota","Dehigahalanda","127",1261,621,640
"3312090","Hambantota","Hambantota","Walawa","125",1672,844,828
"3312095","Hambantota","Hambantota","Godawaya","126",2024,987,1037
"3312100","Hambantota","Hambantota","Sisilasagama","124",3401,1706,1695
"3312105","Hambantota","Hambantota","Manajjawa","128",2333,1117,1216
"3312110","Hambantota","Hambantota","Samodagama","92",1759,892,867
"3312115","Hambantota","Hambantota","Mirijjavila","123",2007,1014,993
"3312120","Hambantota","Hambantota","Hambantota West","94",7302,3528,3774
"3312125","Hambantota","Hambantota","Hambantota East","93",981,525,456
"3312130","Hambantota","Hambantota","Siribopura","90",6505,3174,3331
"3312135","Hambantota","Hambantota","Koholankala","89",2816,1432,1384
"3312140","Hambantota","Hambantota","Pallemalala","83",1649,805,844
"3312145","Hambantota","Hambantota","Bundala","81",556,266,290
"3312150","Hambantota","Hambantota","Siriyagama","82",1275,655,620
"3315005","Hambantota","Ambalantota","Siyambalakote","170",842,412,430
"3315010","Hambantota","Ambalantota","Barawakumbuka","171",2040,992,1048
"3315015","Hambantota","Ambalantota","Thaligala","172",1701,820,881
"3315020","Hambantota","Ambalantota","Liyangasthota","133",1683,859,824
"3315025","Hambantota","Ambalantota","Wetiya","173",1484,741,743
"3315030","Hambantota","Ambalantota","Murawesihena","186",1582,814,768
"3315035","Hambantota","Ambalantota","Mahajandura","185",1138,579,559
"3315040","Hambantota","Ambalantota","Handunkatuwa","183",1344,674,670
"3315045","Hambantota","Ambalantota","Rote","184",1964,992,972
"3315050","Hambantota","Ambalantota","Hedavinna","169",1436,718,718
"3315055","Hambantota","Ambalantota","Ridiyagama","129",1967,1000,967
"3315060","Hambantota","Ambalantota","Punchihenayagama","130",1083,557,526
"3315065","Hambantota","Ambalantota","Poliyarwatta","131",798,380,418
"3315070","Hambantota","Ambalantota","Godakoggalla","138",1103,545,558
"3315075","Hambantota","Ambalantota","Koggalla","134",1560,765,795
"3315080","Hambantota","Ambalantota","Modara Piliwala","135",1027,523,504
"3315085","Hambantota","Ambalantota","Bolana North","139",1350,654,696
"3315090","Hambantota","Ambalantota","Jansagama","168",1267,634,633
"3315095","Hambantota","Ambalantota","Mamadala South","167",1756,869,887
"3315100","Hambantota","Ambalantota","Mamadala North","166",956,457,499
"3315105","Hambantota","Ambalantota","Ethbatuwa","180",1503,771,732
"3315110","Hambantota","Ambalantota","Mulana","181",1427,717,710
"3315115","Hambantota","Ambalantota","Eraminiyaya","182",1483,746,737
"3315120","Hambantota","Ambalantota","Ihalagama","179",1719,823,896
"3315125","Hambantota","Ambalantota","Deniya","176",770,379,391
"3315130","Hambantota","Ambalantota","Elegoda West","162",542,264,278
"3315135","Hambantota","Ambalantota","Elegoda East","161",978,478,500
"3315140","Hambantota","Ambalantota","Beminiyanvila","159",916,442,474
"3315145","Hambantota","Ambalantota","Walawewatta West","164",891,430,461
"3315150","Hambantota","Ambalantota","Walawewatta East","163",1090,520,570
"3315155","Hambantota","Ambalantota","Bolana South","140",1734,851,883
"3315160","Hambantota","Ambalantota","Kudabolana","141",1050,499,551
"3315165","Hambantota","Ambalantota","Palugaha Godella","147",1119,572,547
"3315170","Hambantota","Ambalantota","Rotawala","165",1330,647,683
"3315175","Hambantota","Ambalantota","Uhapitagoda","160",2972,1499,1473
"3315180","Hambantota","Ambalantota","Miniethiliya","174",957,488,469
"3315185","Hambantota","Ambalantota","Pingama","175",896,448,448
"3315190","Hambantota","Ambalantota","Pallegama","177",1124,517,607
"3315195","Hambantota","Ambalantota","Hungama","178",2001,984,1017
"3315200","Hambantota","Ambalantota","Bataatha North","157",1348,664,684
"3315205","Hambantota","Ambalantota","Bataatha South","158",1850,905,945
"3315210","Hambantota","Ambalantota","Hathagala","156",718,353,365
"3315215","Hambantota","Ambalantota","Kivula South","154",822,390,432
"3315220","Hambantota","Ambalantota","Kivula North","153",666,332,334
"3315225","Hambantota","Ambalantota","Lunama North","151",1186,569,617
"3315230","Hambantota","Ambalantota","Lunama South","152",1422,686,736
"3315235","Hambantota","Ambalantota","Nonagama","155",1347,673,674
"3315240","Hambantota","Ambalantota","Ekkassa","149",1642,767,875
"3315245","Hambantota","Ambalantota","Welipatanvila","150",675,326,349
"3315250","Hambantota","Ambalantota","Malpettawa","148",1092,531,561
"3315255","Hambantota","Ambalantota","Puhulyaya","146",1322,631,691
"3315260","Hambantota","Ambalantota","Ambalanthota North","144",1618,853,765
"3315265","Hambantota","Ambalantota","Ambalanthota South","143",1298,622,676
"3315270","Hambantota","Ambalantota","Wanduruppa","142",1849,891,958
"3315275","Hambantota","Ambalantota","Thawaluvila","145",1505,743,762
"3318005","Hambantota","Angunakolapelessa","Kariyamaditta","235",563,275,288
"3318010","Hambantota","Angunakolapelessa","Dabarella North","233",736,341,395
"3318015","Hambantota","Angunakolapelessa","Rathmalwala","232",732,354,378
"3318020","Hambantota","Angunakolapelessa","Kailawelpotawa","226",591,268,323
"3318025","Hambantota","Angunakolapelessa","Kendaketiya","231",1313,640,673
"3318030","Hambantota","Angunakolapelessa","Dabarella South","234",586,282,304
"3318035","Hambantota","Angunakolapelessa","Thalawa North","236",842,386,456
"3318040","Hambantota","Angunakolapelessa","Thalawa South","237",1091,524,567
"3318045","Hambantota","Angunakolapelessa","Debokkawa South","220",1059,512,547
"3318050","Hambantota","Angunakolapelessa","Debokkawa North","219",807,389,418
"3318055","Hambantota","Angunakolapelessa","Uswewa","225",693,351,342
"3318060","Hambantota","Angunakolapelessa","Metigathwala","227",636,312,324
"3318065","Hambantota","Angunakolapelessa","Amarathungama","222",1185,600,585
"3318070","Hambantota","Angunakolapelessa","Sooriyapokuna","221",626,298,328
"3318075","Hambantota","Angunakolapelessa","Pahalagama","198",1572,783,789
"3318080","Hambantota","Angunakolapelessa","Kohombagaswewa","224",715,349,366
"3318085","Hambantota","Angunakolapelessa","Dikwewa","229",1132,544,588
"3318090","Hambantota","Angunakolapelessa","Abesekaragama","228",430,196,234
"3318095","Hambantota","Angunakolapelessa","Kalawelwala","230",587,284,303
"3318100","Hambantota","Angunakolapelessa","Meda Ara","223",560,287,273
"3318105","Hambantota","Angunakolapelessa","Binkama","192",1546,779,767
"3318110","Hambantota","Angunakolapelessa","Karagahawala","195",843,409,434
"3318115","Hambantota","Angunakolapelessa","Dandenigama","194",816,410,406
"3318120","Hambantota","Angunakolapelessa","Guruwala","199",1365,675,690
"3318125","Hambantota","Angunakolapelessa","Weeragaswewa","210",511,252,259
"3318130","Hambantota","Angunakolapelessa","Gajanayakagama","215",928,457,471
"3318135","Hambantota","Angunakolapelessa","Medagoda","213",714,350,364
"3318140","Hambantota","Angunakolapelessa","Dimbulgoda","214",671,314,357
"3318145","Hambantota","Angunakolapelessa","Attanayala East","218",773,384,389
"3318150","Hambantota","Angunakolapelessa","Attanayala West","217",811,394,417
"3318155","Hambantota","Angunakolapelessa","Wakamulla","216",956,463,493
"3318160","Hambantota","Angunakolapelessa","Heenbunna","211",1314,673,641
"3318165","Hambantota","Angunakolapelessa","Makuladeniya","212",430,198,232
"3318170","Hambantota","Angunakolapelessa","Udayala","207",1358,662,696
"3318175","Hambantota","Angunakolapelessa","Medayala","208",591,282,309
"3318180","Hambantota","Angunakolapelessa","Bogamuwa","209",801,410,391
"3318185","Hambantota","Angunakolapelessa","Daha Amuna","203",813,401,412
"3318190","Hambantota","Angunakolapelessa","Julamulla","196",1060,517,543
"3318195","Hambantota","Angunakolapelessa","Jandura","197",2335,1177,1158
"3318200","Hambantota","Angunakolapelessa","Helekada","193",1540,748,792
"3318205","Hambantota","Angunakolapelessa","Aluthwewa","190",1054,510,544
"3318210","Hambantota","Angunakolapelessa","Kankanamgama","191",706,340,366
"3318215","Hambantota","Angunakolapelessa","Achariyagama","188",1272,615,657
"3318220","Hambantota","Angunakolapelessa","Angunakolapelessa","187",1289,632,657
"3318225","Hambantota","Angunakolapelessa","Yakagala","189",2508,1247,1261
"3318230","Hambantota","Angunakolapelessa","Gurunnehege Ara","202",877,446,431
"3318235","Hambantota","Angunakolapelessa","Kotawaya","204",389,193,196
"3318240","Hambantota","Angunakolapelessa","Netalaporuwa","206",690,319,371
"3318245","Hambantota","Angunakolapelessa","Hakuruwela","205",647,312,335
"3318250","Hambantota","Angunakolapelessa","Indigetawela","200",1193,593,600
"3318255","Hambantota","Angunakolapelessa","Thalamporuwa","201",1044,493,551
"3321005","Hambantota","Weeraketiya","Mulanyaya","425",843,402,441
"3321010","Hambantota","Weeraketiya","Handapangala Ayna","422",316,156,160
"3321015","Hambantota","Weeraketiya","Heellage Ayna","421",659,349,310
"3321020","Hambantota","Weeraketiya","Kudagal Ara","426",608,289,319
"3321025","Hambantota","Weeraketiya","Okandayaya North","428",610,311,299
"3321030","Hambantota","Weeraketiya","Okandayaya West","429",525,249,276
"3321035","Hambantota","Weeraketiya","Kaluwagahayaya","427",605,290,315
"3321040","Hambantota","Weeraketiya","Ihala Gonadeniya","413",744,353,391
"3321045","Hambantota","Weeraketiya","Debokkawa West","411",739,379,360
"3321050","Hambantota","Weeraketiya","Debokkawa East","410",556,278,278
"3321055","Hambantota","Weeraketiya","Wekandawala North","408",552,260,292
"3321060","Hambantota","Weeraketiya","Pahala Gonadeniya","414",773,351,422
"3321065","Hambantota","Weeraketiya","Kuda Bibula North","418",755,376,379
"3321070","Hambantota","Weeraketiya","Galpottayaya North","420",1032,478,554
"3321075","Hambantota","Weeraketiya","Galpottayaya South","419",466,222,244
"3321080","Hambantota","Weeraketiya","Malhewage Ayna","423",492,233,259
"3321085","Hambantota","Weeraketiya","Kandamaditta","424",399,194,205
"3321090","Hambantota","Weeraketiya","Meegas Ara","441",1121,527,594
"3321095","Hambantota","Weeraketiya","Kuda Bibula South","417",542,269,273
"3321100","Hambantota","Weeraketiya","Abakolawewa South","416",322,166,156
"3321105","Hambantota","Weeraketiya","Abakolawewa North","415",648,325,323
"3321110","Hambantota","Weeraketiya","Morayaya North","407",420,197,223
"3321115","Hambantota","Weeraketiya","Morayaya South","406",656,319,337
"3321120","Hambantota","Weeraketiya","Kemegala","405",623,305,318
"3321125","Hambantota","Weeraketiya","Wekandawala South","409",783,359,424
"3321130","Hambantota","Weeraketiya","Thelambuyaya","412",516,254,262
"3321135","Hambantota","Weeraketiya","Siyambalaheddewa","401",348,161,187
"3321140","Hambantota","Weeraketiya","Degampotha","400",887,420,467
"3321145","Hambantota","Weeraketiya","Kinchigune West","404",353,160,193
"3321150","Hambantota","Weeraketiya","Medagama","442",851,409,442
"3321155","Hambantota","Weeraketiya","Raluwa","436",979,471,508
"3321160","Hambantota","Weeraketiya","Kinchigune South","403",546,261,285
"3321165","Hambantota","Weeraketiya","Kinchigune East","402",610,288,322
"3321170","Hambantota","Weeraketiya","Medamulana","399",1422,685,737
"3321175","Hambantota","Weeraketiya","Yakgasmulla","398",1118,521,597
"3321180","Hambantota","Weeraketiya","Udukirivila","397",862,397,465
"3321185","Hambantota","Weeraketiya","Buddhiyagama North","440",876,431,445
"3321190","Hambantota","Weeraketiya","Keppitiyawa North","439",758,350,408
"3321195","Hambantota","Weeraketiya","Ittademaliya East","445",559,248,311
"3321200","Hambantota","Weeraketiya","Ittademaliya West","444",491,230,261
"3321205","Hambantota","Weeraketiya","Ittademaliya South","443",481,216,265
"3321210","Hambantota","Weeraketiya","Athubode West","447",522,259,263
"3321215","Hambantota","Weeraketiya","Athubode East","446",427,198,229
"3321220","Hambantota","Weeraketiya","Keppitiyawa South","438",570,275,295
"3321225","Hambantota","Weeraketiya","Buddhiyagama West","392",837,397,440
"3321230","Hambantota","Weeraketiya","Buddhiyagama East","391",1197,575,622
"3321235","Hambantota","Weeraketiya","Weeraketiya West","388",1051,520,531
"3321240","Hambantota","Weeraketiya","Mandaduwa","389",778,377,401
"3321245","Hambantota","Weeraketiya","Agrahera","390",880,437,443
"3321250","Hambantota","Weeraketiya","Weeraketiya East","387",1115,544,571
"3321255","Hambantota","Weeraketiya","Mulgirigala East","395",942,442,500
"3321260","Hambantota","Weeraketiya","Mulgirigala North","396",419,222,197
"3321265","Hambantota","Weeraketiya","Mulgirigala West","394",801,374,427
"3321270","Hambantota","Weeraketiya","Mulgirigala South","393",919,433,486
"3321275","Hambantota","Weeraketiya","Bedigama West","385",415,200,215
"3321280","Hambantota","Weeraketiya","Bedigama North","383",653,316,337
"3321285","Hambantota","Weeraketiya","Bedigama East","382",560,264,296
"3321290","Hambantota","Weeraketiya","Bedigama South","381",948,467,481
"3321295","Hambantota","Weeraketiya","Kuda Bedigama","386",567,256,311
"3321300","Hambantota","Weeraketiya","Medagoda","384",518,254,264
"3324005","Hambantota","Katuwana","Karivilakanda","527",702,353,349
"3324010","Hambantota","Katuwana","Medakanda","525",1539,777,762
"3324015","Hambantota","Katuwana","Hingurakanda","520",917,442,475
"3324020","Hambantota","Katuwana","Uda Alupothdeniya","523",733,369,364
"3324025","Hambantota","Katuwana","Alupothdeniya Pahala","522",331,163,168
"3324030","Hambantota","Katuwana","Kohomporuwa","517",693,304,389
"3324035","Hambantota","Katuwana","Gangulandeniya","516",307,152,155
"3324040","Hambantota","Katuwana","Ambagas Ara","515",936,461,475
"3324045","Hambantota","Katuwana","Labuhengoda","503",545,267,278
"3324050","Hambantota","Katuwana","Sapugahayaya","502",948,459,489
"3324055","Hambantota","Katuwana","Hellala","501",779,374,405
"3324060","Hambantota","Katuwana","Middeniya North","498",1126,563,563
"3324065","Hambantota","Katuwana","Middeniya East","500",1819,878,941
"3324070","Hambantota","Katuwana","Kudagoda West","494",624,309,315
"3324075","Hambantota","Katuwana","Kudagoda East","493",507,254,253
"3324080","Hambantota","Katuwana","Dambethalawa","497",805,398,407
"3324085","Hambantota","Katuwana","Murungasyaya East","495",1117,554,563
"3324090","Hambantota","Katuwana","Murungasyaya West","496",963,474,489
"3324095","Hambantota","Katuwana","Middeniya West","499",1370,660,710
"3324100","Hambantota","Katuwana","Welipitiya East","507",433,213,220
"3324105","Hambantota","Katuwana","Welipitiya","506",613,287,326
"3324110","Hambantota","Katuwana","Welipitiya West","508",741,344,397
"3324115","Hambantota","Katuwana","Ritigaha Yaya","513",1069,500,569
"3324120","Hambantota","Katuwana","Thalwatta","514",1262,604,658
"3324125","Hambantota","Katuwana","Meemanakoladeniya","512",1403,677,726
"3324130","Hambantota","Katuwana","Siyambalamuraya","519",962,471,491
"3324135","Hambantota","Katuwana","Udawelmulla","521",492,250,242
"3324140","Hambantota","Katuwana","Siyarapitiya","518",496,231,265
"3324145","Hambantota","Katuwana","Kehelwatta","526",429,216,213
"3324150","Hambantota","Katuwana","Udagomadiya","524",1213,591,622
"3324155","Hambantota","Katuwana","Bengamukanda","528",644,329,315
"3324160","Hambantota","Katuwana","Dangalakanda","531",761,352,409
"3324165","Hambantota","Katuwana","Rukmalpitiya","530",738,364,374
"3324170","Hambantota","Katuwana","Gallindamulla","529",650,326,324
"3324175","Hambantota","Katuwana","Katuwana","535",1505,746,759
"3324180","Hambantota","Katuwana","Pangamvilayaya","536",838,392,446
"3324185","Hambantota","Katuwana","Ulahitiyawa West","511",627,288,339
"3324190","Hambantota","Katuwana","Ulahitiyawa","509",387,204,183
"3324195","Hambantota","Katuwana","Ulahitiyawa East","510",733,353,380
"3324200","Hambantota","Katuwana","Adalugoda","504",543,252,291
"3324205","Hambantota","Katuwana","Mellaketigoda","505",579,288,291
"3324210","Hambantota","Katuwana","Araboda","540",607,289,318
"3324215","Hambantota","Katuwana","Horavinna","537",777,394,383
"3324220","Hambantota","Katuwana","Hediwatta","538",621,278,343
"3324225","Hambantota","Katuwana","Weerakkuttigoda","534",1043,505,538
"3324230","Hambantota","Katuwana","Ranasingoda","532",751,367,384
"3324235","Hambantota","Katuwana","Obadagahadeniya","533",790,389,401
"3324240","Hambantota","Katuwana","Wathukanda","544",962,457,505
"3324245","Hambantota","Katuwana","Kongasthenna","545",808,404,404
"3324250","Hambantota","Katuwana","Galpothukanda","546",792,395,397
"3324255","Hambantota","Katuwana","Ambagahahena","547",1040,515,525
"3324260","Hambantota","Katuwana","Karametiya","543",1151,548,603
"3324265","Hambantota","Katuwana","Puwakgas Ara","548",826,381,445
"3324270","Hambantota","Katuwana","Binthenna","549",858,411,447
"3324275","Hambantota","Katuwana","Bookendayaya","539",640,306,334
"3324280","Hambantota","Katuwana","Walgammulla","550",1227,608,619
"3325005","Hambantota","Walasmulla","Rammala","562",762,387,375
"3325010","Hambantota","Walasmulla","Saputhanthirikanda","561",669,312,357
"3325015","Hambantota","Walasmulla","Warapitiya","559",783,387,396
"3325020","Hambantota","Walasmulla","Keredeniya","560",664,325,339
"3325025","Hambantota","Walasmulla","Haggitha Kanda North","542",777,357,420
"3325030","Hambantota","Walasmulla","Konkarahena","541",902,409,493
"3325035","Hambantota","Walasmulla","Mapitakanda","552",887,407,480
"3325040","Hambantota","Walasmulla","Radani Ara","570",940,459,481
"3325045","Hambantota","Walasmulla","Namaneliya","572",742,351,391
"3325050","Hambantota","Walasmulla","Udahagoda","573",1046,496,550
"3325055","Hambantota","Walasmulla","Weedikanda","571",656,296,360
"3325060","Hambantota","Walasmulla","Galwadiya","432",774,369,405
"3325065","Hambantota","Walasmulla","Uda Julampitiya","430",928,442,486
"3325070","Hambantota","Walasmulla","Julampitiya","433",768,381,387
"3325075","Hambantota","Walasmulla","Palle Julampitiya","431",815,402,413
"3325080","Hambantota","Walasmulla","Pahala Obada","437",726,339,387
"3325085","Hambantota","Walasmulla","Bowala North","464",750,391,359
"3325090","Hambantota","Walasmulla","Bowala West","462",717,363,354
"3325095","Hambantota","Walasmulla","Welandagoda","551",929,456,473
"3325100","Hambantota","Walasmulla","Batagassa","553",800,375,425
"3325105","Hambantota","Walasmulla","Pahalawatta","554",1039,459,580
"3325110","Hambantota","Walasmulla","Pathegama","563",716,350,366
"3325115","Hambantota","Walasmulla","Thalapathkanda","565",797,400,397
"3325120","Hambantota","Walasmulla","Dehigahahena","564",826,404,422
"3325125","Hambantota","Walasmulla","Veedapola","568",523,270,253
"3325130","Hambantota","Walasmulla","Mathuwakanda","567",668,330,338
"3325135","Hambantota","Walasmulla","Handugala","566",825,407,418
"3325140","Hambantota","Walasmulla","Kebellaketiya","557",637,310,327
"3325145","Hambantota","Walasmulla","Egodabedda","555",761,365,396
"3325150","Hambantota","Walasmulla","Kekiriobada","556",639,316,323
"3325155","Hambantota","Walasmulla","Agalabada","569",860,416,444
"3325160","Hambantota","Walasmulla","Bowala South","463",545,257,288
"3325165","Hambantota","Walasmulla","Ihala  Muruthawela","434",742,368,374
"3325170","Hambantota","Walasmulla","Muruthawela Pahala","435",589,286,303
"3325175","Hambantota","Walasmulla","Galahitiya North","449",445,213,232
"3325180","Hambantota","Walasmulla","Omara East","452",827,371,456
"3325185","Hambantota","Walasmulla","Omara West","451",768,345,423
"3325190","Hambantota","Walasmulla","Ethpitiya","460",1406,659,747
"3325195","Hambantota","Walasmulla","Wattehengoda","575",1176,568,608
"3325200","Hambantota","Walasmulla","Horewela","574",1255,611,644
"3325205","Hambantota","Walasmulla","Pissubedda","558",444,223,221
"3325210","Hambantota","Walasmulla","Medagamgoda","576",845,399,446
"3325215","Hambantota","Walasmulla","Yahalmulla","461",1347,641,706
"3325220","Hambantota","Walasmulla","Ihala Walasmulla","457",743,342,401
"3325225","Hambantota","Walasmulla","Pahala Walasmulla","458",771,370,401
"3325230","Hambantota","Walasmulla","Galahitiya South","450",433,214,219
"3325235","Hambantota","Walasmulla","Galahitiya East","448",850,429,421
"3325240","Hambantota","Walasmulla","Koholana","456",702,338,364
"3325245","Hambantota","Walasmulla","Walasmulla East","454",764,384,380
"3325250","Hambantota","Walasmulla","Walasmulla North","455",291,164,127
"3325255","Hambantota","Walasmulla","Walasmulla West","459",1515,718,797
"3325260","Hambantota","Walasmulla","Walasmulla South","453",686,332,354
"3325265","Hambantota","Walasmulla","Daluwakgoda","465",804,394,410
"3327005","Hambantota","Okewela","Kanumuldeniya North","469",739,350,389
"3327010","Hambantota","Okewela","Olu Ara","467",708,326,382
"3327015","Hambantota","Okewela","Kanumuldeniya West","466",1565,761,804
"3327020","Hambantota","Okewela","Kanumuldeniya East","471",729,324,405
"3327025","Hambantota","Okewela","Udadeniya","474",975,462,513
"3327030","Hambantota","Okewela","Kurunduwatta","472",611,275,336
"3327035","Hambantota","Okewela","Sumihirigama","468",910,457,453
"3327040","Hambantota","Okewela","Rajapuragoda","473",771,368,403
"3327045","Hambantota","Okewela","Wijayasiripura","470",1178,560,618
"3327050","Hambantota","Okewela","Morakandegoda","480",725,354,371
"3327055","Hambantota","Okewela","Kadigamuwa East","483",648,311,337
"3327060","Hambantota","Okewela","Thalahagamwaduwa Pahala","482",529,236,293
"3327065","Hambantota","Okewela","Thalahagamwaduwa Ihala","481",815,394,421
"3327070","Hambantota","Okewela","Nathuwala","476",816,396,420
"3327075","Hambantota","Okewela","Kandebedda","478",685,335,350
"3327080","Hambantota","Okewela","Godawenna","479",432,199,233
"3327085","Hambantota","Okewela","Kahatellagoda","477",619,293,326
"3327090","Hambantota","Okewela","Kanumuldeniya South","475",654,302,352
"3327095","Hambantota","Okewela","Kadigamuwa West","484",546,246,300
"3327100","Hambantota","Okewela","Wawwa","491",669,308,361
"3327105","Hambantota","Okewela","Modarawana North","485",527,243,284
"3327110","Hambantota","Okewela","Modarawana South","486",600,299,301
"3327115","Hambantota","Okewela","Okewela","487",819,410,409
"3327120","Hambantota","Okewela","Heenatihathamuna","492",458,212,246
"3327125","Hambantota","Okewela","Pallewawwa","490",371,167,204
"3327130","Hambantota","Okewela","Pahala Yatigala","489",514,247,267
"3327135","Hambantota","Okewela","Yatigala Ihala","488",405,180,225
"3330005","Hambantota","Beliatta","Maligathenna","325",440,212,228
"3330010","Hambantota","Beliatta","Udugalmotegama","324",728,364,364
"3330015","Hambantota","Beliatta","Pallattara West","321",613,282,331
"3330020","Hambantota","Beliatta","Pallattara South","322",428,199,229
"3330025","Hambantota","Beliatta","Pallattara East","320",700,334,366
"3330030","Hambantota","Beliatta","Nugewela","310",899,421,478
"3330035","Hambantota","Beliatta","Ihala Beligalla East","311",572,268,304
"3330040","Hambantota","Beliatta","Wadiya","313",550,245,305
"3330045","Hambantota","Beliatta","Ihala Beligalla West","312",524,248,276
"3330050","Hambantota","Beliatta","Beligalla North","314",904,408,496
"3330055","Hambantota","Beliatta","Beligalla South","315",490,227,263
"3330060","Hambantota","Beliatta","Dammulla East","319",853,403,450
"3330065","Hambantota","Beliatta","Dammulla West","318",359,159,200
"3330070","Hambantota","Beliatta","Pattiyawela","328",682,326,356
"3330075","Hambantota","Beliatta","Tharaperiya","323",442,208,234
"3330080","Hambantota","Beliatta","Nihiluwa West","327",924,444,480
"3330085","Hambantota","Beliatta","Indiketiyagoda","326",405,191,214
"3330090","Hambantota","Beliatta","Nihiluwa East","329",1044,492,552
"3330095","Hambantota","Beliatta","Waharakgoda North","330",731,335,396
"3330100","Hambantota","Beliatta","Waharakgoda South","331",439,216,223
"3330105","Hambantota","Beliatta","Kahawatta","348",1187,572,615
"3330110","Hambantota","Beliatta","Kosgahagoda","317",624,295,329
"3330115","Hambantota","Beliatta","Agulmaduwa","316",851,371,480
"3330120","Hambantota","Beliatta","Aranwela North","334",797,393,404
"3330125","Hambantota","Beliatta","Karambaketiya","350",766,384,382
"3330130","Hambantota","Beliatta","Galwewa","349",932,462,470
"3330135","Hambantota","Beliatta","Godawela","332",834,411,423
"3330140","Hambantota","Beliatta","Panamulla","333",547,255,292
"3330145","Hambantota","Beliatta","Ambagasdeniya","341",751,359,392
"3330150","Hambantota","Beliatta","Getamanna North","339",762,360,402
"3330155","Hambantota","Beliatta","Eldeniya","342",916,440,476
"3330160","Hambantota","Beliatta","Getamanna West","337",723,336,387
"3330165","Hambantota","Beliatta","Getamanna East","340",537,267,270
"3330170","Hambantota","Beliatta","Mahaheella East","343",1116,535,581
"3330175","Hambantota","Beliatta","Kambussawala West","347",380,200,180
"3330180","Hambantota","Beliatta","Kambussawala East","346",892,421,471
"3330185","Hambantota","Beliatta","Beliatta West","353",645,335,310
"3330190","Hambantota","Beliatta","Beliatta Town","351",822,399,423
"3330195","Hambantota","Beliatta","Puwakdandawa North","354",1088,554,534
"3330200","Hambantota","Beliatta","Puwakdandawa East","357",1240,577,663
"3330205","Hambantota","Beliatta","Aranwela West","335",870,414,456
"3330210","Hambantota","Beliatta","Sitinamaluwa West","358",719,349,370
"3330215","Hambantota","Beliatta","Sitinamaluwa North","359",1195,566,629
"3330220","Hambantota","Beliatta","Sitinamaluwa East","360",1437,674,763
"3330225","Hambantota","Beliatta","Sitinamaluwa South","361",1010,485,525
"3330230","Hambantota","Beliatta","Pahalagoda","356",771,369,402
"3330235","Hambantota","Beliatta","Medagoda","355",969,455,514
"3330240","Hambantota","Beliatta","Beliatta South","352",831,390,441
"3330245","Hambantota","Beliatta","Kudaheella East","366",672,329,343
"3330250","Hambantota","Beliatta","Kudaheella North","368",1660,774,886
"3330255","Hambantota","Beliatta","Mahaheella West","344",1059,522,537
"3330260","Hambantota","Beliatta","Mahaheella North","345",415,205,210
"3330265","Hambantota","Beliatta","Getamanna South","336",725,347,378
"3330270","Hambantota","Beliatta","Nayakawatta","338",1438,681,757
"3330275","Hambantota","Beliatta","Ambala North","371",808,409,399
"3330280","Hambantota","Beliatta","Ambala West","370",653,308,345
"3330285","Hambantota","Beliatta","Miriswatta","369",812,378,434
"3330290","Hambantota","Beliatta","Kudaheella South","367",1229,595,634
"3330295","Hambantota","Beliatta","Ovilana","365",542,262,280
"3330300","Hambantota","Beliatta","Mihindupura","364",734,369,365
"3330305","Hambantota","Beliatta","Palapotha East","363",930,439,491
"3330310","Hambantota","Beliatta","Palapotha West","362",476,229,247
"3330315","Hambantota","Beliatta","Dedduwawala East","373",753,356,397
"3330320","Hambantota","Beliatta","Dedduwawala","372",636,310,326
"3330325","Hambantota","Beliatta","Galagama North","377",747,363,384
"3330330","Hambantota","Beliatta","Galagama West","378",592,263,329
"3330335","Hambantota","Beliatta","Galagama South","379",727,362,365
"3330340","Hambantota","Beliatta","Galagama East","380",643,293,350
"3330345","Hambantota","Beliatta","Nakulugamuwa West","374",1130,516,614
"3330350","Hambantota","Beliatta","Nakulugamuwa North","375",1030,480,550
"3330355","Hambantota","Beliatta","Wevudatta","376",642,297,345
"3333005","Hambantota","Tangalle","Sudarshanagama","307",1130,545,585
"3333010","Hambantota","Tangalle","Pattiyapola West","261",1005,508,497
"3333015","Hambantota","Tangalle","Thalunna","248",1187,565,622
"3333020","Hambantota","Tangalle","Andupelena","247",914,468,446
"3333025","Hambantota","Tangalle","Kadiragoda","246",899,408,491
"3333030","Hambantota","Tangalle","Gotaimbaragama","250",521,247,274
"3333035","Hambantota","Tangalle","Kattakaduwa North","249",1175,570,605
"3333040","Hambantota","Tangalle","Kattakaduwa South","251",1671,833,838
"3333045","Hambantota","Tangalle","Ranna East","253",1757,864,893
"3333050","Hambantota","Tangalle","Ranna West","252",1773,871,902
"3333055","Hambantota","Tangalle","Vigamuwa","245",1367,647,720
"3333060","Hambantota","Tangalle","Pattiyapola East","263",829,401,428
"3333065","Hambantota","Tangalle","Pattiyapola South","262",864,385,479
"3333070","Hambantota","Tangalle","Vitharandeniya North","308",643,296,347
"3333075","Hambantota","Tangalle","Thenagama South","306",504,239,265
"3333080","Hambantota","Tangalle","Thenagama North","305",436,198,238
"3333085","Hambantota","Tangalle","Thalapitiyagama","304",305,145,160
"3333090","Hambantota","Tangalle","Ethgalmulla","303",722,347,375
"3333095","Hambantota","Tangalle","Uduvilagoda","302",445,214,231
"3333100","Hambantota","Tangalle","Vitharandeniya South","309",763,375,388
"3333105","Hambantota","Tangalle","Aluthgoda","266",611,278,333
"3333110","Hambantota","Tangalle","Palathuduwa","267",627,312,315
"3333115","Hambantota","Tangalle","Marakolliya","259",1198,589,609
"3333120","Hambantota","Tangalle","Medagama","258",1179,538,641
"3333125","Hambantota","Tangalle","Netolpitiya North","256",1622,800,822
"3333130","Hambantota","Tangalle","Netolpitiya South","257",1777,870,907
"3333135","Hambantota","Tangalle","Wadigala","244",1386,684,702
"3333140","Hambantota","Tangalle","Kahandawa","243",1690,810,880
"3333145","Hambantota","Tangalle","Nidahasgama West","241",1302,638,664
"3333150","Hambantota","Tangalle","Nidahasgama East","240",1640,782,858
"3333155","Hambantota","Tangalle","Kahandamodara","239",859,434,425
"3333160","Hambantota","Tangalle","Gurupokuna","238",423,222,201
"3333165","Hambantota","Tangalle","Wella Odaya","242",1348,705,643
"3333170","Hambantota","Tangalle","Rekawa East","254",761,359,402
"3333175","Hambantota","Tangalle","Rekawa West","255",1038,511,527
"3333180","Hambantota","Tangalle","Medilla","260",1109,567,542
"3333185","Hambantota","Tangalle","Walgameliya","265",919,441,478
"3333190","Hambantota","Tangalle","Godawanagoda","264",1007,467,540
"3333195","Hambantota","Tangalle","Wagegoda","300",754,339,415
"3333200","Hambantota","Tangalle","Nalagama East","301",414,191,223
"3333205","Hambantota","Tangalle","Siyambalagoda","298",689,342,347
"3333210","Hambantota","Tangalle","Nalagama West","299",555,255,300
"3333215","Hambantota","Tangalle","Polommaruwa North","282",1209,586,623
"3333220","Hambantota","Tangalle","Danketiya","269",2539,1241,1298
"3333225","Hambantota","Tangalle","Medaketiya","268",1562,771,791
"3333230","Hambantota","Tangalle","Kotuwegoda","272",563,277,286
"3333235","Hambantota","Tangalle","Indipokunagoda North","270",1921,909,1012
"3333240","Hambantota","Tangalle","Polommaruwa South","281",1242,624,618
"3333245","Hambantota","Tangalle","Kadurupokuna East","277",1221,586,635
"3333250","Hambantota","Tangalle","Indipokunagoda South","271",573,243,330
"3333255","Hambantota","Tangalle","Pallikkudawa Urban","273",1315,691,624
"3333260","Hambantota","Tangalle","Pallikkudawa Rural","274",1134,537,597
"3333265","Hambantota","Tangalle","Kadurupokuna South","280",1744,855,889
"3333270","Hambantota","Tangalle","Kadurupokuna North","279",624,305,319
"3333275","Hambantota","Tangalle","Kadurupokuna West","278",887,429,458
"3333280","Hambantota","Tangalle","Seenimodara West","297",1365,636,729
"3333285","Hambantota","Tangalle","Seenimodara East","296",888,420,468
"3333290","Hambantota","Tangalle","Unakooruwa West","276",1093,541,552
"3333295","Hambantota","Tangalle","Unakooruwa East","275",1183,600,583
"3333300","Hambantota","Tangalle","Moraketi Ara East","295",443,201,242
"3333305","Hambantota","Tangalle","Moraketi Ara West","294",920,446,474
"3333310","Hambantota","Tangalle","Pahajjawa","284",1114,548,566
"3333315","Hambantota","Tangalle","Mahawela","283",486,228,258
"3333320","Hambantota","Tangalle","Ihalagoda","286",707,346,361
"3333325","Hambantota","Tangalle","Nakulugamuwa South","285",464,233,231
"3333330","Hambantota","Tangalle","Kudawella North","289",1098,508,590
"3333335","Hambantota","Tangalle","Kudawella Central","290",884,437,447
"3333340","Hambantota","Tangalle","Kudawella East","287",711,350,361
"3333345","Hambantota","Tangalle","Mawella South","293",501,231,270
"3333350","Hambantota","Tangalle","Mawella North","292",182,83,99
"3333355","Hambantota","Tangalle","Kudawella South","291",1354,655,699
"3333360","Hambantota","Tangalle","Kudawella West","288",762,395,367
"8103005","Badulla","Mahiyanganaya","Rotalawela","1M",1878,905,973
"8103010","Badulla","Mahiyanganaya","Divulapelessa","1C",2167,1073,1094
"8103015","Badulla","Mahiyanganaya","Aluyatawela","1I",1900,940,960
"8103020","Badulla","Mahiyanganaya","Theldeniyaya","1L",2014,965,1049
"8103025","Badulla","Mahiyanganaya","Hebarawa","1A",1581,795,786
"8103030","Badulla","Mahiyanganaya","Ginnoruwa","1J",1364,666,698
"8103035","Badulla","Mahiyanganaya","Belaganwewa","1G",1879,905,974
"8103040","Badulla","Mahiyanganaya","Ulhitiya","1R",1832,909,923
"8103045","Badulla","Mahiyanganaya","Pahala Rathkinda","1D",2502,1212,1290
"8103050","Badulla","Mahiyanganaya","Hobariyawa","1N",2395,1179,1216
"8103055","Badulla","Mahiyanganaya","Millattawa","1P",2494,1174,1320
"8103060","Badulla","Mahiyanganaya","Viranegama","1E",1652,782,870
"8103065","Badulla","Mahiyanganaya","Aluttarama","1H",1567,770,797
"8103070","Badulla","Mahiyanganaya","Girandurukotte","1F",4027,1977,2050
"8103075","Badulla","Mahiyanganaya","Bathalayaya","1",3196,1567,1629
"8103080","Badulla","Mahiyanganaya","Haddattawa","2A",2023,1003,1020
"8103085","Badulla","Mahiyanganaya","Meegahahena","1K",1682,823,859
"8103090","Badulla","Mahiyanganaya","Galporuyaya","1B",2479,1240,1239
"8103095","Badulla","Mahiyanganaya","Beligalla","7",2405,1189,1216
"8103100","Badulla","Mahiyanganaya","Dambana","7A",2179,1119,1060
"8103105","Badulla","Mahiyanganaya","Kukulapola","8",1242,634,608
"8103110","Badulla","Mahiyanganaya","Wewatta","8A",1881,950,931
"8103115","Badulla","Mahiyanganaya","Thalangamuwa","2C",2004,1024,980
"8103120","Badulla","Mahiyanganaya","Sorabora","2B",1978,1000,978
"8103125","Badulla","Mahiyanganaya","Wewgampaha","2",3350,1667,1683
"8103130","Badulla","Mahiyanganaya","Dehigolla","3B",2285,1127,1158
"8103135","Badulla","Mahiyanganaya","Elewela","3C",2329,1093,1236
"8103140","Badulla","Mahiyanganaya","Mahiyanganaya Town","3A",2700,1467,1233
"8103145","Badulla","Mahiyanganaya","Poojanagaraya","3D",2248,1099,1149
"8103150","Badulla","Mahiyanganaya","Dambarawa","3",2113,1026,1087
"8103155","Badulla","Mahiyanganaya","Senanigama","4D",2202,1025,1177
"8103160","Badulla","Mahiyanganaya","Mapakadawewa","4A",2720,1307,1413
"8103165","Badulla","Mahiyanganaya","Pangaragammana","4",2076,968,1108
"8103170","Badulla","Mahiyanganaya","Dambagolla","4C",1993,990,1003
"8103175","Badulla","Mahiyanganaya","Medayaya","4B",1439,706,733
"8106005","Badulla","Rideemaliyadda","Orubendiwewa","02D",1698,857,841
"8106010","Badulla","Rideemaliyadda","Sangabopura","02K",1298,620,678
"8106015","Badulla","Rideemaliyadda","Welampele","02E",2106,1007,1099
"8106020","Badulla","Rideemaliyadda","Keselpotha North","02B",1960,965,995
"8106025","Badulla","Rideemaliyadda","Ikiriyagoda","02G",1464,754,710
"8106030","Badulla","Rideemaliyadda","Kandubedda","09D",882,461,421
"8106035","Badulla","Rideemaliyadda","Aralupitiya","09C",1062,523,539
"8106040","Badulla","Rideemaliyadda","Ekiriyankumbura","09",1322,646,676
"8106045","Badulla","Rideemaliyadda","Dehigama","09A",2130,1049,1081
"8106050","Badulla","Rideemaliyadda","Morana","09B",378,187,191
"8106055","Badulla","Rideemaliyadda","Kudalunuka","10A",1014,481,533
"8106060","Badulla","Rideemaliyadda","Aluketiyawa","06",590,279,311
"8106065","Badulla","Rideemaliyadda","Keselpotha South","02F",1630,813,817
"8106070","Badulla","Rideemaliyadda","Serana","02C",2132,1026,1106
"8106075","Badulla","Rideemaliyadda","Arawatta","02L",1638,785,853
"8106080","Badulla","Rideemaliyadda","Uva Gemunupura","02A",1695,790,905
"8106085","Badulla","Rideemaliyadda","Senevigama","02J",1901,910,991
"8106090","Badulla","Rideemaliyadda","Uva Thissapura","06A",2249,1098,1151
"8106095","Badulla","Rideemaliyadda","Gamakumbura North","06E",1125,528,597
"8106100","Badulla","Rideemaliyadda","Kuralewela","06C",553,277,276
"8106105","Badulla","Rideemaliyadda","Nagadeepa","06B",819,405,414
"8106110","Badulla","Rideemaliyadda","Mahalunuka","10",1322,655,667
"8106115","Badulla","Rideemaliyadda","Pethiyagoda","11A",1487,716,771
"8106120","Badulla","Rideemaliyadda","Rideemaliyadda South","11B",1793,887,906
"8106125","Badulla","Rideemaliyadda","Rideemaliyadda North","11",1235,607,628
"8106130","Badulla","Rideemaliyadda","Uraniya","11C",608,297,311
"8106135","Badulla","Rideemaliyadda","Kotathalawa","05",558,290,268
"8106140","Badulla","Rideemaliyadda","Andaulpatha","05A",1765,847,918
"8106145","Badulla","Rideemaliyadda","Gamakumbura South","06F",628,302,326
"8106150","Badulla","Rideemaliyadda","Abhayapura","02H",1538,753,785
"8106155","Badulla","Rideemaliyadda","Dikkendayaya","06D",1076,511,565
"8106160","Badulla","Rideemaliyadda","Pahalaoyagama","05B",1010,482,528
"8106165","Badulla","Rideemaliyadda","Bubula","13B",974,466,508
"8106170","Badulla","Rideemaliyadda","Ritigahaarawa","12",477,235,242
"8106175","Badulla","Rideemaliyadda","Kandegama","12A",783,376,407
"8106180","Badulla","Rideemaliyadda","Mahagama","13",868,413,455
"8106185","Badulla","Rideemaliyadda","Kuruvithenna","13A",1482,730,752
"8106190","Badulla","Rideemaliyadda","Deekirigolla","14A",670,344,326
"8106195","Badulla","Rideemaliyadda","Pinnagolla","14",950,453,497
"8106200","Badulla","Rideemaliyadda","Arawa","15",773,411,362
"8106205","Badulla","Rideemaliyadda","Dikyaya","15A",682,322,360
"8106210","Badulla","Rideemaliyadda","Diyakombala","11D",1293,605,688
"8109005","Badulla","Meegahakivula","Karametiya","22D",1514,743,771
"8109010","Badulla","Meegahakivula","Balagolla","22A",1234,597,637
"8109015","Badulla","Meegahakivula","Aggalaulpatha","22C",1394,687,707
"8109020","Badulla","Meegahakivula","Karandagahamada","22B",1206,596,610
"8109025","Badulla","Meegahakivula","Polgaha Arawa","22E",729,373,356
"8109030","Badulla","Meegahakivula","Polwatta","16D",364,181,183
"8109035","Badulla","Meegahakivula","Watagommana","16E",368,180,188
"8109040","Badulla","Meegahakivula","Roberiya","18F",2046,949,1097
"8109045","Badulla","Meegahakivula","Pitamaruwa","16A",906,425,481
"8109050","Badulla","Meegahakivula","Wewathenna","16B",453,217,236
"8109055","Badulla","Meegahakivula","Ellanda","16C",646,309,337
"8109060","Badulla","Meegahakivula","Kalugahakandura","16",663,312,351
"8109065","Badulla","Meegahakivula","Komarika","22F",1216,594,622
"8109070","Badulla","Meegahakivula","Akurukaduwa","22G",1465,701,764
"8109075","Badulla","Meegahakivula","Meegahakivula","22",1340,672,668
"8109080","Badulla","Meegahakivula","Thaldena","23",1532,712,820
"8109085","Badulla","Meegahakivula","Kohana","23C",564,266,298
"8109090","Badulla","Meegahakivula","Ketawatta","21A",870,416,454
"8109095","Badulla","Meegahakivula","Morahela","21",556,286,270
"8109100","Badulla","Meegahakivula","Hunuketapitiya","23B",653,315,338
"8112005","Badulla","Kandaketiya","Mahakele","31F",1086,550,536
"8112010","Badulla","Kandaketiya","Baduluoya West","31A",987,457,530
"8112015","Badulla","Kandaketiya","Kandakepoo Ulpotha","31D",790,388,402
"8112020","Badulla","Kandaketiya","Hevandana","31C",666,312,354
"8112025","Badulla","Kandaketiya","Mahathenna","30C",1004,498,506
"8112030","Badulla","Kandaketiya","Baduluoya East","30A",1831,923,908
"8112035","Badulla","Kandaketiya","Kandaketiya","31B",946,469,477
"8112040","Badulla","Kandaketiya","Welaoya","31E",768,382,386
"8112045","Badulla","Kandaketiya","Kivulegedara","31G",1222,576,646
"8112050","Badulla","Kandaketiya","Kirivehera","31H",1137,586,551
"8112055","Badulla","Kandaketiya","Wewathenna","30B",877,423,454
"8112060","Badulla","Kandaketiya","Maliyadda","30",1061,538,523
"8112065","Badulla","Kandaketiya","Pallewela","31",630,293,337
"8112070","Badulla","Kandaketiya","Mudagamuwa","32A",613,298,315
"8112075","Badulla","Kandaketiya","Dikkumbura","32B",649,315,334
"8112080","Badulla","Kandaketiya","Hapathgamuwa","32C",586,281,305
"8112085","Badulla","Kandaketiya","Bopitiya","33A",420,196,224
"8112090","Badulla","Kandaketiya","Bogahakumbura","33",763,370,393
"8112095","Badulla","Kandaketiya","Beramada","35A",927,439,488
"8112100","Badulla","Kandaketiya","Godunna","32",685,324,361
"8112105","Badulla","Kandaketiya","Wasanagama","32D",467,223,244
"8112110","Badulla","Kandaketiya","Thetilla","35C",664,315,349
"8112115","Badulla","Kandaketiya","Thalakumbura","35E",854,401,453
"8112120","Badulla","Kandaketiya","Galauda","35",1230,592,638
"8112125","Badulla","Kandaketiya","Bokanoruwa","35B",1596,749,847
"8112130","Badulla","Kandaketiya","Narangala","35D",616,290,326
"8115005","Badulla","Soranathota","Idamepanguwa","34",348,161,187
"8115010","Badulla","Soranathota","Budugekanda","29A",467,221,246
"8115015","Badulla","Soranathota","Pallekanda","29B",424,199,225
"8115020","Badulla","Soranathota","Boliyadda","23A",956,444,512
"8115025","Badulla","Soranathota","Pathanegedara","24B",532,262,270
"8115030","Badulla","Soranathota","Egodawela","24",557,254,303
"8115035","Badulla","Soranathota","Wattekele","24A",287,139,148
"8115040","Badulla","Soranathota","Pussellawa","23AA",1218,768,450
"8115045","Badulla","Soranathota","Pussellakanda","28A",892,406,486
"8115050","Badulla","Soranathota","Moragolla","29",537,263,274
"8115055","Badulla","Soranathota","Dikpitiya","34A",916,420,496
"8115060","Badulla","Soranathota","Ledgerwatta","27C",924,416,508
"8115065","Badulla","Soranathota","Idamegama","27B",1493,693,800
"8115070","Badulla","Soranathota","Soranathota","28",914,419,495
"8115075","Badulla","Soranathota","Yatilellagama","26A",775,362,413
"8115080","Badulla","Soranathota","Ambagasdowa","25C",790,393,397
"8115085","Badulla","Soranathota","Ketakellagama","25B",1129,511,618
"8115090","Badulla","Soranathota","Kuttiyagolla","25A",1019,467,552
"8115095","Badulla","Soranathota","Angoda","25",515,248,267
"8115100","Badulla","Soranathota","Kosgolla","25D",806,386,420
"8115105","Badulla","Soranathota","Rideepana","26C",1830,859,971
"8115110","Badulla","Soranathota","Kohovila","26",1343,647,696
"8115115","Badulla","Soranathota","Kithulwattagama","26B",636,300,336
"8115120","Badulla","Soranathota","Kirioruwa","27",1700,754,946
"8115125","Badulla","Soranathota","Kandegedara Town","27A",1563,703,860
"8118005","Badulla","Passara","Demodara","20",659,323,336
"8118010","Badulla","Passara","Palawatta","20B",720,348,372
"8118015","Badulla","Passara","Kahataruppa","19A",950,466,484
"8118020","Badulla","Passara","Dambakote","20A",1118,527,591
"8118025","Badulla","Passara","Madugasthalawa North","19",610,284,326
"8118030","Badulla","Passara","Thalagahagedara","19B",858,407,451
"8118035","Badulla","Passara","Welgolla","89D",942,464,478
"8118040","Badulla","Passara","Madugasthalawa South","19C",928,443,485
"8118045","Badulla","Passara","Gerandiella","89F",1607,743,864
"8118050","Badulla","Passara","Maligathenna","89E",823,375,448
"8118055","Badulla","Passara","Medawelagama","89",2101,994,1107
"8118060","Badulla","Passara","Paramahankada","89I",920,407,513
"8118065","Badulla","Passara","Nikebedda","89H",1878,909,969
"8118070","Badulla","Passara","Udagama","89A",1098,512,586
"8118075","Badulla","Passara","Pelgahathenna","89G",2571,1194,1377
"8118080","Badulla","Passara","Sapuroda","89B",1058,500,558
"8118085","Badulla","Passara","Palagolla","88H",1034,491,543
"8118090","Badulla","Passara","Gonagala West","88C",807,374,433
"8118095","Badulla","Passara","Gonagala East","88I",1329,634,695
"8118100","Badulla","Passara","Kanahela","88A",1188,570,618
"8118105","Badulla","Passara","Pallegama","88G",1133,531,602
"8118110","Badulla","Passara","Passara Town North","88B",1387,691,696
"8118115","Badulla","Passara","Passara Town South","88K",854,426,428
"8118120","Badulla","Passara","Passara Town East","88L",1188,570,618
"8118125","Badulla","Passara","Ambathenna West","88M",1812,871,941
"8118130","Badulla","Passara","Thennuge","88D",1162,557,605
"8118135","Badulla","Passara","Meedumpitiya","90B",2080,969,1111
"8118140","Badulla","Passara","Kudugala Pathana","90D",1009,452,557
"8118145","Badulla","Passara","Tholabowatta","90",1416,694,722
"8118150","Badulla","Passara","Ambathenna","88F",560,259,301
"8118155","Badulla","Passara","Meeriyabedda","88",1770,814,956
"8118160","Badulla","Passara","Puhulwatta","88J",1705,790,915
"8118165","Badulla","Passara","Maussagolla West","87A",1318,612,706
"8118170","Badulla","Passara","Kanawerella West","87C",780,325,455
"8118175","Badulla","Passara","Kanawerella","87",1908,931,977
"8118180","Badulla","Passara","Kanawerella East","87D",1954,913,1041
"8118185","Badulla","Passara","Bibilegama West","87B",1090,494,596
"8118190","Badulla","Passara","Wewekele","87G",380,176,204
"8118195","Badulla","Passara","Bibilegama East","87E",385,189,196
"8118200","Badulla","Passara","Maussagolla East","87F",1144,540,604
"8118205","Badulla","Passara","Dambewela","88E",573,266,307
"8119005","Badulla","Lunugala","Ekiriya","17",913,443,470
"8119010","Badulla","Lunugala","Metigahathenna","18",928,431,497
"8119015","Badulla","Lunugala","Galwelagama","18C",330,153,177
"8119020","Badulla","Lunugala","Wewabedda","18A",1652,785,867
"8119025","Badulla","Lunugala","Janathapura North","95A",476,217,259
"8119030","Badulla","Lunugala","Arawakumbura","94C",1529,713,816
"8119035","Badulla","Lunugala","Udakiruwa","92A",385,188,197
"8119040","Badulla","Lunugala","Alakolagala","94E",970,459,511
"8119045","Badulla","Lunugala","Udapanguwa","94",1576,738,838
"8119050","Badulla","Lunugala","Lunugala Town","94A",1432,684,748
"8119055","Badulla","Lunugala","Janathapura South","95B",415,191,224
"8119060","Badulla","Lunugala","Janathapura","95",1135,547,588
"8119065","Badulla","Lunugala","Batawatta","18D",1372,663,709
"8119070","Badulla","Lunugala","Gallulla","18B",1316,611,705
"8119075","Badulla","Lunugala","Madulsima","89C",3068,1408,1660
"8119080","Badulla","Lunugala","Sumudugama","94G",1321,607,714
"8119085","Badulla","Lunugala","Attanagolla","94F",999,467,532
"8119090","Badulla","Lunugala","Sooriyagoda","94D",712,353,359
"8119095","Badulla","Lunugala","Weragoda","92B",233,116,117
"8119100","Badulla","Lunugala","Pallekiruwa","92",669,337,332
"8119105","Badulla","Lunugala","Kottalbedda","93",1742,779,963
"8119110","Badulla","Lunugala","Mahadowa","89J",1967,932,1035
"8119115","Badulla","Lunugala","Yapamma","94B",968,447,521
"8119120","Badulla","Lunugala","Peessagama","94I",728,330,398
"8119125","Badulla","Lunugala","Rendapola","94J",813,368,445
"8119130","Badulla","Lunugala","Hopton","94H",1076,499,577
"8119135","Badulla","Lunugala","Maduwatta","90C",2057,976,1081
"8119140","Badulla","Lunugala","Millabedda","90A",599,289,310
"8121005","Badulla","Badulla","Pitawelagama","78L",2824,1308,1516
"8121010","Badulla","Badulla","Badulla North","78A",4062,1948,2114
"8121015","Badulla","Badulla","Medapathana","78M",2297,1086,1211
"8121020","Badulla","Badulla","Kailagoda","78G",2440,1157,1283
"8121025","Badulla","Badulla","Andeniya","79A",2168,1026,1142
"8121030","Badulla","Badulla","Sirimalgoda","80A",2968,1363,1605
"8121035","Badulla","Badulla","Damanwara","80F",1630,769,861
"8121040","Badulla","Badulla","Hinnarangolla","81A",1674,791,883
"8121045","Badulla","Badulla","Kendagolla","81",2013,943,1070
"8121050","Badulla","Badulla","Thelbedda","81B",3670,1733,1937
"8121055","Badulla","Badulla","Ilukthenna","80B",1369,616,753
"8121060","Badulla","Badulla","Hegoda","79",2235,1036,1199
"8121065","Badulla","Badulla","Badulupitiya","78J",5153,2357,2796
"8121070","Badulla","Badulla","Badulla Central","78D",3347,1462,1885
"8121075","Badulla","Badulla","Badulla West","78C",2753,1203,1550
"8121080","Badulla","Badulla","Katupelella","78H",2437,1134,1303
"8121085","Badulla","Badulla","Badulla South","78",3557,1668,1889
"8121090","Badulla","Badulla","Badulla East","78B",4159,2156,2003
"8121095","Badulla","Badulla","Hindagoda","78K",3079,1451,1628
"8121100","Badulla","Badulla","Rambukpotha","80",2889,1354,1535
"8121105","Badulla","Badulla","Malangamuwa","80G",1298,618,680
"8121110","Badulla","Badulla","Viyadiguna","80E",1819,805,1014
"8121115","Badulla","Badulla","Vineethagama","80C",991,469,522
"8121120","Badulla","Badulla","Wewessa","80J",2143,1004,1139
"8121125","Badulla","Badulla","Welibissa","80I",922,422,500
"8121130","Badulla","Badulla","Glen Alpin","80H",2823,1361,1462
"8121135","Badulla","Badulla","Udawela","80D",2193,1060,1133
"8121140","Badulla","Badulla","Hingurugamuwa","78E",4139,1960,2179
"8121145","Badulla","Badulla","Kanupelella","78F",1990,919,1071
"8124005","Badulla","Hali-Ela","Kokatiyamaluwa","77A",1165,570,595
"8124010","Badulla","Hali-Ela","Wegama","77",1299,614,685
"8124015","Badulla","Hali-Ela","Jangulla","77B",1613,746,867
"8124020","Badulla","Hali-Ela","Landewela","76A",473,215,258
"8124025","Badulla","Hali-Ela","Bogoda","76",761,368,393
"8124030","Badulla","Hali-Ela","Panakanniya","75E",905,421,484
"8124035","Badulla","Hali-Ela","Ketawala","75C",1374,652,722
"8124040","Badulla","Hali-Ela","Udakohovila","74F",1744,842,902
"8124045","Badulla","Hali-Ela","Hethekma","75",1380,648,732
"8124050","Badulla","Hali-Ela","Deegalla","75A",1019,470,549
"8124055","Badulla","Hali-Ela","Pattipola","75B",1566,744,822
"8124060","Badulla","Hali-Ela","Anthuduwawela","74D",2110,1019,1091
"8124065","Badulla","Hali-Ela","Bogahamaditta","74B",2736,1317,1419
"8124070","Badulla","Hali-Ela","Mahawattagama","82C",3050,1436,1614
"8124075","Badulla","Hali-Ela","Dematawelhinna","82B",1684,743,941
"8124080","Badulla","Hali-Ela","Welikemulla","82A",1049,510,539
"8124085","Badulla","Hali-Ela","Unagolla","84A",1005,473,532
"8124090","Badulla","Hali-Ela","Medapitigama","74E",1888,880,1008
"8124095","Badulla","Hali-Ela","Dickwella","74",3469,1686,1783
"8124100","Badulla","Hali-Ela","Hali-Ela","74A",1166,624,542
"8124105","Badulla","Hali-Ela","Samagipura","74C",1886,896,990
"8124110","Badulla","Hali-Ela","Udagama","75D",782,353,429
"8124115","Badulla","Hali-Ela","Gawela","55C",2220,1068,1152
"8124120","Badulla","Hali-Ela","Pahamunuthota","55D",652,325,327
"8124125","Badulla","Hali-Ela","Neludanda","56D",899,455,444
"8124130","Badulla","Hali-Ela","Hinnarangolla","55E",1744,823,921
"8124135","Badulla","Hali-Ela","Mugunumatha West","73C",2617,1194,1423
"8124140","Badulla","Hali-Ela","Mugunumatha East","73B",1385,662,723
"8124145","Badulla","Hali-Ela","Godegama","84B",964,439,525
"8124150","Badulla","Hali-Ela","Medagama","84",1765,833,932
"8124155","Badulla","Hali-Ela","Imbulgoda","82",2560,1211,1349
"8124165","Badulla","Hali-Ela","Kandana","86",2045,932,1113
"8124170","Badulla","Hali-Ela","Bulathwatta","86A",924,421,503
"8124175","Badulla","Hali-Ela","Springvalley Estate","86B",1626,768,858
"8124180","Badulla","Hali-Ela","Springvalley","85B",779,360,419
"8124185","Badulla","Hali-Ela","Beddegama","85",1354,642,712
"8124190","Badulla","Hali-Ela","Wewelhinna","85A",2446,1132,1314
"8124195","Badulla","Hali-Ela","Uduwara","73",1865,869,996
"8124200","Badulla","Hali-Ela","Hapuwalakumbura","73A",2165,1046,1119
"8124205","Badulla","Hali-Ela","Kirinda","73D",1542,744,798
"8124210","Badulla","Hali-Ela","Morethota","56A",2682,1263,1419
"8124215","Badulla","Hali-Ela","Uva Mahawela","56B",1295,588,707
"8124220","Badulla","Hali-Ela","Etampitiya","55",1941,906,1035
"8124225","Badulla","Hali-Ela","Pallegama","55A",1004,513,491
"8124230","Badulla","Hali-Ela","Dehivinna","56",1668,813,855
"8124235","Badulla","Hali-Ela","Niliathugoda","56E",1188,574,614
"8124240","Badulla","Hali-Ela","Neluwa","56C",2012,930,1082
"8124245","Badulla","Hali-Ela","Kudumahuwela","57D",742,366,376
"8124250","Badulla","Hali-Ela","Wepassawela","57B",1256,596,660
"8124255","Badulla","Hali-Ela","Maligathenna","57H",2209,1022,1187
"8124260","Badulla","Hali-Ela","Perahettiya","57A",1468,701,767
"8124265","Badulla","Hali-Ela","Katugaha","57F",1291,616,675
"8124270","Badulla","Hali-Ela","Mahathenna","57E",1808,845,963
"8124275","Badulla","Hali-Ela","Malitta","57",1408,671,737
"8124280","Badulla","Hali-Ela","Kurukude","57C",1726,865,861
"8124285","Badulla","Hali-Ela","Warakadanda","57G",1217,623,594
"8127005","Badulla","Uva-Paranagama","Yalagamuwa","37E",847,405,442
"8127010","Badulla","Uva-Paranagama","Ritikumbura","37F",861,386,475
"8127015","Badulla","Uva-Paranagama","Wethalawa","37A",687,328,359
"8127020","Badulla","Uva-Paranagama","Maspanna","37",654,302,352
"8127025","Badulla","Uva-Paranagama","Kohilegama","37C",592,278,314
"8127030","Badulla","Uva-Paranagama","Ellanda","37D",588,264,324
"8127035","Badulla","Uva-Paranagama","Kindigoda","37B",484,229,255
"8127040","Badulla","Uva-Paranagama","Hathkinda","38B",510,238,272
"8127045","Badulla","Uva-Paranagama","Dimbulana","38A",920,423,497
"8127050","Badulla","Uva-Paranagama","Ilukwela","38D",1125,539,586
"8127055","Badulla","Uva-Paranagama","Gampaha","38C",1434,699,735
"8127060","Badulla","Uva-Paranagama","Wewegama","38",571,266,305
"8127065","Badulla","Uva-Paranagama","Kerklis","38E",1594,771,823
"8127070","Badulla","Uva-Paranagama","Malwattegama","39A",800,383,417
"8127075","Badulla","Uva-Paranagama","Medipokuna","39B",737,359,378
"8127080","Badulla","Uva-Paranagama","Thuppitiya","40",717,351,366
"8127085","Badulla","Uva-Paranagama","Panagoda","40A",686,324,362
"8127090","Badulla","Uva-Paranagama","Pitiyakumbura","39C",1308,631,677
"8127095","Badulla","Uva-Paranagama","Bambarapana","39",1181,560,621
"8127100","Badulla","Uva-Paranagama","Alagolla","42B",2550,1249,1301
"8127105","Badulla","Uva-Paranagama","Voldemar","43G",1594,758,836
"8127110","Badulla","Uva-Paranagama","Thawalampola","43A",692,348,344
"8127115","Badulla","Uva-Paranagama","Kodakumbura","43F",1212,590,622
"8127120","Badulla","Uva-Paranagama","Koradekumbura","44C",944,467,477
"8127125","Badulla","Uva-Paranagama","Malapolagama","44A",992,515,477
"8127130","Badulla","Uva-Paranagama","Welamedagama","44B",440,219,221
"8127135","Badulla","Uva-Paranagama","Uduhawara","44",1036,498,538
"8127140","Badulla","Uva-Paranagama","Hangunnawa","43B",1066,512,554
"8127145","Badulla","Uva-Paranagama","Ranhawadigama","43E",1028,488,540
"8127150","Badulla","Uva-Paranagama","Idamegama","43C",809,391,418
"8127155","Badulla","Uva-Paranagama","Paranagama","43",1131,552,579
"8127160","Badulla","Uva-Paranagama","Mudanawa","43D",381,183,198
"8127165","Badulla","Uva-Paranagama","Sapugolla","42",1703,821,882
"8127170","Badulla","Uva-Paranagama","Ethkandawaka","42A",1173,555,618
"8127175","Badulla","Uva-Paranagama","Kirawanagama","41",979,480,499
"8127180","Badulla","Uva-Paranagama","Beraliyapola","41E",855,410,445
"8127185","Badulla","Uva-Paranagama","Pannalawela","41A",1048,501,547
"8127190","Badulla","Uva-Paranagama","Rahupola","41D",838,407,431
"8127195","Badulla","Uva-Paranagama","Udaperuwa","54",827,395,432
"8127200","Badulla","Uva-Paranagama","Weliulla","54A",1008,514,494
"8127205","Badulla","Uva-Paranagama","Metiwalalanda","53",1461,699,762
"8127210","Badulla","Uva-Paranagama","Unapana","41C",505,272,233
"8127215","Badulla","Uva-Paranagama","Lunuwatta","41B",1840,885,955
"8127220","Badulla","Uva-Paranagama","Pallewela","45D",1285,616,669
"8127225","Badulla","Uva-Paranagama","Busdulla","45A",1015,503,512
"8127230","Badulla","Uva-Paranagama","Kurundugolla","45C",917,451,466
"8127235","Badulla","Uva-Paranagama","Ambagasdowa","47A",1940,913,1027
"8127240","Badulla","Uva-Paranagama","Pannalagama","47F",1351,643,708
"8127245","Badulla","Uva-Paranagama","Uma Ela","47",1764,851,913
"8127250","Badulla","Uva-Paranagama","Karagahaulpatha","46C",1372,664,708
"8127255","Badulla","Uva-Paranagama","Medawela","46A",1991,972,1019
"8127260","Badulla","Uva-Paranagama","Perawella","46",1803,864,939
"8127265","Badulla","Uva-Paranagama","Galahagama","46B",1994,1030,964
"8127270","Badulla","Uva-Paranagama","Medagodagama","46D",1236,614,622
"8127275","Badulla","Uva-Paranagama","Thelhawadigama","46E",1004,507,497
"8127280","Badulla","Uva-Paranagama","Ketagoda","47E",1677,822,855
"8127285","Badulla","Uva-Paranagama","Dangamuwa","47B",977,469,508
"8127290","Badulla","Uva-Paranagama","Rathamba","47C",1743,859,884
"8127295","Badulla","Uva-Paranagama","Kumarapattiya","45",2009,958,1051
"8127300","Badulla","Uva-Paranagama","Balagala","45B",1509,728,781
"8127305","Badulla","Uva-Paranagama","Downside","53G",855,413,442
"8127310","Badulla","Uva-Paranagama","Kendagolla","53D",1188,558,630
"8127315","Badulla","Uva-Paranagama","Yahala Arawa","53C",1122,537,585
"8127320","Badulla","Uva-Paranagama","Ulugala","53B",498,244,254
"8127325","Badulla","Uva-Paranagama","Hangiliella","53A",818,393,425
"8127330","Badulla","Uva-Paranagama","Kotawera Udagama","53E",1879,905,974
"8127335","Badulla","Uva-Paranagama","Kotawera Pahalagama","53F",1412,677,735
"8127340","Badulla","Uva-Paranagama","Daragala","47D",2231,1086,1145
"8130005","Badulla","Welimada","Alakolagala","49D",2410,1159,1251
"8130010","Badulla","Welimada","Hulankapolla","49C",2309,1078,1231
"8130015","Badulla","Welimada","Silmiyapura","49B",1691,777,914
"8130020","Badulla","Welimada","Boragas","49A",3026,1435,1591
"8130025","Badulla","Welimada","Vidurupola","49",2306,1140,1166
"8130030","Badulla","Welimada","Gavarammana","49E",1887,930,957
"8130035","Badulla","Welimada","Palugama Town","50",1850,935,915
"8130040","Badulla","Welimada","Puranwela","50I",1768,861,907
"8130045","Badulla","Welimada","Girambe","48B",1574,762,812
"8130050","Badulla","Welimada","Divurumgama","48A",1524,719,805
"8130055","Badulla","Welimada","Palugama Ella","50C",1272,609,663
"8130060","Badulla","Welimada","Welimada Watta","48C",806,419,387
"8130065","Badulla","Welimada","Ambagahakumbura","48",2049,1009,1040
"8130070","Badulla","Welimada","Dimuthugama","50H",2078,1026,1052
"8130075","Badulla","Welimada","Welimada Town","52A",2051,1045,1006
"8130080","Badulla","Welimada","Landegama","52B",1736,804,932
"8130085","Badulla","Welimada","Divithotawela","59D",1863,908,955
"8130090","Badulla","Welimada","Puhulpola","58B",1033,524,509
"8130095","Badulla","Welimada","Dikkapitiya","58",789,409,380
"8130100","Badulla","Welimada","Koskanuwegama","58C",797,396,401
"8130105","Badulla","Welimada","Dayaraba Watta","58D",2474,1167,1307
"8130110","Badulla","Welimada","Ketakella","58A",521,243,278
"8130115","Badulla","Welimada","Yalpathwela","59B",1452,698,754
"8130120","Badulla","Welimada","Dambavinna","59A",2447,1228,1219
"8130125","Badulla","Welimada","Kabillegama","52D",1602,757,845
"8130130","Badulla","Welimada","Idamegama","51B",1689,809,880
"8130135","Badulla","Welimada","Erabadda","50E",1206,577,629
"8130140","Badulla","Welimada","Keppetipola","50D",1433,731,702
"8130145","Badulla","Welimada","Hewanakumbura","50F",1036,496,540
"8130150","Badulla","Welimada","Ambewela","50A",2292,1122,1170
"8130155","Badulla","Welimada","Himbiliyagolla","50G",652,315,337
"8130160","Badulla","Welimada","Thennakonwela","50B",1270,609,661
"8130165","Badulla","Welimada","Kalubululanda","51A",1810,863,947
"8130170","Badulla","Welimada","Mavithikumbura","52C",1471,711,760
"8130175","Badulla","Welimada","Nedungamuwa","52",1967,927,1040
"8130180","Badulla","Welimada","Medagedaragama","59C",1966,969,997
"8130185","Badulla","Welimada","Nawela","59",2014,933,1081
"8130190","Badulla","Welimada","Pahalayalkumbura","59E",941,420,521
"8130195","Badulla","Welimada","Welikadagama","60D",1250,638,612
"8130200","Badulla","Welimada","Mirahawatta","60",1666,817,849
"8130205","Badulla","Welimada","Udupeella","60B",1067,505,562
"8130210","Badulla","Welimada","Kotakithula","60C",1968,904,1064
"8130215","Badulla","Welimada","Malpotha","60A",800,402,398
"8130220","Badulla","Welimada","Karagasthenna","61A",2900,1385,1515
"8130225","Badulla","Welimada","Alugolla","61B",1499,734,765
"8130230","Badulla","Welimada","Bogahakumbura","51",1217,605,612
"8130235","Badulla","Welimada","Bibiligamuwa","50J",888,436,452
"8130240","Badulla","Welimada","Alawathugoda","51D",1038,527,511
"8130245","Badulla","Welimada","Kandepuhulpola","51C",1496,718,778
"8130250","Badulla","Welimada","Helayalkumbura","62H",1198,577,621
"8130255","Badulla","Welimada","Guruthalawa","61",2108,1192,916
"8130260","Badulla","Welimada","Mahathenna","61C",1607,753,854
"8130265","Badulla","Welimada","Hingurugamuwa","60E",1307,645,662
"8130270","Badulla","Welimada","Galedanda","62C",1722,846,876
"8130275","Badulla","Welimada","Boralanda","62B",2178,1050,1128
"8130280","Badulla","Welimada","Wangiyakumbura","62D",1613,805,808
"8130285","Badulla","Welimada","Ohiya","62A",148,66,82
"8130290","Badulla","Welimada","Rahangala","62F",1577,800,777
"8130295","Badulla","Welimada","Hinnarangolla","62E",1471,675,796
"8130300","Badulla","Welimada","Udakendagolla","62J",1390,685,705
"8130305","Badulla","Welimada","Rathkarawwa","62",822,409,413
"8130310","Badulla","Welimada","Pitapola","62I",1527,757,770
"8130315","Badulla","Welimada","Ohiya Estate","62K",443,211,232
"8130320","Badulla","Welimada","Maligathenna","62G",2846,1348,1498
"8133005","Badulla","Bandarawela","Mathetilla","67J",1232,591,641
"8133010","Badulla","Bandarawela","Konthahela","67A",1243,598,645
"8133015","Badulla","Bandarawela","Icelab Watta","67N",1216,590,626
"8133020","Badulla","Bandarawela","Kirioruwa","67E",1549,721,828
"8133025","Badulla","Bandarawela","Ettalapitiya","67",2445,1133,1312
"8133030","Badulla","Bandarawela","Diganathenna","67H",2499,1206,1293
"8133035","Badulla","Bandarawela","Ambegoda","67C",2596,1256,1340
"8133040","Badulla","Bandarawela","Wewathenna","67G",2637,1267,1370
"8133045","Badulla","Bandarawela","Watagamuwa","67F",2531,1192,1339
"8133050","Badulla","Bandarawela","Bindunuwewa","67B",1500,726,774
"8133055","Badulla","Bandarawela","Kebillewela North","67D",2544,1193,1351
"8133060","Badulla","Bandarawela","Gediyaroda","67K",1883,865,1018
"8133065","Badulla","Bandarawela","Bandarawela West","65B",3287,1623,1664
"8133070","Badulla","Bandarawela","Bandarawela East","65G",3182,1469,1713
"8133075","Badulla","Bandarawela","Thanthiriya","66G",2347,1056,1291
"8133080","Badulla","Bandarawela","Udaperuwa","66B",1636,756,880
"8133085","Badulla","Bandarawela","Egodagama","66E",1532,746,786
"8133090","Badulla","Bandarawela","Weheragalathenna","66F",1657,773,884
"8133095","Badulla","Bandarawela","Bambaragama","70",780,379,401
"8133100","Badulla","Bandarawela","Makulella","66A",2514,1271,1243
"8133105","Badulla","Bandarawela","Kinigama","66",1767,872,895
"8133110","Badulla","Bandarawela","Inikambedda","65E",3184,1491,1693
"8133115","Badulla","Bandarawela","Karagahawela","65C",2364,1103,1261
"8133120","Badulla","Bandarawela","Obadella","65F",1687,797,890
"8133125","Badulla","Bandarawela","Beddekumbura","65D",746,373,373
"8133130","Badulla","Bandarawela","Kebillewela South","65A",1391,675,716
"8133135","Badulla","Bandarawela","Mahaulpatha","66D",1213,565,648
"8133140","Badulla","Bandarawela","Darahitawanagoda","66H",1144,551,593
"8133145","Badulla","Bandarawela","Doolgolla","66C",627,312,315
"8133150","Badulla","Bandarawela","Creig Watta","66I",2392,1137,1255
"8133155","Badulla","Bandarawela","Liyangahawela Watta","70D",1916,877,1039
"8133160","Badulla","Bandarawela","Ambadandegama","70B",1164,571,593
"8133165","Badulla","Bandarawela","Beddearawa","70C",503,228,275
"8133170","Badulla","Bandarawela","Liyangahawela","70A",821,390,431
"8133175","Badulla","Bandarawela","Nayabedda Estate","65H",3773,1754,2019
"8136005","Badulla","Ella","Piyarapandowa","68H",2058,993,1065
"8136010","Badulla","Ella","Halpe","68",1947,956,991
"8136015","Badulla","Ella","Kirinda","68D",1550,760,790
"8136020","Badulla","Ella","Demodara","68I",2592,1268,1324
"8136025","Badulla","Ella","Navulla","68A",1777,842,935
"8136030","Badulla","Ella","Gawarawela","72",1819,871,948
"8136035","Badulla","Ella","Beddewela","72H",1701,822,879
"8136040","Badulla","Ella","Pupula West","72D",887,450,437
"8136045","Badulla","Ella","Pupula","72C",1755,865,890
"8136050","Badulla","Ella","Galtenhena","72E",1006,459,547
"8136055","Badulla","Ella","Nawela East","72A",960,456,504
"8136060","Badulla","Ella","Nawela West","72F",902,447,455
"8136065","Badulla","Ella","Medawela West","72G",1145,553,592
"8136070","Badulla","Ella","Yahalewela","68E",1182,560,622
"8136075","Badulla","Ella","Newberg","68J",831,408,423
"8136080","Badulla","Ella","Ella","68B",1403,687,716
"8136085","Badulla","Ella","Madhuragama","68C",1307,627,680
"8136090","Badulla","Ella","Idamegama","68F",572,282,290
"8136095","Badulla","Ella","Hettipola","69G",1495,761,734
"8136100","Badulla","Ella","Millagama","68G",1360,684,676
"8136105","Badulla","Ella","Udukumbalwela","69",1639,772,867
"8136110","Badulla","Ella","Dowa","69D",1872,902,970
"8136115","Badulla","Ella","Palleperuwa","69C",2479,1214,1265
"8136120","Badulla","Ella","Heeloya","69B",2439,1151,1288
"8136125","Badulla","Ella","Kithalella","69E",1435,689,746
"8136130","Badulla","Ella","Rawanaella","69F",509,258,251
"8136135","Badulla","Ella","Karandagolla","69A",1519,776,743
"8136140","Badulla","Ella","Govussa","71A",885,442,443
"8136145","Badulla","Ella","Ilukpelessa","71",653,321,332
"8136150","Badulla","Ella","Ballaketuwa","72B",1728,816,912
"8136155","Badulla","Ella","Namunukula","72B1",1163,556,607
"8136160","Badulla","Ella","Dodamgolla","71B",611,317,294
"8139005","Badulla","Haputale","Ellagama","63K",1324,638,686
"8139010","Badulla","Haputale","Kahattewela","64A",1581,782,799
"8139015","Badulla","Haputale","Eranawela","64B",1676,784,892
"8139020","Badulla","Haputale","Ranjallawa","64C",2306,1093,1213
"8139025","Badulla","Haputale","Bingethenna","64G",1650,785,865
"8139030","Badulla","Haputale","Kahagolla","64",2120,1022,1098
"8139035","Badulla","Haputale","Dodamwatta","63G",1500,723,777
"8139040","Badulla","Haputale","Diyathalawa","63B",3297,2031,1266
"8139045","Badulla","Haputale","Jayaminipura","64H",1172,550,622
"8139050","Badulla","Haputale","Aluthwela","63D",1275,616,659
"8139055","Badulla","Haputale","Welanhinna","63J",1100,513,587
"8139060","Badulla","Haputale","Pahala Kadurugamuwa","63",2142,1031,1111
"8139065","Badulla","Haputale","Viharakele","63F",1248,570,678
"8139070","Badulla","Haputale","Umankandura","63H",1994,945,1049
"8139075","Badulla","Haputale","Panketiya","63M",2557,1205,1352
"8139080","Badulla","Haputale","Hela Kadurugamuwa","63I",1508,704,804
"8139085","Badulla","Haputale","Haputhalegama","63C",1638,799,839
"8139090","Badulla","Haputale","Glenanore","64F",2383,1116,1267
"8139095","Badulla","Haputale","Horadorowwa","63E",1005,480,525
"8139100","Badulla","Haputale","Magiripura","63L",2079,986,1093
"8139105","Badulla","Haputale","Kolathenna","63P",504,245,259
"8139110","Badulla","Haputale","Haputhale Town","63A",3957,1964,1993
"8139115","Badulla","Haputale","Pitarathmale","64D",2800,1343,1457
"8139120","Badulla","Haputale","Dambethenna","63O",4349,2102,2247
"8139125","Badulla","Haputale","Thotalagala","63N",1206,575,631
"8139130","Badulla","Haputale","Galkanda","64E",1427,697,730
"8142005","Badulla","Haldummulla","Weerakongama","158G",1137,572,565
"8142010","Badulla","Haldummulla","Kalupahana","158",909,438,471
"8142015","Badulla","Haldummulla","Haldummulla","157A",1725,826,899
"8142020","Badulla","Haldummulla","Beragala","157B",2668,1242,1426
"8142025","Badulla","Haldummulla","Viharagala","157G",2760,1362,1398
"8142030","Badulla","Haldummulla","Nikapotha West","155L",268,133,135
"8142035","Badulla","Haldummulla","Nikapotha East","155",727,369,358
"8142040","Badulla","Haldummulla","Lemasthota","155C",338,161,177
"8142045","Badulla","Haldummulla","Ranasinghegama","155H",816,409,407
"8142050","Badulla","Haldummulla","Kotabakma","155D",1868,910,958
"8142055","Badulla","Haldummulla","Koslanda","155A",2412,1152,1260
"8142060","Badulla","Haldummulla","Mahakanda","155N",976,440,536
"8142065","Badulla","Haldummulla","Poonagala","155P",3991,1895,2096
"8142070","Badulla","Haldummulla","Divulgasmulla","154B",1719,803,916
"8142075","Badulla","Haldummulla","Gampaha","154",1299,614,685
"8142080","Badulla","Haldummulla","Ampitithenna","155K",988,421,567
"8142085","Badulla","Haldummulla","Kelipanawela","155M",440,211,229
"8142090","Badulla","Haldummulla","Moraketiya","155E",559,270,289
"8142095","Badulla","Haldummulla","Kirawanagama","156",739,380,359
"8142100","Badulla","Haldummulla","Manthenna","156B",592,290,302
"8142105","Badulla","Haldummulla","Amilagama","157E",678,308,370
"8142110","Badulla","Haldummulla","Soragune","157",587,287,300
"8142115","Badulla","Haldummulla","Kithulgahaarawa","158E",623,296,327
"8142120","Badulla","Haldummulla","Watagamuwa","157K",1055,482,573
"8142125","Badulla","Haldummulla","Walhaputhenna","157H",644,282,362
"8142130","Badulla","Haldummulla","Uvathenna","158C",571,280,291
"8142135","Badulla","Haldummulla","Marangahawela","158F",443,207,236
"8142140","Badulla","Haldummulla","Seelathenna","158D",629,291,338
"8142145","Badulla","Haldummulla","Harankahawa","158B",631,301,330
"8142150","Badulla","Haldummulla","Medawela","157F",442,217,225
"8142155","Badulla","Haldummulla","Welibissa","157D",314,153,161
"8142160","Badulla","Haldummulla","We Eliya","157C",608,324,284
"8142165","Badulla","Haldummulla","Kosgama","158A",681,376,305
"8142170","Badulla","Haldummulla","Ranwanguhawa","156A",381,193,188
"8142175","Badulla","Haldummulla","Akkara Seeya","155F",204,117,87
"8142180","Badulla","Haldummulla","Welanvita","155B",362,190,172
"8142185","Badulla","Haldummulla","Kolongasthenna","154A",757,371,386
"8142190","Badulla","Haldummulla","Bambara Pokuna","154C",165,82,83
"8142195","Badulla","Haldummulla","Mahalanda","155G",852,467,385
"8203005","Moneragala","Bibile","Uravula","103E",340,178,162
"8203010","Moneragala","Bibile","Karandugala","103D",726,340,386
"8203015","Moneragala","Bibile","Bulupitiya","103B",985,490,495
"8203020","Moneragala","Bibile","Nilgala","103",729,360,369
"8203025","Moneragala","Bibile","Kanawegalla","102F",496,238,258
"8203030","Moneragala","Bibile","Ussagala","102E",554,267,287
"8203035","Moneragala","Bibile","Bokagonna","101",1409,676,733
"8203040","Moneragala","Bibile","Pitakumbura","101A",1079,525,554
"8203045","Moneragala","Bibile","Hamapola","103A",1018,468,550
"8203050","Moneragala","Bibile","Thotillaketiya","103C",823,392,431
"8203055","Moneragala","Bibile","Kokunnewa","101D",985,489,496
"8203060","Moneragala","Bibile","Morattamulla","101E",856,415,441
"8203065","Moneragala","Bibile","Nagala","101B",1344,642,702
"8203070","Moneragala","Bibile","Radaliyadda","102A",1159,538,621
"8203075","Moneragala","Bibile","Ambagolla","102D",989,472,517
"8203080","Moneragala","Bibile","Wegama","102",1112,545,567
"8203085","Moneragala","Bibile","Wegama South","102C",1376,662,714
"8203090","Moneragala","Bibile","Mallehewa","102B",1207,576,631
"8203095","Moneragala","Bibile","Karagahawela East","96B",787,389,398
"8203100","Moneragala","Bibile","Kehel Attawala","96",1063,509,554
"8203105","Moneragala","Bibile","Karagahawela West","96A",1008,469,539
"8203110","Moneragala","Bibile","Udamallehewa","102G",869,392,477
"8203115","Moneragala","Bibile","Egoda Kotagama","97A",670,310,360
"8203120","Moneragala","Bibile","Kotagama","97",924,441,483
"8203125","Moneragala","Bibile","Badullagammana","100F",1584,745,839
"8203130","Moneragala","Bibile","Kavudella","100D",1036,493,543
"8203135","Moneragala","Bibile","Rathupasketiya","100B",1572,769,803
"8203140","Moneragala","Bibile","Lindakumbura","101C",1339,630,709
"8203145","Moneragala","Bibile","Bibila","100",1579,807,772
"8203150","Moneragala","Bibile","Ambelanda","100C",812,419,393
"8203155","Moneragala","Bibile","Dodamgolla","99",1181,541,640
"8203160","Moneragala","Bibile","Dehiattawela","99B",854,420,434
"8203165","Moneragala","Bibile","Kanulwela","99A",2047,962,1085
"8203170","Moneragala","Bibile","Ethanawatta","98A",689,351,338
"8203175","Moneragala","Bibile","Kuruwamba","100A",1059,461,598
"8203180","Moneragala","Bibile","Hewelwela","100E",889,428,461
"8203185","Moneragala","Bibile","Mudiyala","98B",809,395,414
"8203190","Moneragala","Bibile","Yalkumbura","98",748,353,395
"8203195","Moneragala","Bibile","Thanayamgama","98C",683,329,354
"8203200","Moneragala","Bibile","Medipitiya","99C",940,439,501
"8206005","Moneragala","Madulla","Nelliyadda","104B",460,224,236
"8206010","Moneragala","Madulla","Mullegama","104",892,466,426
"8206015","Moneragala","Madulla","Galgamuwa","104C",1182,609,573
"8206020","Moneragala","Madulla","Inginiyagala","104A",1399,681,718
"8206025","Moneragala","Madulla","Baduluwela","118",794,408,386
"8206030","Moneragala","Madulla","Bandarawadiya","118A",690,339,351
"8206035","Moneragala","Madulla","Panguwa","116B",890,446,444
"8206040","Moneragala","Madulla","Thalkotayaya","116E",696,336,360
"8206045","Moneragala","Madulla","Deliwa","116",583,296,287
"8206050","Moneragala","Madulla","Thampalawela","112A",893,437,456
"8206055","Moneragala","Madulla","Ruwalwela","116D",975,452,523
"8206060","Moneragala","Madulla","Watawanagama","116C",388,178,210
"8206065","Moneragala","Madulla","Gangodagama","114C",414,221,193
"8206070","Moneragala","Madulla","Ritigahawatta","114D",824,395,429
"8206075","Moneragala","Madulla","Mariarawa","114B",1021,499,522
"8206080","Moneragala","Madulla","Kolladeniya","114A",1293,620,673
"8206085","Moneragala","Madulla","Ihawa","114",935,431,504
"8206090","Moneragala","Madulla","Alpitiya","116A",926,429,497
"8206095","Moneragala","Madulla","Makulla","112",874,426,448
"8206100","Moneragala","Madulla","Namaloya Colony","112C",984,466,518
"8206105","Moneragala","Madulla","Aratugaswela","112E",632,309,323
"8206110","Moneragala","Madulla","Pagura","113B",680,343,337
"8206115","Moneragala","Madulla","Galbokka","113",620,308,312
"8206120","Moneragala","Madulla","Magandana","112B",582,278,304
"8206125","Moneragala","Madulla","Udumulla","112D",731,343,388
"8206130","Moneragala","Madulla","Kottagala","117A",841,387,454
"8206135","Moneragala","Madulla","Gangoda Arawa","115A",666,323,343
"8206140","Moneragala","Madulla","Polgahagama","115",882,438,444
"8206145","Moneragala","Madulla","Alugalge","115B",567,297,270
"8206150","Moneragala","Madulla","Neelawa Bedda","115D",637,305,332
"8206155","Moneragala","Madulla","Kahagolla","115C",594,290,304
"8206160","Moneragala","Madulla","Magandaoya Colony","117C",758,371,387
"8206165","Moneragala","Madulla","Gonathalawa","117B",927,446,481
"8206170","Moneragala","Madulla","Dambagalla","117",1416,703,713
"8206175","Moneragala","Madulla","Ellekona","113E",1333,651,682
"8206180","Moneragala","Madulla","Therela","113D",804,392,412
"8206185","Moneragala","Madulla","Iluklanda","113C",664,317,347
"8206190","Moneragala","Madulla","Obbegoda","113A",791,371,420
"8209005","Moneragala","Medagama","Pothubandhana","106F",946,446,500
"8209010","Moneragala","Medagama","Yakunnawa","106E",1002,489,513
"8209015","Moneragala","Medagama","Bendiyawa","106B",1333,664,669
"8209020","Moneragala","Medagama","Kotabowa","106A",1253,623,630
"8209025","Moneragala","Medagama","Godigamuwa","106G",1614,806,808
"8209030","Moneragala","Medagama","Senpathigama","106D",801,371,430
"8209035","Moneragala","Medagama","Aiwela","107A",1126,538,588
"8209040","Moneragala","Medagama","Senapathiya","107",852,403,449
"8209045","Moneragala","Medagama","Bibilamulla","107B",930,412,518
"8209050","Moneragala","Medagama","Nannapurawa","106",1172,545,627
"8209055","Moneragala","Medagama","Dahamgama","106C",1125,534,591
"8209060","Moneragala","Medagama","Kalugahawadiya","111F",796,382,414
"8209065","Moneragala","Medagama","Kongolla","108",803,379,424
"8209070","Moneragala","Medagama","Diviyapola","108B",444,199,245
"8209075","Moneragala","Medagama","Kohukumbura","109",658,312,346
"8209080","Moneragala","Medagama","Nugamura","109B",855,408,447
"8209085","Moneragala","Medagama","Ellekona","109C",1228,580,648
"8209090","Moneragala","Medagama","Dahagoniya","108C",884,388,496
"8209095","Moneragala","Medagama","Monarawana","108A",1267,610,657
"8209100","Moneragala","Medagama","Mellagama","111B",1157,578,579
"8209105","Moneragala","Medagama","Thambana","111C",954,457,497
"8209110","Moneragala","Medagama","Thimbiriya","110E",1573,781,792
"8209115","Moneragala","Medagama","Medagama","110D",1667,857,810
"8209120","Moneragala","Medagama","Elhena","109A",943,488,455
"8209125","Moneragala","Medagama","Pitadeniya","110B",793,383,410
"8209130","Moneragala","Medagama","Kinnarabowa","110I",667,324,343
"8209135","Moneragala","Medagama","Ilukkumbura","110F",1039,521,518
"8209140","Moneragala","Medagama","Bakinigahawela","110A",1349,628,721
"8209145","Moneragala","Medagama","Pubbara","111",463,221,242
"8209150","Moneragala","Medagama","Polgahapitiya","110H",1899,923,976
"8209155","Moneragala","Medagama","Kendavinna","110C",951,461,490
"8209160","Moneragala","Medagama","Alana","110G",598,275,323
"8209165","Moneragala","Medagama","Rattanadeniya","111A",1117,561,556
"8209170","Moneragala","Medagama","Amunekandura","111E",963,466,497
"8209175","Moneragala","Medagama","Keenagoda","111D",659,325,334
"8212005","Moneragala","Siyambalanduwa","Nape","120",1012,508,504
"8212010","Moneragala","Siyambalanduwa","Buddama","121A",1261,618,643
"8212015","Moneragala","Siyambalanduwa","Waragama","121",1308,658,650
"8212020","Moneragala","Siyambalanduwa","Kotagoda","122C",1015,503,512
"8212025","Moneragala","Siyambalanduwa","Weragoda","122B",596,325,271
"8212030","Moneragala","Siyambalanduwa","Newgala","122I",759,383,376
"8212035","Moneragala","Siyambalanduwa","Govindupura","122H",1223,590,633
"8212040","Moneragala","Siyambalanduwa","Pallewela","122A",1209,603,606
"8212045","Moneragala","Siyambalanduwa","Ambagahapitiya","121B",770,390,380
"8212050","Moneragala","Siyambalanduwa","Meeyagala","120A",662,345,317
"8212055","Moneragala","Siyambalanduwa","Barawaya","122",1412,716,696
"8212060","Moneragala","Siyambalanduwa","Kooragammana","122J",594,285,309
"8212065","Moneragala","Siyambalanduwa","Kalugollayaya","122K",684,339,345
"8212070","Moneragala","Siyambalanduwa","Samanala Bedda","122F",890,440,450
"8212075","Moneragala","Siyambalanduwa","Muthukandiya","122D",755,374,381
"8212080","Moneragala","Siyambalanduwa","Yakkadurawa","122G",1393,690,703
"8212085","Moneragala","Siyambalanduwa","Galamuna","122E",719,378,341
"8212090","Moneragala","Siyambalanduwa","Helamulla","123G",845,439,406
"8212095","Moneragala","Siyambalanduwa","Pallegama","123K",1108,570,538
"8212100","Moneragala","Siyambalanduwa","Maha Kalugolla","123B",1022,498,524
"8212105","Moneragala","Siyambalanduwa","Karambagoda","123J",946,463,483
"8212110","Moneragala","Siyambalanduwa","Ruhunu Danawwa","123E",626,318,308
"8212115","Moneragala","Siyambalanduwa","Sri Wijithapura","123D",1437,737,700
"8212120","Moneragala","Siyambalanduwa","Siyambalanduwa","123",915,541,374
"8212125","Moneragala","Siyambalanduwa","Manabharana","123F",1202,608,594
"8212130","Moneragala","Siyambalanduwa","Madugama","123C",2094,1080,1014
"8212135","Moneragala","Siyambalanduwa","Kivuleyaya","123H",1407,711,696
"8212140","Moneragala","Siyambalanduwa","Kodayana","123A",1220,582,638
"8212145","Moneragala","Siyambalanduwa","Nugagaha Kivula","123I",1022,539,483
"8212150","Moneragala","Siyambalanduwa","Kotiyagoda","128D",947,478,469
"8212155","Moneragala","Siyambalanduwa","Indigasella","128E",1108,543,565
"8212160","Moneragala","Siyambalanduwa","Dombagahawela","128A",2343,1151,1192
"8212165","Moneragala","Siyambalanduwa","Liyangolla","128B",1225,602,623
"8212170","Moneragala","Siyambalanduwa","Beraliyapola","128C",729,371,358
"8212175","Moneragala","Siyambalanduwa","Kimbulawela","128",749,360,389
"8212180","Moneragala","Siyambalanduwa","Pahatha Arawa","126B",1504,744,760
"8212185","Moneragala","Siyambalanduwa","Ethimale","126",1122,579,543
"8212190","Moneragala","Siyambalanduwa","Guruhela","126C",1081,516,565
"8212195","Moneragala","Siyambalanduwa","Gemunupura","124E",890,441,449
"8212200","Moneragala","Siyambalanduwa","Perakumpura","124D",1052,518,534
"8212205","Moneragala","Siyambalanduwa","Siripura","124G",1335,672,663
"8212210","Moneragala","Siyambalanduwa","Thissapura","124B",1784,906,878
"8212215","Moneragala","Siyambalanduwa","Ethimale Colony","124A",1238,617,621
"8212220","Moneragala","Siyambalanduwa","Minipura","124F",980,501,479
"8212225","Moneragala","Siyambalanduwa","Vilaoya","126A",1574,797,777
"8212230","Moneragala","Siyambalanduwa","Wattegama","124",1624,846,778
"8212235","Moneragala","Siyambalanduwa","Wijayapura","124C",959,456,503
"8212240","Moneragala","Siyambalanduwa","Kotiyagala","124H",1690,850,840
"8215005","Moneragala","Moneragala","Tenwatta","130E",1516,733,783
"8215010","Moneragala","Moneragala","Guruhela","130F",1314,655,659
"8215015","Moneragala","Moneragala","Batugammana","130",780,382,398
"8215020","Moneragala","Moneragala","Debeddekivula","130C",930,455,475
"8215025","Moneragala","Moneragala","Weliyaya","130B",2248,1145,1103
"8215030","Moneragala","Moneragala","Rattanapitiya","130D",1361,674,687
"8215035","Moneragala","Moneragala","Nakkala","130A",1794,897,897
"8215040","Moneragala","Moneragala","Hidikivula","129D",1912,925,987
"8215045","Moneragala","Moneragala","Hulandawa","129C",2559,1289,1270
"8215050","Moneragala","Moneragala","Magandanamulla","129E",1981,956,1025
"8215055","Moneragala","Moneragala","Moneragala","129B",2531,1336,1195
"8215060","Moneragala","Moneragala","Aliyawatta","129I",1754,899,855
"8215065","Moneragala","Moneragala","Kolonvinna","127",1073,535,538
"8215070","Moneragala","Moneragala","Bohitiya","127B",1664,789,875
"8215075","Moneragala","Moneragala","Kawdawa","129A",858,434,424
"8215080","Moneragala","Moneragala","Hulandawa Left","129G",1760,845,915
"8215085","Moneragala","Moneragala","Viharamulla","129F",2461,1232,1229
"8215090","Moneragala","Moneragala","Muppane","129",3922,2078,1844
"8215095","Moneragala","Moneragala","Maduruketiya","131B",5082,2504,2578
"8215100","Moneragala","Moneragala","Kumbukkana","131A",2251,1128,1123
"8215105","Moneragala","Moneragala","Horombuwa","131C",2468,1267,1201
"8215110","Moneragala","Moneragala","Hulandawa South","129H",2411,1228,1183
"8215115","Moneragala","Moneragala","Marawa","125A",1442,718,724
"8215120","Moneragala","Moneragala","Veheragala","127A",943,495,448
"8215125","Moneragala","Moneragala","Thenagallanda","125B",1608,795,813
"8215130","Moneragala","Moneragala","Kahambana","125",897,463,434
"8218005","Moneragala","Badalkumbura","Gedavila","134D",545,266,279
"8218010","Moneragala","Badalkumbura","Karandagama","133A",1043,512,531
"8218015","Moneragala","Badalkumbura","Ella","134F",765,363,402
"8218020","Moneragala","Badalkumbura","Pallegama","134E",456,225,231
"8218025","Moneragala","Badalkumbura","Thalawagama","134B",1102,548,554
"8218030","Moneragala","Badalkumbura","Mailagasthenna","134G",851,443,408
"8218035","Moneragala","Badalkumbura","Karavila","134A",914,459,455
"8218040","Moneragala","Badalkumbura","Madamagama","133D",951,463,488
"8218045","Moneragala","Badalkumbura","Wekumbura","134",720,352,368
"8218050","Moneragala","Badalkumbura","Maiyokka Watta","134C",846,429,417
"8218055","Moneragala","Badalkumbura","Waradola","135",1308,624,684
"8218060","Moneragala","Badalkumbura","Ankada","135C",734,346,388
"8218065","Moneragala","Badalkumbura","Kotamuduna","135A",924,420,504
"8218070","Moneragala","Badalkumbura","Alupotha","132",1939,861,1078
"8218075","Moneragala","Badalkumbura","Wasipaha","133",1220,567,653
"8218080","Moneragala","Badalkumbura","Badalkumbura","133B",1687,875,812
"8218085","Moneragala","Badalkumbura","Maligathenna","133C",1125,554,571
"8218090","Moneragala","Badalkumbura","Pussellawa","131C",1358,668,690
"8218095","Moneragala","Badalkumbura","Madukotan Arawa","131B",919,444,475
"8218100","Moneragala","Badalkumbura","Yakurawa","131",1219,584,635
"8218105","Moneragala","Badalkumbura","Therappahuwa","131D",1445,701,744
"8218110","Moneragala","Badalkumbura","Punsisigama","139A",891,424,467
"8218115","Moneragala","Badalkumbura","Madugahapattiya","139E",1164,578,586
"8218120","Moneragala","Badalkumbura","Kalagahakivula","139F",531,259,272
"8218125","Moneragala","Badalkumbura","Madugasmulla","132A",842,429,413
"8218130","Moneragala","Badalkumbura","Ranugalla","135B",1179,579,600
"8218135","Moneragala","Badalkumbura","Ethpattiya","136A",563,276,287
"8218140","Moneragala","Badalkumbura","Miyanakadura","136",1453,657,796
"8218145","Moneragala","Badalkumbura","Dewathura","136B",1620,742,878
"8218150","Moneragala","Badalkumbura","Naranwatta","138C",534,250,284
"8218155","Moneragala","Badalkumbura","Athala","139",907,453,454
"8218160","Moneragala","Badalkumbura","Ettalamulla","139C",453,210,243
"8218165","Moneragala","Badalkumbura","Muthukeliyawa","139B",1182,581,601
"8218170","Moneragala","Badalkumbura","Meegahayaya","139D",486,266,220
"8218175","Moneragala","Badalkumbura","Bogahapelessa","138",519,269,250
"8218180","Moneragala","Badalkumbura","Dambagahawela","137A",553,258,295
"8218185","Moneragala","Badalkumbura","Hingurukaduwa","137",827,388,439
"8218190","Moneragala","Badalkumbura","Keliwessa","137B",818,399,419
"8218195","Moneragala","Badalkumbura","Moratuwagama","138A",469,230,239
"8218200","Moneragala","Badalkumbura","Lunugala Colony","138B",1438,683,755
"8218205","Moneragala","Badalkumbura","Katugahagalge","139G",1603,774,829
"8221005","Moneragala","Wellawaya","Kurugama","153",1678,840,838
"8221010","Moneragala","Wellawaya","Randeniya","153A",1700,871,829
"8221015","Moneragala","Wellawaya","Siyambalagunaya","153B",1556,785,771
"8221020","Moneragala","Wellawaya","Sudupanawela","152C",2421,1189,1232
"8221025","Moneragala","Wellawaya","Kotikambokka","152",1844,933,911
"8221030","Moneragala","Wellawaya","Galbokka","152A",1036,537,499
"8221035","Moneragala","Wellawaya","Dimbulamuraya","152B",1859,935,924
"8221040","Moneragala","Wellawaya","Wellawaya","151",4062,2093,1969
"8221045","Moneragala","Wellawaya","Yalabowa","151C",1783,887,896
"8221050","Moneragala","Wellawaya","Nugayaya","151D",1547,776,771
"8221055","Moneragala","Wellawaya","Warunagama","151B",5189,2548,2641
"8221060","Moneragala","Wellawaya","Anapallama","151A",2125,1068,1057
"8221065","Moneragala","Wellawaya","Pubuduwewa","150F",2165,1087,1078
"8221070","Moneragala","Wellawaya","Neluwagala","151G",1843,913,930
"8221075","Moneragala","Wellawaya","Buduruwagala","151E",1875,896,979
"8221080","Moneragala","Wellawaya","Andawelayaya","151F",2121,1055,1066
"8221085","Moneragala","Wellawaya","Siripuragama","150I",1640,825,815
"8221090","Moneragala","Wellawaya","Veherayaya Colony","150H",2444,1147,1297
"8221095","Moneragala","Wellawaya","Veherayaya","150C",2033,1042,991
"8221100","Moneragala","Wellawaya","Randenigodayaya","150E",1419,682,737
"8221105","Moneragala","Wellawaya","Handapanagala","150B",1319,648,671
"8221110","Moneragala","Wellawaya","Maha Aragama","150G",1614,841,773
"8221115","Moneragala","Wellawaya","Thelulla Colony","150K",2956,1474,1482
"8221120","Moneragala","Wellawaya","Ethiliwewa","150J",2236,1098,1138
"8221125","Moneragala","Wellawaya","Thelulla","150",1186,571,615
"8221130","Moneragala","Wellawaya","Balaharuwa","150A",2637,1349,1288
"8221135","Moneragala","Wellawaya","Debara Ara","150L",1337,683,654
"8221140","Moneragala","Wellawaya","Kithulkote","150M",2265,1150,1115
"8221145","Moneragala","Wellawaya","Uva Kudaoya","150D",2170,1082,1088
"8224005","Moneragala","Buttala","Uda Arawa","143/2",1178,579,599
"8224010","Moneragala","Buttala","Horabokka","143/1",1637,806,831
"8224015","Moneragala","Buttala","Unawatuna","140/A/1",2818,1384,1434
"8224020","Moneragala","Buttala","Yudaganawa","140A",2220,1100,1120
"8224025","Moneragala","Buttala","Dikyaya","140/3",2069,1071,998
"8224030","Moneragala","Buttala","Udagama","140",2245,1172,1073
"8224035","Moneragala","Buttala","Mahagodayaya","140/2",2019,991,1028
"8224040","Moneragala","Buttala","Gaminipura","145B",1892,926,966
"8224045","Moneragala","Buttala","Okkampitiya","145",1513,780,733
"8224050","Moneragala","Buttala","Galtemmandiya","145/B/1",1342,641,701
"8224055","Moneragala","Buttala","Ulugala","145/A/1",1872,1003,869
"8224060","Moneragala","Buttala","Maligavila","145A",2282,1183,1099
"8224065","Moneragala","Buttala","Minipuragama","145/A/2",675,345,330
"8224070","Moneragala","Buttala","Buruthagolla","145/B/2",1662,845,817
"8224075","Moneragala","Buttala","Pahalagama","145/1",1950,972,978
"8224080","Moneragala","Buttala","Konketiya","142A",2185,1126,1059
"8224085","Moneragala","Buttala","Medagama","142",1654,846,808
"8224090","Moneragala","Buttala","Pettagamwela","140/1",1351,668,683
"8224095","Moneragala","Buttala","Puhulkotuwa","142/3",2362,1145,1217
"8224100","Moneragala","Buttala","Veheragala","140/B/1",1247,601,646
"8224105","Moneragala","Buttala","Pelwatta","143",2782,1378,1404
"8224110","Moneragala","Buttala","Mahasenpura","143/A/1",1889,925,964
"8224115","Moneragala","Buttala","Kumaragama","143/A/2",1510,731,779
"8224120","Moneragala","Buttala","Kukurampola","143A",1846,907,939
"8224125","Moneragala","Buttala","Kumarapura","140B",1642,845,797
"8224130","Moneragala","Buttala","Yatiyallathota","142/2",1278,662,616
"8224135","Moneragala","Buttala","Waguruwela","142/1",1887,932,955
"8224140","Moneragala","Buttala","Gonagan Ara","142B",1788,936,852
"8224145","Moneragala","Buttala","Rahathangama","143/A/3",2289,1230,1059
"8227005","Moneragala","Katharagama","Sella Katharagama","146A",1924,1033,891
"8227010","Moneragala","Katharagama","Katharagama","146",3364,1792,1572
"8227015","Moneragala","Katharagama","Detagamuwa","146B",4777,2612,2165
"8227020","Moneragala","Katharagama","Kandasurindugama","146C",4031,2013,2018
"8227025","Moneragala","Katharagama","Karavile","146D",4124,2133,1991
"8230005","Moneragala","Thanamalvila","Kandiyapitawewa","149C/1",2406,1177,1229
"8230010","Moneragala","Thanamalvila","Kotavehera Mankada","149C",2854,1457,1397
"8230015","Moneragala","Thanamalvila","Aluthwewa","149D",2159,1136,1023
"8230020","Moneragala","Thanamalvila","Hambegamuwa","149",2429,1277,1152
"8230025","Moneragala","Thanamalvila","Hambegamuwa Colony","149/1",1979,1009,970
"8230030","Moneragala","Thanamalvila","Kahakurullan Pelessa","149/2",1660,853,807
"8230035","Moneragala","Thanamalvila","Mahawewa","148A",1087,573,514
"8230040","Moneragala","Thanamalvila","Sooriyaara","148",2212,1131,1081
"8230045","Moneragala","Thanamalvila","Usgala","148B",914,461,453
"8230050","Moneragala","Thanamalvila","Nikawewa","147B",821,428,393
"8230055","Moneragala","Thanamalvila","Bodagama","147D",1772,875,897
"8230060","Moneragala","Thanamalvila","Kivul Ara","147C",1372,681,691
"8230065","Moneragala","Thanamalvila","Sittarama","147",3090,1564,1526
"8230070","Moneragala","Thanamalvila","Seenukkuwa","147A",1928,978,950
"8233005","Moneragala","Sevanagala","Katupilagama","149A",6442,3224,3218
"8233010","Moneragala","Sevanagala","Habaraluwewa","149E",2621,1287,1334
"8233015","Moneragala","Sevanagala","Samagipura","149G",1788,858,930
"8233020","Moneragala","Sevanagala","Weliara","149G/1",912,452,460
"8233025","Moneragala","Sevanagala","Punchiwewa","149G/2",696,360,336
"8233030","Moneragala","Sevanagala","Kiri Ibbanwewa","149E/2",3101,1525,1576
"8233035","Moneragala","Sevanagala","Sevanagala","149E/1",4795,2432,2363
"8233040","Moneragala","Sevanagala","Muthuminigama","149/A/1",3322,1627,1695
"8233045","Moneragala","Sevanagala","Bahirawa","149/B/1",1682,845,837
"8233050","Moneragala","Sevanagala","Indikolapelessa","149/B/2",1495,723,772
"8233055","Moneragala","Sevanagala","Habarugala","149F",5423,2679,2744
"8233060","Moneragala","Sevanagala","Nugegalayaya","149F/1",3460,1787,1673
"8233065","Moneragala","Sevanagala","Mahagama","149B",3119,1575,1544
"8233070","Moneragala","Sevanagala","Habarattawela","149/B/3",3044,1537,1507
"1103005","Colombo","Colombo","Sammanthranapura","",7829,4017,3812
"1103010","Colombo","Colombo","Mattakkuliya","",28003,14029,13974
"1103015","Colombo","Colombo","Modara","",17757,8794,8963
"1103020","Colombo","Colombo","Madampitiya","",12970,6505,6465
"1103025","Colombo","Colombo","Mahawatta","",8809,4367,4442
"1103030","Colombo","Colombo","Aluthmawatha","",13625,6602,7023
"1103035","Colombo","Colombo","Lunupokuna","",12423,6352,6071
"1103040","Colombo","Colombo","Bloemendhal","",13802,6740,7062
"1103045","Colombo","Colombo","Kotahena East","",6385,3024,3361
"1103050","Colombo","Colombo","Kotahena West","",9409,4617,4792
"1103055","Colombo","Colombo","Kochchikade North","",9339,5005,4334
"1103060","Colombo","Colombo","Jinthupitiya","",8110,3901,4209
"1103065","Colombo","Colombo","Masangasweediya","",8516,4303,4213
"1103070","Colombo","Colombo","New Bazaar","",13436,6753,6683
"1103075","Colombo","Colombo","Grandpass South","",17588,8739,8849
"1103080","Colombo","Colombo","Grandpass North","",8904,4433,4471
"1103085","Colombo","Colombo","Nawagampura","",6821,3459,3362
"1103090","Colombo","Colombo","Maligawatta East","",11524,5774,5750
"1103095","Colombo","Colombo","Khettarama","",13683,6907,6776
"1103100","Colombo","Colombo","Aluthkade East","",10053,4987,5066
"1103105","Colombo","Colombo","Aluthkade West","",7517,3914,3603
"1103110","Colombo","Colombo","Kochchikade South","",7746,4062,3684
"1103115","Colombo","Colombo","Pettah","",1924,1854,70
"1103120","Colombo","Colombo","Fort","",1473,1065,408
"1103125","Colombo","Colombo","Galle Face","",3789,1880,1909
"1103130","Colombo","Colombo","Slave Island","",3795,1868,1927
"1103135","Colombo","Colombo","Hunupitiya","",6883,3335,3548
"1103140","Colombo","Colombo","Suduwella","",3915,2007,1908
"1103145","Colombo","Colombo","Keselwatta","",7221,3637,3584
"1103150","Colombo","Colombo","Panchikawatta","",8467,4195,4272
"1103155","Colombo","Colombo","Maligawatta West","",8968,4363,4605
"1103160","Colombo","Colombo","Maligakanda","",8526,4530,3996
"1103165","Colombo","Colombo","Maradana","",4591,2424,2167
"1103170","Colombo","Colombo","Ibbanwala","",2617,1027,1590
"1103175","Colombo","Colombo","Wekanda","",6839,3329,3510
"1106005","Colombo","Kolonnawa","Wadulla","509D",7606,3783,3823
"1106010","Colombo","Kolonnawa","Sedawatta","509A",6934,3501,3433
"1106015","Colombo","Kolonnawa","Halmulla","509C",2308,1144,1164
"1106020","Colombo","Kolonnawa","Kotuvila","509",5083,2509,2574
"1106025","Colombo","Kolonnawa","Veheragoda","509B",2119,986,1133
"1106030","Colombo","Kolonnawa","Orugodawatta","510A",5900,3017,2883
"1106035","Colombo","Kolonnawa","Meethotamulla","510",8432,4236,4196
"1106040","Colombo","Kolonnawa","Welewatta","508A",4671,2374,2297
"1106045","Colombo","Kolonnawa","Kittampahuwa","508",5761,2884,2877
"1106050","Colombo","Kolonnawa","Wennawatta","507",7611,3676,3935
"1106055","Colombo","Kolonnawa","Maha Buthgamuwa B","506C",3703,1787,1916
"1106060","Colombo","Kolonnawa","Kuda Buthgamuwa","506A",4649,2242,2407
"1106065","Colombo","Kolonnawa","Kelanimulla","504",4040,1976,2064
"1106070","Colombo","Kolonnawa","Ambathale","501A",2767,1421,1346
"1106075","Colombo","Kolonnawa","Mulleriyawa North","501",4439,2255,2184
"1106080","Colombo","Kolonnawa","Belagama","504A",3283,1601,1682
"1106085","Colombo","Kolonnawa","Kotikawatta East","505",3535,1711,1824
"1106090","Colombo","Kolonnawa","Maha Buthgamuwa A","506",3349,1633,1716
"1106095","Colombo","Kolonnawa","Maha Buthgamuwa C","506D",4103,2016,2087
"1106100","Colombo","Kolonnawa","Wellampitiya","511",2244,1131,1113
"1106105","Colombo","Kolonnawa","Kuruniyawatta","510B",3603,1767,1836
"1106110","Colombo","Kolonnawa","Kolonnawa","512",2342,1170,1172
"1106115","Colombo","Kolonnawa","Dahampura","511A",5867,2867,3000
"1106120","Colombo","Kolonnawa","Singhapura","512B",4078,1982,2096
"1106125","Colombo","Kolonnawa","Megoda Kolonnawa","513A",10149,4975,5174
"1106130","Colombo","Kolonnawa","Bopetta","513D",3221,1564,1657
"1106135","Colombo","Kolonnawa","Batalandahena","506B",4715,2296,2419
"1106140","Colombo","Kolonnawa","Kotikawatta West","505C",2946,1401,1545
"1106145","Colombo","Kolonnawa","Mulleriyawa South","503A",4935,2382,2553
"1106150","Colombo","Kolonnawa","Malgama","503C",5096,2467,2629
"1106155","Colombo","Kolonnawa","Udumulla North","502",2643,1325,1318
"1106160","Colombo","Kolonnawa","Maligagodella","502B",2083,973,1110
"1106165","Colombo","Kolonnawa","Rajasinghagama","502C",6442,2908,3534
"1106170","Colombo","Kolonnawa","Udumulla South","502A",2408,1148,1260
"1106175","Colombo","Kolonnawa","Himbutana East","503B",3879,1902,1977
"1106180","Colombo","Kolonnawa","Himbutana West","503",3344,1649,1695
"1106185","Colombo","Kolonnawa","Malpura","505A",4044,2080,1964
"1106190","Colombo","Kolonnawa","Gothatuwa New Town","505B",1944,939,1005
"1106195","Colombo","Kolonnawa","Kajugahawatta","513C",2567,1244,1323
"1106200","Colombo","Kolonnawa","Gothatuwa","513",2580,1241,1339
"1106205","Colombo","Kolonnawa","Salamulla","512A",5213,2494,2719
"1106210","Colombo","Kolonnawa","Wijayapura","512D",3173,1536,1637
"1106215","Colombo","Kolonnawa","Gajabapura","512C",2533,1243,1290
"1106220","Colombo","Kolonnawa","Madinnagoda","513B",3761,1941,1820
"1106225","Colombo","Kolonnawa","Elhena","513E",2181,1097,1084
"1106230","Colombo","Kolonnawa","Dodamgahahena","505D",3403,1651,1752
"1109005","Colombo","Kaduwela","Welivita","475",4997,2405,2592
"1109010","Colombo","Kaduwela","Raggahawatta","474A",4030,1930,2100
"1109015","Colombo","Kaduwela","Hewagama","474",4165,2064,2101
"1109020","Colombo","Kaduwela","Kaduwela","473A",4342,2261,2081
"1109025","Colombo","Kaduwela","Pahala Bomiriya","472A",4224,2103,2121
"1109030","Colombo","Kaduwela","Ihala Bomiriya","471",4261,2041,2220
"1109035","Colombo","Kaduwela","Wekewatta","471A",3863,1898,1965
"1109040","Colombo","Kaduwela","Nawagamuwa","470",5530,2748,2782
"1109045","Colombo","Kaduwela","Pahala Bomiriya B","472B",4878,2456,2422
"1109050","Colombo","Kaduwela","Welihinda","488A",2099,1043,1056
"1109055","Colombo","Kaduwela","Kothalawala","473",6091,3090,3001
"1109060","Colombo","Kaduwela","Mahadeniya","475A",5495,2684,2811
"1109065","Colombo","Kaduwela","Thalahena North","478",3131,1554,1577
"1109070","Colombo","Kaduwela","Malabe North","476B",7680,3882,3798
"1109075","Colombo","Kaduwela","Thunadahena","488B",4405,2284,2121
"1109080","Colombo","Kaduwela","Korathota","488",9178,4443,4735
"1109085","Colombo","Kaduwela","Nawagamuwa South","470A",2871,1320,1551
"1109090","Colombo","Kaduwela","Batewela","480C",1913,863,1050
"1109095","Colombo","Kaduwela","Ranala","469",4842,2437,2405
"1109100","Colombo","Kaduwela","Dedigamuwa","480A",2105,1029,1076
"1109105","Colombo","Kaduwela","Embilladeniya","480B",1876,942,934
"1109110","Colombo","Kaduwela","Welipillewa","480",2623,1307,1316
"1109115","Colombo","Kaduwela","Shanthalokagama","487A",6922,3298,3624
"1109120","Colombo","Kaduwela","Pore","489",5133,2576,2557
"1109125","Colombo","Kaduwela","Malabe East","476",5958,2923,3035
"1109130","Colombo","Kaduwela","Malabe West","476A",5141,2509,2632
"1109135","Colombo","Kaduwela","Thalangama North B","477A",3777,1822,1955
"1109140","Colombo","Kaduwela","Thalahena South","478A",2793,1337,1456
"1109145","Colombo","Kaduwela","Muttettugoda","477B",6734,3275,3459
"1109150","Colombo","Kaduwela","Thalangama North A","477",9250,4524,4726
"1109155","Colombo","Kaduwela","Walpola","491A",8518,4102,4416
"1109160","Colombo","Kaduwela","Kalapaluwawa","491",4287,2041,2246
"1109165","Colombo","Kaduwela","Kotuwegoda","491B",3087,1544,1543
"1109170","Colombo","Kaduwela","Subhoothipura","492",2568,1314,1254
"1109175","Colombo","Kaduwela","Udumulla","492C",2465,1171,1294
"1109180","Colombo","Kaduwela","Battaramulla North","492B",2001,979,1022
"1109185","Colombo","Kaduwela","Batapotha","479E",7582,3761,3821
"1109190","Colombo","Kaduwela","Pothuarawa","477C",7422,3572,3850
"1109195","Colombo","Kaduwela","Hokandara North","494",6238,3116,3122
"1109200","Colombo","Kaduwela","Oruwala","487",4501,2165,2336
"1109205","Colombo","Kaduwela","Athurugiriya","490",5799,2783,3016
"1109210","Colombo","Kaduwela","Thaldiyawala","490B",3027,1458,1569
"1109215","Colombo","Kaduwela","Boralugoda","489A",3149,1553,1596
"1109220","Colombo","Kaduwela","Hokandara East","494A",5113,2548,2565
"1109225","Colombo","Kaduwela","Arangala","494B",5512,2784,2728
"1109230","Colombo","Kaduwela","Evarihena","495A",2607,1245,1362
"1109235","Colombo","Kaduwela","Kumaragewatta","479D",5076,2480,2596
"1109240","Colombo","Kaduwela","Jayawadanagama","479",2208,1035,1173
"1109245","Colombo","Kaduwela","Aruppitiya","479F",2354,1162,1192
"1109250","Colombo","Kaduwela","Asiri Uyana","479B",3057,1452,1605
"1109255","Colombo","Kaduwela","Battaramulla South","492A",1580,736,844
"1109260","Colombo","Kaduwela","Rajamalwatta","492D",2014,1005,1009
"1109265","Colombo","Kaduwela","Pahalawela","479A",4442,2109,2333
"1109270","Colombo","Kaduwela","Wickramasinghapura","479C",3136,1532,1604
"1109275","Colombo","Kaduwela","Wellangiriya","495",4725,2306,2419
"1109280","Colombo","Kaduwela","Hokandara South","494C",5548,2737,2811
"1109285","Colombo","Kaduwela","Athurugiriya South","490A",3718,1834,1884
"1112005","Colombo","Homagama","Jalthara","449",7292,3581,3711
"1112010","Colombo","Homagama","Henpita","451",1484,763,721
"1112015","Colombo","Homagama","Atigala West","446A",1501,728,773
"1112020","Colombo","Homagama","Atigala East","446",1921,958,963
"1112025","Colombo","Homagama","Batawala","450",1771,845,926
"1112030","Colombo","Homagama","Walpita","450A",1654,816,838
"1112035","Colombo","Homagama","Nawalamulla","482D",3005,1481,1524
"1112040","Colombo","Homagama","Meegasmulla","482E",3022,1558,1464
"1112045","Colombo","Homagama","Habarakada North","481",2723,1356,1367
"1112050","Colombo","Homagama","Mullegama North","481D",1256,592,664
"1112055","Colombo","Homagama","Mullegama South","481A",3142,1515,1627
"1112060","Colombo","Homagama","Habarakada South","481B",2406,1167,1239
"1112065","Colombo","Homagama","Panagoda Town","482B",1755,838,917
"1112070","Colombo","Homagama","Henawatta","482C",6703,3272,3431
"1112075","Colombo","Homagama","Meegoda North","447",3060,1502,1558
"1112080","Colombo","Homagama","Panaluwa","447B",4725,2424,2301
"1112085","Colombo","Homagama","Watareka North","448B",4165,2065,2100
"1112090","Colombo","Homagama","Meegoda South","447A",2105,1040,1065
"1112095","Colombo","Homagama","Godagama North","483",1403,720,683
"1112100","Colombo","Homagama","Panagoda West","482",3070,1505,1565
"1112105","Colombo","Homagama","Panagoda East","482A",1400,1033,367
"1112110","Colombo","Homagama","Habarakada Watta","481C",3064,1491,1573
"1112115","Colombo","Homagama","Homagama North","486",1800,931,869
"1112120","Colombo","Homagama","Homagama West","486B",3240,1588,1652
"1112125","Colombo","Homagama","Homagama South","486F",3128,1583,1545
"1112130","Colombo","Homagama","Galavilawatta North","486C",3525,1687,1838
"1112135","Colombo","Homagama","Homagama Town","486A",2873,1568,1305
"1112140","Colombo","Homagama","Homagama East","486D",2207,1040,1167
"1112145","Colombo","Homagama","Pitipana Town","484B",3062,1595,1467
"1112150","Colombo","Homagama","Godagama South","483A",3154,1527,1627
"1112155","Colombo","Homagama","Kurunduwatta","448C",3867,1828,2039
"1112160","Colombo","Homagama","Gehenuwala","447C",2035,1006,1029
"1112165","Colombo","Homagama","Watareka South","448",6457,3111,3346
"1112170","Colombo","Homagama","Ovitigama","448A",4701,2325,2376
"1112175","Colombo","Homagama","Kandanawatta","484D",2771,1309,1462
"1112180","Colombo","Homagama","Kiriberiyakele","484F",3332,1585,1747
"1112185","Colombo","Homagama","Mawathgama","485",2472,1217,1255
"1112190","Colombo","Homagama","Katuwana","486E",4223,2119,2104
"1112195","Colombo","Homagama","Galavilawatta South","486G",3360,1630,1730
"1112200","Colombo","Homagama","Niyandagala","499A",3845,1738,2107
"1112205","Colombo","Homagama","Hiripitiya","499G",4467,2179,2288
"1112210","Colombo","Homagama","Mambulgoda","500A",2983,1467,1516
"1112215","Colombo","Homagama","Kithulhena","591C",1581,768,813
"1112220","Colombo","Homagama","Siddamulla North","591",2429,1156,1273
"1112225","Colombo","Homagama","Siddamulla South","591B",2452,1183,1269
"1112230","Colombo","Homagama","Mattegoda West","587",4931,2333,2598
"1112235","Colombo","Homagama","Mattegoda Central 'A'","587A",1894,834,1060
"1112240","Colombo","Homagama","Mattegoda East","587C",3594,1806,1788
"1112245","Colombo","Homagama","Brahmanagama","500",4655,2389,2266
"1112250","Colombo","Homagama","Deepangoda","590B",3278,1582,1696
"1112255","Colombo","Homagama","Magammana West","590A",2502,1203,1299
"1112260","Colombo","Homagama","Magammana East","590",4039,1965,2074
"1112265","Colombo","Homagama","Uduwana","485A",3192,1570,1622
"1112270","Colombo","Homagama","Prasannapura","484G",2679,1293,1386
"1112275","Colombo","Homagama","Pitipana North","484",3762,1858,1904
"1112280","Colombo","Homagama","Suwapubudugama","484E",2127,1046,1081
"1112285","Colombo","Homagama","Pitipana South","484A",2888,1378,1510
"1112290","Colombo","Homagama","Dolahena","484C",3981,1961,2020
"1112295","Colombo","Homagama","Diyagama East","589",1529,749,780
"1112300","Colombo","Homagama","Diyagama West","589A",1942,933,1009
"1112305","Colombo","Homagama","Kirigampamunuwa","588",3189,1554,1635
"1112310","Colombo","Homagama","Mattegoda Central 'B'","587B",2968,1385,1583
"1112315","Colombo","Homagama","Siyambalagoda North","592",4087,2067,2020
"1112320","Colombo","Homagama","Kudamaduwa","591A",3087,1535,1552
"1112325","Colombo","Homagama","Sangharama","591D",2129,1034,1095
"1112330","Colombo","Homagama","Siyambalagoda South","592A",1843,888,955
"1112335","Colombo","Homagama","Rilawala","593A",1695,813,882
"1112340","Colombo","Homagama","Kahathuduwa West","602B",3225,1569,1656
"1112345","Colombo","Homagama","Kiriwattuduwa South","603A",2850,1368,1482
"1112350","Colombo","Homagama","Kiriwattuduwa North","603",2091,994,1097
"1112355","Colombo","Homagama","Moonamale - Yakahaluwa","603C",2497,1264,1233
"1112360","Colombo","Homagama","Kithulavila","603B",3189,1556,1633
"1112365","Colombo","Homagama","Kahathuduwa North","602",2681,1265,1416
"1112370","Colombo","Homagama","Kahathuduwa East","602C",2131,998,1133
"1112375","Colombo","Homagama","Kahathuduwa South","602A",3073,1502,1571
"1112380","Colombo","Homagama","Undurugoda","600",1315,623,692
"1112385","Colombo","Homagama","Wethara","593",1977,966,1011
"1112390","Colombo","Homagama","Ambalangoda","594",2044,986,1058
"1112395","Colombo","Homagama","Heraliyawala","595",954,496,458
"1112400","Colombo","Homagama","Palagama","599",2418,1178,1240
"1112405","Colombo","Homagama","Weniwelkola","601",4878,2397,2481
"1115005","Colombo","Seethawaka","Bollathawa","433",1700,813,887
"1115010","Colombo","Seethawaka","Kanampella West","425A",1799,865,934
"1115015","Colombo","Seethawaka","Kanampella East","425",1080,519,561
"1115020","Colombo","Seethawaka","Manakada","429B",598,279,319
"1115025","Colombo","Seethawaka","Eswatta North","429",2048,980,1068
"1115030","Colombo","Seethawaka","Kiriwandala North","431B",3356,1694,1662
"1115035","Colombo","Seethawaka","Kudagama","432A",1689,788,901
"1115040","Colombo","Seethawaka","Weralupitiya","432H",815,405,410
"1115045","Colombo","Seethawaka","Seethagama","432F",2316,1052,1264
"1115050","Colombo","Seethawaka","Avissawella","432",2333,1150,1183
"1115055","Colombo","Seethawaka","Ukwatta","432C",2649,1268,1381
"1115060","Colombo","Seethawaka","Agra Pedesa","432G",2001,927,1074
"1115065","Colombo","Seethawaka","Eswatta South","429C",1631,758,873
"1115070","Colombo","Seethawaka","Ihala Kosgama North","428",2664,1266,1398
"1115075","Colombo","Seethawaka","Thawalgoda","426",1385,656,729
"1115080","Colombo","Seethawaka","Muruthagama","426A",1076,517,559
"1115085","Colombo","Seethawaka","Akaravita","434",1195,591,604
"1115090","Colombo","Seethawaka","Kahatapitiya","435",1152,580,572
"1115095","Colombo","Seethawaka","Kalu Aggala","436",1431,714,717
"1115100","Colombo","Seethawaka","Salawa","427A",2464,1164,1300
"1115105","Colombo","Seethawaka","Pahala Kosgama West","427B",1959,962,997
"1115110","Colombo","Seethawaka","Pahala Kosgama East","427",1830,919,911
"1115115","Colombo","Seethawaka","Ihala Kosgama South","428B",1307,615,692
"1115120","Colombo","Seethawaka","Miriswatta","428C",2095,1036,1059
"1115125","Colombo","Seethawaka","Aluth Ambalama","428A",1837,878,959
"1115130","Colombo","Seethawaka","Kiriwandala South","431E",2138,1063,1075
"1115135","Colombo","Seethawaka","Kotahera","432D",1725,858,867
"1115140","Colombo","Seethawaka","Seethawaka","432B",1877,893,984
"1115145","Colombo","Seethawaka","Aradhana Kanda","432E",2964,1469,1495
"1115150","Colombo","Seethawaka","Puwakpitiya South","431C",3837,1833,2004
"1115155","Colombo","Seethawaka","Puwakpitiya","431",1307,623,684
"1115160","Colombo","Seethawaka","Egodagama","431D",1301,632,669
"1115165","Colombo","Seethawaka","Weragolla North","431A",1893,890,1003
"1115170","Colombo","Seethawaka","Hingurala","429A",2099,1076,1023
"1115175","Colombo","Seethawaka","Kadugoda North","430",1451,694,757
"1115180","Colombo","Seethawaka","Mawalgama","437",2033,982,1051
"1115185","Colombo","Seethawaka","Suduwella","436A",3559,1751,1808
"1115190","Colombo","Seethawaka","Gira Imbula","435A",928,455,473
"1115195","Colombo","Seethawaka","Walawwatta","445A",1339,701,638
"1115200","Colombo","Seethawaka","Pahala Hanwella","445",1492,755,737
"1115205","Colombo","Seethawaka","Hanwella Town","443B",2989,1542,1447
"1115210","Colombo","Seethawaka","Ihala Hanwella North","443",1510,746,764
"1115215","Colombo","Seethawaka","Niripola","438",1681,801,880
"1115220","Colombo","Seethawaka","Brandigampala","440A",1173,571,602
"1115225","Colombo","Seethawaka","Kadugoda South","430A",1732,840,892
"1115230","Colombo","Seethawaka","Weragolla South","431F",1322,693,629
"1115235","Colombo","Seethawaka","Digana","442F",1478,704,774
"1115240","Colombo","Seethawaka","Lahirugama","442D",2146,1040,1106
"1115245","Colombo","Seethawaka","Mambula","441",1128,529,599
"1115250","Colombo","Seethawaka","Welikanna","442",1512,705,807
"1115255","Colombo","Seethawaka","Kahahena","441A",1627,797,830
"1115260","Colombo","Seethawaka","Neluwattuduwa","440",666,329,337
"1115265","Colombo","Seethawaka","Diddeniya North","439",1717,849,868
"1115270","Colombo","Seethawaka","Ihala Hanwella South","443C",1041,493,548
"1115275","Colombo","Seethawaka","Pahathgama","443A",1857,928,929
"1115280","Colombo","Seethawaka","Jayaweeragoda","443D",1717,839,878
"1115285","Colombo","Seethawaka","Koodaluvila","444D",2807,1378,1429
"1115290","Colombo","Seethawaka","Thunnana East","444",868,441,427
"1115295","Colombo","Seethawaka","Diddeniya South","439A",1233,623,610
"1115300","Colombo","Seethawaka","Elamalawala","442B",606,303,303
"1115305","Colombo","Seethawaka","Ilukovita","442C",533,261,272
"1115310","Colombo","Seethawaka","Koswatta","442E",708,343,365
"1115315","Colombo","Seethawaka","Pagngnagula","442A",767,366,401
"1115320","Colombo","Seethawaka","Pelpola","442G",744,361,383
"1115325","Colombo","Seethawaka","Kudakanda","444E",1289,600,689
"1115330","Colombo","Seethawaka","Thunnana West","444B",1713,838,875
"1115335","Colombo","Seethawaka","Mawathagama West","444C",1976,923,1053
"1115340","Colombo","Seethawaka","Mawathagama East","444A",914,445,469
"1118005","Colombo","Padukka","Pinnawala North","456",845,403,442
"1118010","Colombo","Padukka","Pinnawala South","456A",1518,737,781
"1118015","Colombo","Padukka","Waga North","457B",857,434,423
"1118020","Colombo","Padukka","Waga East","457",1789,882,907
"1118025","Colombo","Padukka","Thummodara","458A",794,389,405
"1118030","Colombo","Padukka","Waga South","457C",970,467,503
"1118035","Colombo","Padukka","Siyambalawa","459B",1891,927,964
"1118040","Colombo","Padukka","Pahala Bope","459A",1074,500,574
"1118045","Colombo","Padukka","Halpe","454B",727,345,382
"1118050","Colombo","Padukka","Waga West","457A",1339,642,697
"1118055","Colombo","Padukka","Uggalla","454",1878,919,959
"1118060","Colombo","Padukka","Wewelpanawa","453A",707,335,372
"1118065","Colombo","Padukka","Pitumpe North","453",1438,698,740
"1118070","Colombo","Padukka","Pitumpe South","453B",1332,632,700
"1118075","Colombo","Padukka","Galagedara East","452",2790,1420,1370
"1118080","Colombo","Padukka","Galagedara North","452A",2391,1194,1197
"1118085","Colombo","Padukka","Galagedara South","452B",1247,614,633
"1118090","Colombo","Padukka","Padukka","461",2939,1451,1488
"1118095","Colombo","Padukka","Arukwatta North","460",1520,724,796
"1118100","Colombo","Padukka","Arukwatta South","460A",2168,1078,1090
"1118105","Colombo","Padukka","Ganegoda","460B",1157,545,612
"1118110","Colombo","Padukka","Angampitiya","454A",2157,1049,1108
"1118115","Colombo","Padukka","Weragala","455",1814,886,928
"1118120","Colombo","Padukka","Angamuwa","461A",1593,803,790
"1118125","Colombo","Padukka","Udumulla","461B",2340,1133,1207
"1118130","Colombo","Padukka","Poregedara","462A",1071,520,551
"1118135","Colombo","Padukka","Pahala Padukka","461C",1329,632,697
"1118140","Colombo","Padukka","Liyanwala","462",1175,570,605
"1118145","Colombo","Padukka","Kurugala","465",1469,725,744
"1118150","Colombo","Padukka","Madulawa South","463A",983,495,488
"1118155","Colombo","Padukka","Madulawa North","463",1361,671,690
"1118160","Colombo","Padukka","Horakandawala","464C",2059,1018,1041
"1118165","Colombo","Padukka","Dampe","464A",1498,726,772
"1118170","Colombo","Padukka","Beruketiya","464D",1901,940,961
"1118175","Colombo","Padukka","Horagala West","464B",1284,626,658
"1118180","Colombo","Padukka","Horagala East","464",1763,891,872
"1118185","Colombo","Padukka","Beliattavila","461D",753,385,368
"1118190","Colombo","Padukka","Miriyagalla","466",1367,659,708
"1118195","Colombo","Padukka","Malagala","467",1755,808,947
"1118200","Colombo","Padukka","Kahawala","467A",932,446,486
"1118205","Colombo","Padukka","Yatawathura","468",764,347,417
"1118210","Colombo","Padukka","Mahingala","455A",621,307,314
"1118215","Colombo","Padukka","Ihala Bope","459",1412,690,722
"1118220","Colombo","Padukka","Gurulana","458B",917,462,455
"1118225","Colombo","Padukka","Udagama","458",765,366,399
"1118230","Colombo","Padukka","Dambora","458C",813,398,415
"1121005","Colombo","Maharagama","Mirihana South","523A",6043,2971,3072
"1121010","Colombo","Maharagama","Mirihana North","523",6222,2953,3269
"1121015","Colombo","Maharagama","Madiwela","524",6244,3028,3216
"1121020","Colombo","Maharagama","Thalawathugoda West","493A",5492,2759,2733
"1121025","Colombo","Maharagama","Thalawathugoda East","493B",6217,2954,3263
"1121030","Colombo","Maharagama","Kalalgoda","493",4956,2383,2573
"1121035","Colombo","Maharagama","Kottawa East","496A",5632,2673,2959
"1121040","Colombo","Maharagama","Rukmale West","497",4471,2185,2286
"1121045","Colombo","Maharagama","Rukmale East A","497A",1259,608,651
"1121050","Colombo","Maharagama","Rukmale East B","497B",2697,1265,1432
"1121055","Colombo","Maharagama","Liyanagoda","496E",4342,2081,2261
"1121060","Colombo","Maharagama","Kottawa North","496C",2466,1186,1280
"1121065","Colombo","Maharagama","Depanama","529A",7647,3700,3947
"1121070","Colombo","Maharagama","Polwatta","529",3513,1667,1846
"1121075","Colombo","Maharagama","Pamunuwa","528",4543,2294,2249
"1121080","Colombo","Maharagama","Thalapathpitiya","525",7086,3249,3837
"1121085","Colombo","Maharagama","Pragathipura","524A",5838,2867,2971
"1121090","Colombo","Maharagama","Udahamulla East","525A",6309,3132,3177
"1121095","Colombo","Maharagama","Udahamulla West","525B",4780,2309,2471
"1121100","Colombo","Maharagama","Pathiragoda","527A",6546,3167,3379
"1121105","Colombo","Maharagama","Maharagama East","527B",3695,1704,1991
"1121110","Colombo","Maharagama","Maharagama West","527C",2464,1242,1222
"1121115","Colombo","Maharagama","Dambahena","528A",5233,2485,2748
"1121120","Colombo","Maharagama","Pannipitiya North","531",4060,1943,2117
"1121125","Colombo","Maharagama","Kottawa West","496D",2766,1345,1421
"1121130","Colombo","Maharagama","Kottawa South","496",7159,3450,3709
"1121135","Colombo","Maharagama","Malapalla West","498B",2692,1304,1388
"1121140","Colombo","Maharagama","Malapalla East","498",3648,1790,1858
"1121145","Colombo","Maharagama","Makumbura North","498A",3458,1680,1778
"1121150","Colombo","Maharagama","Makumbura South","498C",1596,768,828
"1121155","Colombo","Maharagama","Kottawa Town","496B",5496,2796,2700
"1121160","Colombo","Maharagama","Pannipitiya South","531A",2255,1056,1199
"1121165","Colombo","Maharagama","Maharagama Town","530",5453,2675,2778
"1121170","Colombo","Maharagama","Godigamuwa South","532A",5194,2477,2717
"1121175","Colombo","Maharagama","Godigamuwa South B","532B",7328,3470,3858
"1121180","Colombo","Maharagama","Godigamuwa North","532",4094,1864,2230
"1121185","Colombo","Maharagama","Wattegedara","532C",7734,3631,4103
"1121190","Colombo","Maharagama","Navinna","527",4901,2316,2585
"1121195","Colombo","Maharagama","Wijerama","526C",3675,1967,1708
"1121200","Colombo","Maharagama","Gangodavila South B","526B",7391,2908,4483
"1121205","Colombo","Maharagama","Jambugasmulla","526D",3828,1815,2013
"1124005","Colombo","Sri Jayawardenepura Kotte","Obsekarapura","514C",11963,5925,6038
"1124010","Colombo","Sri Jayawardenepura Kotte","Welikada West","514A",7004,3195,3809
"1124015","Colombo","Sri Jayawardenepura Kotte","Welikada East","514",6749,3183,3566
"1124020","Colombo","Sri Jayawardenepura Kotte","Rajagiriya","514B",3591,1878,1713
"1124025","Colombo","Sri Jayawardenepura Kotte","Welikada North","514D",4834,2389,2445
"1124030","Colombo","Sri Jayawardenepura Kotte","Nawala West","520",4059,2032,2027
"1124035","Colombo","Sri Jayawardenepura Kotte","Koswatta","520A",5707,2767,2940
"1124040","Colombo","Sri Jayawardenepura Kotte","Ethulkotte West","521A",3371,1664,1707
"1124045","Colombo","Sri Jayawardenepura Kotte","Ethulkotte","521",5929,2877,3052
"1124050","Colombo","Sri Jayawardenepura Kotte","Pitakotte East","522A",3984,1912,2072
"1124055","Colombo","Sri Jayawardenepura Kotte","Pitakotte","522B",3634,1753,1881
"1124060","Colombo","Sri Jayawardenepura Kotte","Pitakotte West","522",5301,2439,2862
"1124065","Colombo","Sri Jayawardenepura Kotte","Nawala East","520B",5473,2573,2900
"1124070","Colombo","Sri Jayawardenepura Kotte","Nugegoda West","519B",5627,2635,2992
"1124075","Colombo","Sri Jayawardenepura Kotte","Pagoda","519A",5446,2537,2909
"1124080","Colombo","Sri Jayawardenepura Kotte","Nugegoda","519",3365,1678,1687
"1124085","Colombo","Sri Jayawardenepura Kotte","Pagoda East","519C",5944,2902,3042
"1124090","Colombo","Sri Jayawardenepura Kotte","Gangodavila North","526",5352,2493,2859
"1124095","Colombo","Sri Jayawardenepura Kotte","Gangodavila South","526A",7305,3554,3751
"1124100","Colombo","Sri Jayawardenepura Kotte","Gangodavila East","526C",3287,1606,1681
"1127005","Colombo","Thimbirigasyaya","Kollupitiya","",6711,3549,3162
"1127010","Colombo","Thimbirigasyaya","Bambalapitiya","",7564,3621,3943
"1127015","Colombo","Thimbirigasyaya","Kurunduwatta","",9914,4703,5211
"1127020","Colombo","Thimbirigasyaya","Kuppiyawatta West","",6954,3468,3486
"1127025","Colombo","Thimbirigasyaya","Kuppiyawatta East","",10577,5498,5079
"1127030","Colombo","Thimbirigasyaya","Dematagoda","",18602,9356,9246
"1127035","Colombo","Thimbirigasyaya","Wanathamulla","",17355,8547,8808
"1127040","Colombo","Thimbirigasyaya","Borella North","",21326,13617,7709
"1127045","Colombo","Thimbirigasyaya","Borella South","",5127,2566,2561
"1127050","Colombo","Thimbirigasyaya","Gothamipura","",6498,3213,3285
"1127055","Colombo","Thimbirigasyaya","Narahenpita","",11194,5503,5691
"1127060","Colombo","Thimbirigasyaya","Thimbirigasyaya","",12675,5949,6726
"1127065","Colombo","Thimbirigasyaya","Milagiriya","",7389,3214,4175
"1127070","Colombo","Thimbirigasyaya","Havelock Town","",7455,3464,3991
"1127075","Colombo","Thimbirigasyaya","Kirula","",20237,9576,10661
"1127080","Colombo","Thimbirigasyaya","Kirulapone","",17846,8818,9028
"1127085","Colombo","Thimbirigasyaya","Wellawatta North","",14967,7131,7836
"1127090","Colombo","Thimbirigasyaya","Wellawatta South","",10826,5059,5767
"1127095","Colombo","Thimbirigasyaya","Pamankada West","",12451,5658,6793
"1127100","Colombo","Thimbirigasyaya","Pamankada East","",12389,6150,6239
"1130005","Colombo","Dehiwala","Sri Saranankara","538C",6367,3111,3256
"1130010","Colombo","Dehiwala","Vilawala","537",6334,3095,3239
"1130015","Colombo","Dehiwala","Dutugemunu","537A",4806,2388,2418
"1130020","Colombo","Dehiwala","Kohuwala","537B",5475,2567,2908
"1130025","Colombo","Dehiwala","Kalubovila","538",5517,2674,2843
"1130030","Colombo","Dehiwala","Hathbodhiya","538B",6228,3049,3179
"1130035","Colombo","Dehiwala","Galwala","538A",5671,2814,2857
"1130040","Colombo","Dehiwala","Dehiwala West","540A",5184,2499,2685
"1130045","Colombo","Dehiwala","Dehiwala East","540",6767,3262,3505
"1130050","Colombo","Dehiwala","Udyanaya","536A",5914,2891,3023
"1130055","Colombo","Dehiwala","Nedimala","536",9058,4356,4702
"1130060","Colombo","Dehiwala","Malwatta","539/42A",3543,1714,1829
"1130065","Colombo","Dehiwala","Jayathilaka","540B",4374,2108,2266
"1130070","Colombo","Dehiwala","Karagampitiya","539/42",5633,2826,2807
"1130075","Colombo","Dehiwala","Kawdana East","539/42B",8091,3847,4244
"1131005","Colombo","Ratmalana","Mount Lavinia","541",8373,4255,4118
"1131010","Colombo","Ratmalana","Kawdana West","539/42C",6624,3199,3425
"1131015","Colombo","Ratmalana","Watarappala","544",6311,3116,3195
"1131020","Colombo","Ratmalana","Wathumulla","544A",4608,2210,2398
"1131025","Colombo","Ratmalana","Katukurunduwatta","545A",12166,5944,6222
"1131030","Colombo","Ratmalana","Attidiya North","543",8854,4284,4570
"1131035","Colombo","Ratmalana","Attidiya South","543B",7683,3686,3997
"1131040","Colombo","Ratmalana","Piriwena","545",5018,2380,2638
"1131045","Colombo","Ratmalana","Wedikanda","546A",7585,3635,3950
"1131050","Colombo","Ratmalana","Vihara","546B",6443,3097,3346
"1131055","Colombo","Ratmalana","Rathmalana West","546",5736,2847,2889
"1131060","Colombo","Ratmalana","Rathmalana East","546C",6564,3408,3156
"1131065","Colombo","Ratmalana","Kandawala","543A",9541,4725,4816
"1133005","Colombo","Moratuwa","Angulana North","547",4201,2107,2094
"1133010","Colombo","Moratuwa","Kaldemulla","548",4805,2299,2506
"1133015","Colombo","Moratuwa","Soysapura North","548A",2898,1339,1559
"1133020","Colombo","Moratuwa","Soysapura South","548B",2711,1305,1406
"1133025","Colombo","Moratuwa","Dahampura","548C",2748,1288,1460
"1133030","Colombo","Moratuwa","Thelawala North","549B",5385,2696,2689
"1133035","Colombo","Moratuwa","Borupana","549A",5918,2913,3005
"1133040","Colombo","Moratuwa","Thelawala South","549",3916,1826,2090
"1133045","Colombo","Moratuwa","Lakshapathiya North","550A",4481,2168,2313
"1133050","Colombo","Moratuwa","Lakshapathiya Central","550B",3049,1508,1541
"1133055","Colombo","Moratuwa","Angulana South","547A",3333,1681,1652
"1133060","Colombo","Moratuwa","Uyana South","552A",4464,2186,2278
"1133065","Colombo","Moratuwa","Uyana North","552B",3783,1862,1921
"1133070","Colombo","Moratuwa","Rawathawatta South","557B",2144,973,1171
"1133075","Colombo","Moratuwa","Rawathawatta East","557",4033,1941,2092
"1133080","Colombo","Moratuwa","Lakshapathiya South","550",5380,2564,2816
"1133085","Colombo","Moratuwa","Kuduwamulla","551B",3194,1618,1576
"1133090","Colombo","Moratuwa","Katubedda","551",10596,5500,5096
"1133095","Colombo","Moratuwa","Molpe","551A",7487,3956,3531
"1133100","Colombo","Moratuwa","Moratumulla North","551C",3255,1590,1665
"1133105","Colombo","Moratuwa","Kadalana","558A",3544,1711,1833
"1133110","Colombo","Moratuwa","Rawathawatta West","557A",3375,1554,1821
"1133115","Colombo","Moratuwa","Idama","552",2826,1277,1549
"1133120","Colombo","Moratuwa","Uswatta","553C",2174,1019,1155
"1133125","Colombo","Moratuwa","Moratuwella South","553",4524,2111,2413
"1133130","Colombo","Moratuwa","Indibedda West","559",4437,2209,2228
"1133135","Colombo","Moratuwa","Moratumulla East","558",3854,1899,1955
"1133140","Colombo","Moratuwa","Moratumulla West","558B",3630,1759,1871
"1133145","Colombo","Moratuwa","Villorawatta East","560/61",3678,1767,1911
"1133150","Colombo","Moratuwa","Villorawatta West","560/61A",4689,2303,2386
"1133155","Colombo","Moratuwa","Indibedda East","559A",3592,1779,1813
"1133160","Colombo","Moratuwa","Moratuwella North","553A",2236,1091,1145
"1133165","Colombo","Moratuwa","Moratuwella West","553B",2394,1211,1183
"1133170","Colombo","Moratuwa","Koralawella North","554",5696,2785,2911
"1133175","Colombo","Moratuwa","Koralawella East","554B",2192,1046,1146
"1133180","Colombo","Moratuwa","Koralawella West","554C",3531,1719,1812
"1133185","Colombo","Moratuwa","Koralawella South","554A",3582,1735,1847
"1133190","Colombo","Moratuwa","Katukurunda North","555",3551,1722,1829
"1133195","Colombo","Moratuwa","Katukurunda South","555A",4399,2128,2271
"1133200","Colombo","Moratuwa","Egoda Uyana North","556",4603,2229,2374
"1133205","Colombo","Moratuwa","Egoda Uyana Central","556A",2869,1418,1451
"1133210","Colombo","Moratuwa","Egoda Uyana South","556B",5123,2531,2592
"1136005","Colombo","Kesbewa","Pepiliyana West","535",5039,2423,2616
"1136010","Colombo","Kesbewa","Pepiliyana East","535C",1765,850,915
"1136015","Colombo","Kesbewa","Divulpitiya East","535D",2328,1192,1136
"1136020","Colombo","Kesbewa","Divulpitiya West","535B",2631,1339,1292
"1136025","Colombo","Kesbewa","Bellanvila","535A",3413,1689,1724
"1136030","Colombo","Kesbewa","Boralesgamuwa West A","533B",4466,2058,2408
"1136035","Colombo","Kesbewa","Boralesgamuwa West C","533F",1485,739,746
"1136040","Colombo","Kesbewa","Rattanapitiya","533A",4768,2201,2567
"1136045","Colombo","Kesbewa","Egodawatta","533C",3310,1462,1848
"1136050","Colombo","Kesbewa","Boralesgamuwa East A","533",4842,2372,2470
"1136055","Colombo","Kesbewa","Boralesgamuwa West B","533E",2822,1373,1449
"1136060","Colombo","Kesbewa","Werahera North","577",1977,983,994
"1136065","Colombo","Kesbewa","Boralesgamuwa East B","533D",5204,2508,2696
"1136070","Colombo","Kesbewa","Neelammahara","579",3358,1649,1709
"1136075","Colombo","Kesbewa","Katuwawala North","578",3697,1803,1894
"1136080","Colombo","Kesbewa","Vishwakalawa","574B",2045,967,1078
"1136085","Colombo","Kesbewa","Werahera South","577A",5213,2547,2666
"1136090","Colombo","Kesbewa","Katuwawala South","578A",1489,707,782
"1136095","Colombo","Kesbewa","Niwanthidiya","580A",3435,1648,1787
"1136100","Colombo","Kesbewa","Erewwala West","581A",6544,3135,3409
"1136105","Colombo","Kesbewa","Erewwala North","581D",4373,2138,2235
"1136110","Colombo","Kesbewa","Erewwala East","581",2542,1284,1258
"1136115","Colombo","Kesbewa","Rathmaldeniya","581C",5440,2581,2859
"1136120","Colombo","Kesbewa","Mahalwarawa","581E",2773,1315,1458
"1136125","Colombo","Kesbewa","Bangalawatta","581B",2194,1001,1193
"1136130","Colombo","Kesbewa","Pelenwatta East","582B",4032,1975,2057
"1136135","Colombo","Kesbewa","Pelenwatta North","582",4703,2276,2427
"1136140","Colombo","Kesbewa","Pelenwatta West","582A",5503,2682,2821
"1136145","Colombo","Kesbewa","Paligedara","583A",3050,1443,1607
"1136150","Colombo","Kesbewa","Kaliyammahara","580",3042,1493,1549
"1136155","Colombo","Kesbewa","Bokundara","575",3633,1773,1860
"1136160","Colombo","Kesbewa","Thumbovila South","576B",3303,1654,1649
"1136165","Colombo","Kesbewa","Thumbovila North","576A",4037,1962,2075
"1136170","Colombo","Kesbewa","Wewala West","562B",4949,2425,2524
"1136175","Colombo","Kesbewa","Wewala East","562",2655,1276,1379
"1136180","Colombo","Kesbewa","Thumbovila West","576",2697,1292,1405
"1136185","Colombo","Kesbewa","Mampe North","574A",4690,2301,2389
"1136190","Colombo","Kesbewa","Makuludoowa","583",3257,1556,1701
"1136195","Colombo","Kesbewa","Gorakapitiya","584",1749,827,922
"1136200","Colombo","Kesbewa","Nampamunuwa","584A",3385,1643,1742
"1136205","Colombo","Kesbewa","Mavittara North","586A",2761,1338,1423
"1136210","Colombo","Kesbewa","Mampe East","574D",2040,984,1056
"1136215","Colombo","Kesbewa","Bodhirajapura","577B",2303,1155,1148
"1136220","Colombo","Kesbewa","Mampe West","574",3055,1506,1549
"1136225","Colombo","Kesbewa","Mampe South","574C",2070,985,1085
"1136230","Colombo","Kesbewa","Kolamunna","563/73A",3633,1723,1910
"1136235","Colombo","Kesbewa","Suwarapola East","562A",2779,1298,1481
"1136240","Colombo","Kesbewa","Suwarapola West","562C",1387,679,708
"1136245","Colombo","Kesbewa","Hedigama","563/73",4294,2104,2190
"1136250","Colombo","Kesbewa","Batakettara North","565",5847,2853,2994
"1136255","Colombo","Kesbewa","Kesbewa North","572",4279,2014,2265
"1136260","Colombo","Kesbewa","Kesbewa East","572B",2019,980,1039
"1136265","Colombo","Kesbewa","Mavittara South","586",1880,902,978
"1136270","Colombo","Kesbewa","Honnanthara North","585",3522,1716,1806
"1136275","Colombo","Kesbewa","Honnanthara South","585A",3939,1853,2086
"1136280","Colombo","Kesbewa","Makandana East","569",4947,2419,2528
"1136285","Colombo","Kesbewa","Kesbewa South","572A",6316,3130,3186
"1136290","Colombo","Kesbewa","Batakettara South","565A",6628,3320,3308
"1136295","Colombo","Kesbewa","Madapatha","567",3799,1888,1911
"1136300","Colombo","Kesbewa","Delthara West","564",2084,1039,1045
"1136305","Colombo","Kesbewa","Delthara East","564A",1524,754,770
"1136310","Colombo","Kesbewa","Dampe","566",4165,2047,2118
"1136315","Colombo","Kesbewa","Makandana West","569A",4434,2150,2284
"1136320","Colombo","Kesbewa","Nivungama","568A",2196,1078,1118
"1136325","Colombo","Kesbewa","Halpita","570/571",5487,2659,2828
"1136330","Colombo","Kesbewa","Horathuduwa","570/71A",1604,754,850
"1136335","Colombo","Kesbewa","Morenda","568",1300,629,671
"1136340","Colombo","Kesbewa","Batuwandara North","596",1545,717,828
"1136345","Colombo","Kesbewa","Batuwandara South","596A",1481,734,747
"1136350","Colombo","Kesbewa","Jamburaliya","597",3184,1602,1582
"1136355","Colombo","Kesbewa","Polhena","598B",2339,1117,1222
"1136360","Colombo","Kesbewa","Regidel Watta","598A",1270,638,632
"1136365","Colombo","Kesbewa","Kahapola","598",3283,1615,1668
"1203005","Gampaha","Negombo","Kammalthura","77A",4425,2195,2230
"1203010","Gampaha","Negombo","Pallansena North","77",3722,1735,1987
"1203015","Gampaha","Negombo","Kochchikade","78",2777,1361,1416
"1203020","Gampaha","Negombo","Pallansena South","76",3913,1884,2029
"1203025","Gampaha","Negombo","Daluwakotuwa","74",4925,2327,2598
"1203030","Gampaha","Negombo","Palangathure","75A",5025,2426,2599
"1203035","Gampaha","Negombo","Ettukala","73",3534,1689,1845
"1203040","Gampaha","Negombo","Daluwakotuwa East","74A",5478,2663,2815
"1203045","Gampaha","Negombo","Kattuwa","75",4921,2344,2577
"1203050","Gampaha","Negombo","Dalupatha East","72A",6605,3351,3254
"1203055","Gampaha","Negombo","Dalupatha","72",3606,1711,1895
"1203060","Gampaha","Negombo","Kudapaduwa","73A",2997,1398,1599
"1203065","Gampaha","Negombo","Kudapaduwa North","73B",3917,1940,1977
"1203070","Gampaha","Negombo","Kudapaduwa South","73C",3353,1603,1750
"1203075","Gampaha","Negombo","Wellaweediya","158",3928,1906,2022
"1203080","Gampaha","Negombo","Wellaweediya East","158B",3006,1458,1548
"1203085","Gampaha","Negombo","Periyamulla","159",3125,1559,1566
"1203090","Gampaha","Negombo","Hunupitiya","159A",6062,2944,3118
"1203095","Gampaha","Negombo","Angurukaramulla","161A",3663,1786,1877
"1203100","Gampaha","Negombo","Udayarthoppuwa","160",4027,1914,2113
"1203105","Gampaha","Negombo","Wellaweediya South","158A",2718,1338,1380
"1203110","Gampaha","Negombo","Muttakkarai  North","156A",2852,1633,1219
"1203115","Gampaha","Negombo","Doowa","162A",2932,1347,1585
"1203120","Gampaha","Negombo","Pitipana North","162",2948,1405,1543
"1203125","Gampaha","Negombo","Pitipana Central","162D",2460,1171,1289
"1203130","Gampaha","Negombo","Muttakkarai","156",2975,1392,1583
"1203135","Gampaha","Negombo","Muttakkarai East","156B",2058,955,1103
"1203140","Gampaha","Negombo","Thaladoowa","160A",6757,3261,3496
"1203145","Gampaha","Negombo","Udayarthoppuwa South","160B",2475,1207,1268
"1203150","Gampaha","Negombo","Bolawalana","157",5453,2471,2982
"1203155","Gampaha","Negombo","Kurana West","157B",4009,1909,2100
"1203160","Gampaha","Negombo","Kurana East","157A",2620,1222,1398
"1203165","Gampaha","Negombo","Siriwardana Pedesa","156C",3452,1645,1807
"1203170","Gampaha","Negombo","Pitipana South - East","162C",2625,1260,1365
"1203175","Gampaha","Negombo","Pitipana South - West","162B",3225,1585,1640
"1203180","Gampaha","Negombo","Thalahena","163",3729,1838,1891
"1203185","Gampaha","Negombo","Dungalpitiya","163B",2049,970,1079
"1203190","Gampaha","Negombo","Settappaduwa","163C",1883,921,962
"1203195","Gampaha","Negombo","Kepungoda","163A",1907,876,1031
"1206005","Gampaha","Katana","Muruthana","66",1369,644,725
"1206010","Gampaha","Katana","Manaveriya","67A",1712,814,898
"1206015","Gampaha","Katana","Udangawa","67",1720,827,893
"1206020","Gampaha","Katana","Thoppuwa","65A",2914,1411,1503
"1206025","Gampaha","Katana","Bambukuliya","65",2657,1296,1361
"1206030","Gampaha","Katana","Katana North","64A",2623,1247,1376
"1206035","Gampaha","Katana","Katana East","63",2010,1017,993
"1206040","Gampaha","Katana","Katana West","64",3087,1478,1609
"1206045","Gampaha","Katana","Maha Ethgala","68A",1762,868,894
"1206050","Gampaha","Katana","Ethgala","68",3062,1481,1581
"1206055","Gampaha","Katana","Adikkandiya","69B",1061,474,587
"1206060","Gampaha","Katana","Welihena North","69",1823,885,938
"1206065","Gampaha","Katana","Welihena South","69A",4495,2122,2373
"1206070","Gampaha","Katana","Pahala Kandawala","70A",1793,841,952
"1206075","Gampaha","Katana","Ethgala South","68B",991,480,511
"1206080","Gampaha","Katana","Ihala Kandawala","70",4286,2006,2280
"1206085","Gampaha","Katana","Kaluwarippuwa West","94",3630,1783,1847
"1206090","Gampaha","Katana","Kondagammulla","93",2789,1350,1439
"1206095","Gampaha","Katana","Katiyala","93B",3212,1548,1664
"1206100","Gampaha","Katana","Kadirana North","93A",5611,2715,2896
"1206105","Gampaha","Katana","K.C. De Silva Puraya","70B",3711,1827,1884
"1206110","Gampaha","Katana","Thimbirigaskatuwa","71",2594,1214,1380
"1206115","Gampaha","Katana","Sellakanda","161C",4528,2230,2298
"1206120","Gampaha","Katana","Katuwapitiya","161B",2345,1111,1234
"1206125","Gampaha","Katana","Mahahunupitiya West","161D",2010,981,1029
"1206130","Gampaha","Katana","Mahahunupitiya East","161",2496,1186,1310
"1206135","Gampaha","Katana","Pahala Kadirana","93F",2195,1029,1166
"1206140","Gampaha","Katana","Kadirana","93E",5505,2654,2851
"1206145","Gampaha","Katana","Akkara 50","93D",6995,3375,3620
"1206150","Gampaha","Katana","Kadirana South","93C",3245,1602,1643
"1206155","Gampaha","Katana","Kimbulapitiya West","92B",2621,1283,1338
"1206160","Gampaha","Katana","Kimbulapitiya North","92A",1724,854,870
"1206165","Gampaha","Katana","Kimbulapitiya South","92",3418,1682,1736
"1206170","Gampaha","Katana","Kimbulapitiya Central","92C",3656,1735,1921
"1206175","Gampaha","Katana","Andiambalama West","155",6567,3131,3436
"1206180","Gampaha","Katana","Walpola","155A",1967,941,1026
"1206185","Gampaha","Katana","Andiambalama East","155B",3622,1739,1883
"1206190","Gampaha","Katana","Dewamottawa","154",3696,1810,1886
"1206195","Gampaha","Katana","Kovinna","151",4653,2140,2513
"1206200","Gampaha","Katana","Evariwatta","149",6804,2788,4016
"1206205","Gampaha","Katana","Air Force Camp","150",2733,2027,706
"1206210","Gampaha","Katana","Kurana Katunayaka West","142B",3138,1524,1614
"1206215","Gampaha","Katana","Kurana Katunayaka North","142",2701,1310,1391
"1206220","Gampaha","Katana","Kurana Katunayaka South","142A",1814,876,938
"1206225","Gampaha","Katana","Katunayaka North","143",2177,1080,1097
"1206230","Gampaha","Katana","Katunayaka South","143A",5738,2580,3158
"1206235","Gampaha","Katana","Walanagoda","152A",3361,1261,2100
"1206240","Gampaha","Katana","Kalahapitiya","154A",2708,1307,1401
"1206245","Gampaha","Katana","Madawala","152",2552,1228,1324
"1206250","Gampaha","Katana","Muthuwadiya","201",1758,870,888
"1206255","Gampaha","Katana","Liyanagemulla North","144A",5898,2958,2940
"1206260","Gampaha","Katana","Liyanagemulla South","144",4824,2308,2516
"1206265","Gampaha","Katana","Amandoluwa","148",8538,3986,4552
"1206270","Gampaha","Katana","Thempala","200",1476,711,765
"1206275","Gampaha","Katana","Kuswala","202",2225,1032,1193
"1206280","Gampaha","Katana","Ganepola","203",1961,936,1025
"1206285","Gampaha","Katana","Heenatiyana West","153",2465,1126,1339
"1206290","Gampaha","Katana","Heenatiyana South","153B",2458,1162,1296
"1206295","Gampaha","Katana","Heenatiyana East","153A",2111,1032,1079
"1206300","Gampaha","Katana","Raddolugama North A","199F",1723,801,922
"1206305","Gampaha","Katana","Raddolugama North","199C",1221,553,668
"1206310","Gampaha","Katana","Raddolugama South","199B",1894,875,1019
"1206315","Gampaha","Katana","Raddolugama South A","199E",1828,840,988
"1206320","Gampaha","Katana","Raddoluwa North","199",2554,1276,1278
"1206325","Gampaha","Katana","Raddoluwa West","199D",3197,1552,1645
"1206330","Gampaha","Katana","Seeduwa","147",5210,2497,2713
"1206335","Gampaha","Katana","Mookalangamuwa West","145B",3041,1429,1612
"1206340","Gampaha","Katana","Mookalangamuwa East","145A",2402,1179,1223
"1206345","Gampaha","Katana","Bandarawatta East","145C",1915,947,968
"1206350","Gampaha","Katana","Bandarawatta West","145",4127,2084,2043
"1206355","Gampaha","Katana","Dambaduraya","198A",1672,808,864
"1206360","Gampaha","Katana","Raddoluwa South","199A",3062,1452,1610
"1206365","Gampaha","Katana","Lansiyawadiya","204A",2475,1155,1320
"1206370","Gampaha","Katana","Kotugoda","204",2691,1305,1386
"1206375","Gampaha","Katana","Kasagahawatta","204B",1848,886,962
"1206380","Gampaha","Katana","Udammita North","197",1758,850,908
"1206385","Gampaha","Katana","Alawathupitiya","198",1188,571,617
"1206390","Gampaha","Katana","Udammita South","197A",1490,687,803
"1206395","Gampaha","Katana","Ambalammulla","146",2400,1143,1257
"1209005","Gampaha","Divulapitiya","Andimulla","61A",1451,696,755
"1209010","Gampaha","Divulapitiya","Ambalayaya","61",1250,629,621
"1209015","Gampaha","Divulapitiya","Bolagala","60A",700,357,343
"1209020","Gampaha","Divulapitiya","Otharawadiya","60",943,472,471
"1209025","Gampaha","Divulapitiya","Godigamuwa West","57",879,467,412
"1209030","Gampaha","Divulapitiya","Godigamuwa East","57A",1373,671,702
"1209035","Gampaha","Divulapitiya","Balawala","56C",462,262,200
"1209040","Gampaha","Divulapitiya","Badalgama","56",1256,645,611
"1209045","Gampaha","Divulapitiya","Delpakadawara","56A",556,262,294
"1209050","Gampaha","Divulapitiya","Siringapathawatta","55C",398,195,203
"1209055","Gampaha","Divulapitiya","Pethigoda","55",1729,855,874
"1209060","Gampaha","Divulapitiya","Alugolla","55B",1239,646,593
"1209065","Gampaha","Divulapitiya","Polwatta","54A",1147,577,570
"1209070","Gampaha","Divulapitiya","Polhena","80E",954,490,464
"1209075","Gampaha","Divulapitiya","Mellawagedara","80A",1283,608,675
"1209080","Gampaha","Divulapitiya","Diklanda","80D",721,348,373
"1209085","Gampaha","Divulapitiya","Katukenda","55A",1131,555,576
"1209090","Gampaha","Divulapitiya","Akarangaha","56B",1109,546,563
"1209095","Gampaha","Divulapitiya","Kehelella West","82C",1014,497,517
"1209100","Gampaha","Divulapitiya","Lihiniyagammana","82B",1059,558,501
"1209105","Gampaha","Divulapitiya","Akaragama East","58B",845,428,417
"1209110","Gampaha","Divulapitiya","Akaragama West","58",1742,850,892
"1209115","Gampaha","Divulapitiya","Akaragama North","58C",1267,603,664
"1209120","Gampaha","Divulapitiya","Pahala Madampella","59",1676,804,872
"1209125","Gampaha","Divulapitiya","Halpe","61B",2219,1043,1176
"1209130","Gampaha","Divulapitiya","Kaluwarippuwa East - Uthura","95A",1418,669,749
"1209135","Gampaha","Divulapitiya","Kongodamulla North","62B",872,408,464
"1209140","Gampaha","Divulapitiya","Kongodamulla West","62",1487,713,774
"1209145","Gampaha","Divulapitiya","Kongodamulla South","62C",1435,708,727
"1209150","Gampaha","Divulapitiya","Kongodamulla East","62A",1657,799,858
"1209155","Gampaha","Divulapitiya","Ihala Madampella North","58E",924,420,504
"1209160","Gampaha","Divulapitiya","Ihala Madampella West","58D",1008,488,520
"1209165","Gampaha","Divulapitiya","Ihala Madampella East","58A",982,493,489
"1209170","Gampaha","Divulapitiya","Ihalagama","58F",790,387,403
"1209175","Gampaha","Divulapitiya","Kehelella South","82A",1421,701,720
"1209180","Gampaha","Divulapitiya","Kehelella North","82",987,451,536
"1209185","Gampaha","Divulapitiya","Delwagura","81",810,403,407
"1209190","Gampaha","Divulapitiya","Wekada","80B",882,429,453
"1209195","Gampaha","Divulapitiya","Kalumada","80C",631,312,319
"1209200","Gampaha","Divulapitiya","Agalegedara","79C",1065,507,558
"1209205","Gampaha","Divulapitiya","Waradala","79A",1646,811,835
"1209210","Gampaha","Divulapitiya","Kotadeniyawa","54B",1855,898,957
"1209215","Gampaha","Divulapitiya","Erabadda","54",614,305,309
"1209220","Gampaha","Divulapitiya","Diyagampala","53C",1312,645,667
"1209225","Gampaha","Divulapitiya","Koradaminna","53E",877,445,432
"1209230","Gampaha","Divulapitiya","Dimbuldeniya","53B",971,461,510
"1209235","Gampaha","Divulapitiya","Paragoda North","53F",855,414,441
"1209240","Gampaha","Divulapitiya","Paragoda South","53A",785,381,404
"1209245","Gampaha","Divulapitiya","Moragalkanda","53D",362,170,192
"1209250","Gampaha","Divulapitiya","Nawana West","53",909,420,489
"1209255","Gampaha","Divulapitiya","Hettimulla","52B",1049,490,559
"1209260","Gampaha","Divulapitiya","Haloluwa","52",730,357,373
"1209265","Gampaha","Divulapitiya","Kelegedara","52A",827,408,419
"1209270","Gampaha","Divulapitiya","Heeralugedara","79B",1565,770,795
"1209275","Gampaha","Divulapitiya","Walpita","79",1369,638,731
"1209280","Gampaha","Divulapitiya","Welagana","80",966,453,513
"1209285","Gampaha","Divulapitiya","Thammita","84",1519,739,780
"1209290","Gampaha","Divulapitiya","Palliyapitiya West","83",955,468,487
"1209295","Gampaha","Divulapitiya","Induragara North","88A",1956,960,996
"1209300","Gampaha","Divulapitiya","Induragara South","88D",722,349,373
"1209305","Gampaha","Divulapitiya","Kadawala North","96A",1857,938,919
"1209310","Gampaha","Divulapitiya","Kadawala","96",884,427,457
"1209315","Gampaha","Divulapitiya","Kaluwarippuwa East - Dakuna","95",2328,1116,1212
"1209320","Gampaha","Divulapitiya","Miriswatta","95B",1345,660,685
"1209325","Gampaha","Divulapitiya","Dagonna North","91",1562,775,787
"1209330","Gampaha","Divulapitiya","Dagonna East","91C",1402,657,745
"1209335","Gampaha","Divulapitiya","Halgahawelawatta","90B",638,304,334
"1209340","Gampaha","Divulapitiya","Katuwellegama North","90A",1046,481,565
"1209345","Gampaha","Divulapitiya","Kadawala South","96B",963,458,505
"1209350","Gampaha","Divulapitiya","Batepola","88B",1663,774,889
"1209355","Gampaha","Divulapitiya","Doonagaha South","88C",1784,888,896
"1209360","Gampaha","Divulapitiya","Doonagaha","88",1031,505,526
"1209365","Gampaha","Divulapitiya","Palliyapitiya East","83A",1434,686,748
"1209370","Gampaha","Divulapitiya","Hunumulla","86",1842,865,977
"1209375","Gampaha","Divulapitiya","Hapugahagama","85B",787,369,418
"1209380","Gampaha","Divulapitiya","Barawavila","85",1135,533,602
"1209385","Gampaha","Divulapitiya","Kudagammana","51",1916,909,1007
"1209390","Gampaha","Divulapitiya","Pahala Madithiyawala","46",1145,545,600
"1209395","Gampaha","Divulapitiya","Kaluaggala","44A",827,401,426
"1209400","Gampaha","Divulapitiya","Kuleegedara","45",1003,478,525
"1209405","Gampaha","Divulapitiya","Nawana East","53G",573,266,307
"1209410","Gampaha","Divulapitiya","Nariyamulla","42A",557,264,293
"1209415","Gampaha","Divulapitiya","Halpe","42",2559,1252,1307
"1209420","Gampaha","Divulapitiya","Parana Halpe West","41",1060,499,561
"1209425","Gampaha","Divulapitiya","Parana Halpe East","41A",882,388,494
"1209430","Gampaha","Divulapitiya","Gurullagama","42B",830,400,430
"1209435","Gampaha","Divulapitiya","Kithulwala Ihala","43A",1165,561,604
"1209440","Gampaha","Divulapitiya","Kithulwala Pahala","43",1004,487,517
"1209445","Gampaha","Divulapitiya","Kithulwala North","43B",1010,468,542
"1209450","Gampaha","Divulapitiya","Kaluaggala Pahalagama","44B",621,272,349
"1209455","Gampaha","Divulapitiya","Wattemulla","44",1218,613,605
"1209460","Gampaha","Divulapitiya","Ihala Madithiyawala","46A",935,447,488
"1209465","Gampaha","Divulapitiya","Hangawatta","47",398,193,205
"1209470","Gampaha","Divulapitiya","Rassapana","48",488,241,247
"1209475","Gampaha","Divulapitiya","Balagalla West","50",911,426,485
"1209480","Gampaha","Divulapitiya","Parana Handiya","50B",378,184,194
"1209485","Gampaha","Divulapitiya","Pinnakele","85A",888,451,437
"1209490","Gampaha","Divulapitiya","Pinnakele South","85C",878,421,457
"1209495","Gampaha","Divulapitiya","Urapana","86B",1220,596,624
"1209500","Gampaha","Divulapitiya","Kelepitimulla","86A",2268,1065,1203
"1209505","Gampaha","Divulapitiya","Sayakkaramulla","86C",692,332,360
"1209510","Gampaha","Divulapitiya","Henpitagedara","87C",1205,574,631
"1209515","Gampaha","Divulapitiya","Aluthepola West","89",1715,833,882
"1209520","Gampaha","Divulapitiya","Thotillagahawatta","89A",1380,678,702
"1209525","Gampaha","Divulapitiya","Katuwellegama South","90",1447,707,740
"1209530","Gampaha","Divulapitiya","Palugahawela","91B",1389,678,711
"1209535","Gampaha","Divulapitiya","Dagonna South","91A",2542,1243,1299
"1209540","Gampaha","Divulapitiya","Hapuwalana South","87B",756,365,391
"1209545","Gampaha","Divulapitiya","Hapuwalana","87",788,375,413
"1209550","Gampaha","Divulapitiya","Bomugammana North","97A",1712,842,870
"1209555","Gampaha","Divulapitiya","Bomugammana South","97B",1048,515,533
"1209560","Gampaha","Divulapitiya","Pinnalanda","97D",824,390,434
"1209565","Gampaha","Divulapitiya","Divulapitiya","97",2028,1008,1020
"1209570","Gampaha","Divulapitiya","Balagalla East","50A",907,456,451
"1209575","Gampaha","Divulapitiya","Ullalapola East","49",1145,583,562
"1209580","Gampaha","Divulapitiya","Ullalapola West","49A",1166,568,598
"1209585","Gampaha","Divulapitiya","Wewagedara","97C",798,376,422
"1209590","Gampaha","Divulapitiya","Horagasmulla","97E",1531,744,787
"1209595","Gampaha","Divulapitiya","Assennawatta East","104",3105,1464,1641
"1209600","Gampaha","Divulapitiya","Hapuwalana North","87A",780,389,391
"1209605","Gampaha","Divulapitiya","Assennawatta West","104A",1013,479,534
"1209610","Gampaha","Divulapitiya","Weragodamulla","104B",2168,1063,1105
"1209615","Gampaha","Divulapitiya","Aluthepola East","89B",1316,630,686
"1212005","Gampaha","Mirigama","Nalla","3A",3206,1528,1678
"1212010","Gampaha","Mirigama","Giriullagama","1A",1683,815,868
"1212015","Gampaha","Mirigama","Loluwagoda","1",1982,927,1055
"1212020","Gampaha","Mirigama","Delwala South","3B",773,378,395
"1212025","Gampaha","Mirigama","Delwala","3",855,407,448
"1212030","Gampaha","Mirigama","Loluwagoda South","1B",969,463,506
"1212035","Gampaha","Mirigama","Madurupitiya","11",898,435,463
"1212040","Gampaha","Mirigama","Hapugahagedara","11A",866,412,454
"1212045","Gampaha","Mirigama","Kandangamuwa","2",1336,640,696
"1212050","Gampaha","Mirigama","Henegama","5",920,435,485
"1212055","Gampaha","Mirigama","Maladeniya","4A",1255,615,640
"1212060","Gampaha","Mirigama","Kahandawa","4",1506,732,774
"1212065","Gampaha","Mirigama","Kandalama","6",1299,639,660
"1212070","Gampaha","Mirigama","Walbothale","10",1863,931,932
"1212075","Gampaha","Mirigama","Pirisyala","12A",1045,555,490
"1212080","Gampaha","Mirigama","Kamarangawa","12B",703,337,366
"1212085","Gampaha","Mirigama","Keenadeniya","12",1296,621,675
"1212090","Gampaha","Mirigama","Bothale Pahalagama North","14E",1281,652,629
"1212095","Gampaha","Mirigama","Maveehena","9A",895,429,466
"1212100","Gampaha","Mirigama","Kurunduwatta","9B",1240,616,624
"1212105","Gampaha","Mirigama","Purana Meerigama","9",1221,579,642
"1212110","Gampaha","Mirigama","Hakurukumbura","7",2311,1130,1181
"1212115","Gampaha","Mirigama","Mugurugampala","8",1680,831,849
"1212120","Gampaha","Mirigama","Vilwatta","15",1354,663,691
"1212125","Gampaha","Mirigama","Thawalampitiya","15E",1071,446,625
"1212130","Gampaha","Mirigama","Bothale Pahalagama","14",1028,488,540
"1212135","Gampaha","Mirigama","Bothale Pahalagama West","14D",973,467,506
"1212140","Gampaha","Mirigama","Bothale Medagama","14C",855,391,464
"1212145","Gampaha","Mirigama","Bothale Pahalagama East","14F",1726,822,904
"1212150","Gampaha","Mirigama","Thalagama East","13B",499,227,272
"1212155","Gampaha","Mirigama","Thalagama","13A",740,360,380
"1212160","Gampaha","Mirigama","Balathawa","13C",861,430,431
"1212165","Gampaha","Mirigama","Makoora","13",482,240,242
"1212170","Gampaha","Mirigama","Pottekanda","14B",713,361,352
"1212175","Gampaha","Mirigama","Bothale Ihalagama","14A",1021,499,522
"1212180","Gampaha","Mirigama","Andagalakanda","14G",606,293,313
"1212185","Gampaha","Mirigama","Halugama Ihala","16F",866,436,430
"1212190","Gampaha","Mirigama","Kindiwala","16B",617,305,312
"1212195","Gampaha","Mirigama","Halugama Pahala","16E",495,251,244
"1212200","Gampaha","Mirigama","Meerigama","15B",620,360,260
"1212205","Gampaha","Mirigama","Walawwatta","15D",1202,580,622
"1212210","Gampaha","Mirigama","Thilinagama","40C",1196,566,630
"1212215","Gampaha","Mirigama","Vijayarajadahana","40B",834,387,447
"1212220","Gampaha","Mirigama","Neligama Ihala","15C",524,255,269
"1212225","Gampaha","Mirigama","Neligama Central","15F",1081,413,668
"1212230","Gampaha","Mirigama","Neligama","15A",1002,481,521
"1212235","Gampaha","Mirigama","Lindara","16",993,474,519
"1212240","Gampaha","Mirigama","Halugama","16A",1545,763,782
"1212245","Gampaha","Mirigama","Siyambalagoda","21C",764,376,388
"1212250","Gampaha","Mirigama","Lindara Pahala","16D",581,281,300
"1212255","Gampaha","Mirigama","Pohonnaruwa","17",1202,597,605
"1212260","Gampaha","Mirigama","Indiparape","40A",1007,480,527
"1212265","Gampaha","Mirigama","Kosetadeniya","39",630,297,333
"1212270","Gampaha","Mirigama","Imbulanwala","38",834,389,445
"1212275","Gampaha","Mirigama","Uduulla","37",476,220,256
"1212280","Gampaha","Mirigama","Gaspe","36",1419,676,743
"1212285","Gampaha","Mirigama","Banduragoda","35",910,454,456
"1212290","Gampaha","Mirigama","Keppitiwalana","34A",1284,615,669
"1212295","Gampaha","Mirigama","Gaspe Pahalagama","36A",786,387,399
"1212300","Gampaha","Mirigama","Galgana","32A",396,184,212
"1212305","Gampaha","Mirigama","Pelapitigama","31B",1179,585,594
"1212310","Gampaha","Mirigama","Elhena","31C",1741,868,873
"1212315","Gampaha","Mirigama","Ganegoda","40",1021,498,523
"1212320","Gampaha","Mirigama","Hiriwala","40D",1646,758,888
"1212325","Gampaha","Mirigama","Handurumulla","18A",799,379,420
"1212330","Gampaha","Mirigama","Pamunuwatta","19A",1361,687,674
"1212335","Gampaha","Mirigama","Lindara Ihala","16C",499,237,262
"1212340","Gampaha","Mirigama","Arukgoda","21A",522,274,248
"1212345","Gampaha","Mirigama","Madabavita","21",1243,556,687
"1212350","Gampaha","Mirigama","Madabavita Ihalagama","21B",967,468,499
"1212355","Gampaha","Mirigama","Newgala","22A",1023,495,528
"1212360","Gampaha","Mirigama","Danovita","22",1420,718,702
"1212365","Gampaha","Mirigama","Weweldeniya Pahalagama","20A",917,428,489
"1212370","Gampaha","Mirigama","Weweldeniya Pahalagama West","20B",1314,633,681
"1212375","Gampaha","Mirigama","Henepola","19",468,233,235
"1212380","Gampaha","Mirigama","Palmada","18",675,348,327
"1212385","Gampaha","Mirigama","Kal/ Pallewela","26",1079,499,580
"1212390","Gampaha","Mirigama","Raddalgoda","28B",907,439,468
"1212395","Gampaha","Mirigama","Ihala Bokalagama","31A",1033,523,510
"1212400","Gampaha","Mirigama","Pahala Bokalagama","31",2135,1008,1127
"1212405","Gampaha","Mirigama","Kukulnape","32",684,327,357
"1212410","Gampaha","Mirigama","Gaspe South","36B",847,407,440
"1212415","Gampaha","Mirigama","Muddaragama","34",926,446,480
"1212420","Gampaha","Mirigama","Hanchapola","33",944,460,484
"1212425","Gampaha","Mirigama","Hirikuluwa","33A",640,317,323
"1212430","Gampaha","Mirigama","Pathagama","34B",669,330,339
"1212435","Gampaha","Mirigama","Borukgamuwa West","336B",924,439,485
"1212440","Gampaha","Mirigama","Borukgamuwa","336",1131,568,563
"1212445","Gampaha","Mirigama","Pallewela","29A",837,406,431
"1212450","Gampaha","Mirigama","Weragoda/ Kakkele","30A",1149,535,614
"1212455","Gampaha","Mirigama","Hansagiriya","28F",1939,913,1026
"1212460","Gampaha","Mirigama","Wellevilamulla North","28D",919,433,486
"1212465","Gampaha","Mirigama","Wellevilamulla","28A",1771,457,1314
"1212470","Gampaha","Mirigama","Udawela","27",1277,591,686
"1212475","Gampaha","Mirigama","Hapitigama","25",1016,482,534
"1212480","Gampaha","Mirigama","Makkanigoda North","25C",1584,751,833
"1212485","Gampaha","Mirigama","Pahalawela","19B",533,239,294
"1212490","Gampaha","Mirigama","Millawala","20D",1197,578,619
"1212495","Gampaha","Mirigama","Weweldeniya Ihalagama West","20C",782,386,396
"1212500","Gampaha","Mirigama","Weweldeniya Ihalagama","20",880,444,436
"1212505","Gampaha","Mirigama","Kotadeniya","23",1034,492,542
"1212510","Gampaha","Mirigama","Ilukpatha/ Weragoda","23A",1093,513,580
"1212515","Gampaha","Mirigama","Hedidenikanda","358A",761,368,393
"1212520","Gampaha","Mirigama","Radawadunna","360",1437,684,753
"1212525","Gampaha","Mirigama","Bataleeya","25A",1239,578,661
"1212530","Gampaha","Mirigama","Bataleeya South","25B",1027,537,490
"1212535","Gampaha","Mirigama","Bolana","28C",768,388,380
"1212540","Gampaha","Mirigama","Mallehewa","28",941,450,491
"1212545","Gampaha","Mirigama","Webadamulla","28E",1731,844,887
"1212550","Gampaha","Mirigama","Weragoda","30",833,429,404
"1212555","Gampaha","Mirigama","Midellawala","29",537,249,288
"1212560","Gampaha","Mirigama","Kendalanda","336A",1054,485,569
"1212565","Gampaha","Mirigama","Nungamuwa","336C",1291,607,684
"1212570","Gampaha","Mirigama","Uthuwanbogahawatta","335",1333,643,690
"1212575","Gampaha","Mirigama","Maligathenna Pahala","337B",1564,757,807
"1212580","Gampaha","Mirigama","Maligathenna Central","337C",1738,841,897
"1212585","Gampaha","Mirigama","Wandurawa","337",1737,826,911
"1212590","Gampaha","Mirigama","Galgamuwa West","338A",1461,702,759
"1212595","Gampaha","Mirigama","Galgamuwa East","338",974,475,499
"1212600","Gampaha","Mirigama","Kumbaloluwa","340",537,264,273
"1212605","Gampaha","Mirigama","Kumbaloluwa Ihala","340B",1113,538,575
"1212610","Gampaha","Mirigama","Kumbaloluwa Pahala","340A",1114,528,586
"1212615","Gampaha","Mirigama","Dumunnegedara South","341A",722,339,383
"1212620","Gampaha","Mirigama","Dumunnegedara","341",709,364,345
"1212625","Gampaha","Mirigama","Pasyala","342",1189,559,630
"1212630","Gampaha","Mirigama","Pasyala West","342B",794,366,428
"1212635","Gampaha","Mirigama","Muruthawala","24",680,323,357
"1212640","Gampaha","Mirigama","Kithanawatta","356A",2183,1076,1107
"1212645","Gampaha","Mirigama","Kammalpitiya","360B",1275,612,663
"1212650","Gampaha","Mirigama","Radawadunna Central","360C",891,434,457
"1212655","Gampaha","Mirigama","Imbulgasovita","360D",921,450,471
"1212660","Gampaha","Mirigama","Radawadunna Pahala","360A",726,351,375
"1212665","Gampaha","Mirigama","Weerasooriyakanda","358",1429,713,716
"1212670","Gampaha","Mirigama","Pasyala East","342A",836,412,424
"1212675","Gampaha","Mirigama","Udugama","334A",1353,635,718
"1212680","Gampaha","Mirigama","Panawala","344",828,384,444
"1212685","Gampaha","Mirigama","Delgahamedilla","340C",1314,639,675
"1212690","Gampaha","Mirigama","Mottunna West","339A",925,445,480
"1212695","Gampaha","Mirigama","Mottunna","339",764,350,414
"1212700","Gampaha","Mirigama","Maligathenna","337A",2302,1153,1149
"1212705","Gampaha","Mirigama","Kureekotuwa","334",2701,1346,1355
"1212710","Gampaha","Mirigama","Hakwadunna","344A",943,480,463
"1212715","Gampaha","Mirigama","Kureekotuwa Pahala","334B",941,450,491
"1212720","Gampaha","Mirigama","Ellalamulla","356",2314,1195,1119
"1212725","Gampaha","Mirigama","Debahera","357A",1128,564,564
"1212730","Gampaha","Mirigama","Mawathahena","357C",1143,565,578
"1212735","Gampaha","Mirigama","Meevitiya","357",1722,818,904
"1212740","Gampaha","Mirigama","Ketakalapitiya","357B",697,342,355
"1212745","Gampaha","Mirigama","Dambutuwa","359",959,458,501
"1215005","Gampaha","Minuwangoda","Medemulla North","112/3",1398,643,755
"1215010","Gampaha","Minuwangoda","Nilpanagoda West","112/4",1638,775,863
"1215015","Gampaha","Minuwangoda","Nilpanagoda East","112/2",1269,599,670
"1215020","Gampaha","Minuwangoda","Nilpanagoda","112/1",2648,1237,1411
"1215025","Gampaha","Minuwangoda","Arangawa","105/3",1739,850,889
"1215030","Gampaha","Minuwangoda","Horampella North","105/1",1798,872,926
"1215035","Gampaha","Minuwangoda","Galkanda","105/4",913,435,478
"1215040","Gampaha","Minuwangoda","Bodhipihituwala","105/5",1881,940,941
"1215045","Gampaha","Minuwangoda","Watinapaha","103",1177,550,627
"1215050","Gampaha","Minuwangoda","Mabodala West","98/3",1751,850,901
"1215055","Gampaha","Minuwangoda","Mabodala North","98/1",1192,574,618
"1215060","Gampaha","Minuwangoda","Ihala Vithanamulla","98/4",1033,465,568
"1215065","Gampaha","Minuwangoda","Nalapaha","99/3",779,384,395
"1215070","Gampaha","Minuwangoda","Pahala Vithanamulla","98/5",661,303,358
"1215075","Gampaha","Minuwangoda","Mabodala East","98",1096,526,570
"1215080","Gampaha","Minuwangoda","Mabodala South","98/2",793,377,416
"1215085","Gampaha","Minuwangoda","Watinapaha South","103/1",1221,604,617
"1215090","Gampaha","Minuwangoda","Wankepumulla","103/2",506,252,254
"1215095","Gampaha","Minuwangoda","Kamaragoda","103/3",1208,590,618
"1215100","Gampaha","Minuwangoda","Kudagoda","105/6",1079,498,581
"1215105","Gampaha","Minuwangoda","Horampella South","105",1080,526,554
"1215110","Gampaha","Minuwangoda","Mahagama","105/2",1769,869,900
"1215115","Gampaha","Minuwangoda","Wegowwa South","113",1589,789,800
"1215120","Gampaha","Minuwangoda","Minuwangoda East","125/3",2072,1034,1038
"1215125","Gampaha","Minuwangoda","Minuwangoda North","125/2",1154,551,603
"1215130","Gampaha","Minuwangoda","Medemulla South","112",3043,1424,1619
"1215135","Gampaha","Minuwangoda","Boragodawatta North","124",1928,923,1005
"1215140","Gampaha","Minuwangoda","Yatiyana","123",2177,1067,1110
"1215145","Gampaha","Minuwangoda","Peellawatta","123/1",1718,831,887
"1215150","Gampaha","Minuwangoda","Unnaruwa","122",1517,739,778
"1215155","Gampaha","Minuwangoda","Yatiyana Central","123/4",1530,717,813
"1215160","Gampaha","Minuwangoda","Yatiyana East","123/3",2004,963,1041
"1215165","Gampaha","Minuwangoda","Kopiwatta","123/2",1527,713,814
"1215170","Gampaha","Minuwangoda","Boragodawatta South","124/1",1923,930,993
"1215175","Gampaha","Minuwangoda","Minuwangoda West","125/1",1200,595,605
"1215180","Gampaha","Minuwangoda","Meda Minuwangoda","125",997,500,497
"1215185","Gampaha","Minuwangoda","Pansilgoda","126/1",1154,571,583
"1215190","Gampaha","Minuwangoda","Wegowwa East","113/1",854,404,450
"1215195","Gampaha","Minuwangoda","Helakandana","115",1786,850,936
"1215200","Gampaha","Minuwangoda","Peralanda","107/1",1029,504,525
"1215205","Gampaha","Minuwangoda","Dewalapola","106",1729,774,955
"1215210","Gampaha","Minuwangoda","Wadumulla","101",1419,670,749
"1215215","Gampaha","Minuwangoda","Metikotumulla","102/1",1206,567,639
"1215220","Gampaha","Minuwangoda","Essella","102",717,357,360
"1215225","Gampaha","Minuwangoda","Yatagama","99/4",768,355,413
"1215230","Gampaha","Minuwangoda","Naiwala North","99",1598,804,794
"1215235","Gampaha","Minuwangoda","Naiwala East","99/2",1311,666,645
"1215240","Gampaha","Minuwangoda","Naiwala West","99/1",1496,756,740
"1215245","Gampaha","Minuwangoda","Walpitamulla","100",2564,1193,1371
"1215250","Gampaha","Minuwangoda","Balabowa","127",1760,876,884
"1215255","Gampaha","Minuwangoda","Balabowa West","127/1",1983,939,1044
"1215260","Gampaha","Minuwangoda","Pethiyagoda North","108",989,491,498
"1215265","Gampaha","Minuwangoda","Gallegedara","109",1004,488,516
"1215270","Gampaha","Minuwangoda","Ganihimulla","107",1322,609,713
"1215275","Gampaha","Minuwangoda","Hendimahara","141",1298,622,676
"1215280","Gampaha","Minuwangoda","Kalawana","114",1422,685,737
"1215285","Gampaha","Minuwangoda","Wattegedara","126",1023,483,540
"1215290","Gampaha","Minuwangoda","Ambagahawatta","126/3",1136,567,569
"1215295","Gampaha","Minuwangoda","Galloluwa East","121/1",2779,1303,1476
"1215300","Gampaha","Minuwangoda","Galloluwa","121",3362,1674,1688
"1215305","Gampaha","Minuwangoda","Kalahugoda","122/1",1451,685,766
"1215310","Gampaha","Minuwangoda","Polwatta West","120/1",1095,539,556
"1215315","Gampaha","Minuwangoda","Polwatta East","120",1272,620,652
"1215320","Gampaha","Minuwangoda","Pattanduwana North","118/2",1145,545,600
"1215325","Gampaha","Minuwangoda","Ellangala","117/2",722,351,371
"1215330","Gampaha","Minuwangoda","Burullapitiya","126/2",958,449,509
"1215335","Gampaha","Minuwangoda","Mathammana","116",1726,840,886
"1215340","Gampaha","Minuwangoda","Weediyawatta East","130",1370,630,740
"1215345","Gampaha","Minuwangoda","Goigama","131/5",984,485,499
"1215350","Gampaha","Minuwangoda","Ihala Udugampala","131/4",1571,747,824
"1215355","Gampaha","Minuwangoda","Pethiyagoda South","108/1",1187,580,607
"1215360","Gampaha","Minuwangoda","Korase","111",1132,556,576
"1215365","Gampaha","Minuwangoda","Korase Meda","111/1",1722,858,864
"1215370","Gampaha","Minuwangoda","Marapola","129",2433,1142,1291
"1215375","Gampaha","Minuwangoda","Vigoda","128",1864,902,962
"1215380","Gampaha","Minuwangoda","Doranagoda East","110/1",1263,605,658
"1215385","Gampaha","Minuwangoda","Korase East","111/2",957,433,524
"1215390","Gampaha","Minuwangoda","Doranagoda North","110",982,477,505
"1215395","Gampaha","Minuwangoda","Doranagoda West","110/2",1122,550,572
"1215400","Gampaha","Minuwangoda","Pahala Udugampola East","131/1",1885,923,962
"1215405","Gampaha","Minuwangoda","Pahala Udugampola North","131",1669,777,892
"1215410","Gampaha","Minuwangoda","Pahala Udugampola West","131/3",1466,692,774
"1215415","Gampaha","Minuwangoda","Weediyawatta West","130/1",2279,1100,1179
"1215420","Gampaha","Minuwangoda","Welhena","117",1442,703,739
"1215425","Gampaha","Minuwangoda","Weliya","117/1",1327,637,690
"1215430","Gampaha","Minuwangoda","Pattanduwana","118",1213,589,624
"1215435","Gampaha","Minuwangoda","Pattanduwana West","118/1",1576,745,831
"1215440","Gampaha","Minuwangoda","Yagodamulla North","119/3",2077,1007,1070
"1215445","Gampaha","Minuwangoda","Yagodamulla","119/2",1201,569,632
"1215450","Gampaha","Minuwangoda","Uggalboda West","140/3",1701,857,844
"1215455","Gampaha","Minuwangoda","Uggalboda","140/2",1553,739,814
"1215460","Gampaha","Minuwangoda","Kehelbaddara West","140/1",1613,786,827
"1215465","Gampaha","Minuwangoda","Kehelbaddara East","140",1429,673,756
"1215470","Gampaha","Minuwangoda","Pahala Udugampola South","131/2",1283,610,673
"1215475","Gampaha","Minuwangoda","Asgiriwalpola North","135",1389,679,710
"1215480","Gampaha","Minuwangoda","Dombawala","132",1620,750,870
"1215485","Gampaha","Minuwangoda","Pedipola","133/1",1273,600,673
"1215490","Gampaha","Minuwangoda","Doranagoda South","110/3",1907,918,989
"1215495","Gampaha","Minuwangoda","Wathumulla","133",2282,1110,1172
"1215500","Gampaha","Minuwangoda","Asgiriya North","134/1",2022,919,1103
"1215505","Gampaha","Minuwangoda","Asgiriya South","134/2",1876,902,974
"1215510","Gampaha","Minuwangoda","Asgiriya","134",1320,651,669
"1215515","Gampaha","Minuwangoda","Asgiriya West","134/3",1333,628,705
"1215520","Gampaha","Minuwangoda","Asgiriwalpola South","135/1",2022,975,1047
"1215525","Gampaha","Minuwangoda","Asgiriwalpola West","135/2",1753,831,922
"1215530","Gampaha","Minuwangoda","Madelgamuwa East","137",1131,535,596
"1215535","Gampaha","Minuwangoda","Batapotha","137/2",1987,961,1026
"1215540","Gampaha","Minuwangoda","Nedagamuwa North","139/1",1737,827,910
"1215545","Gampaha","Minuwangoda","Nedagamuwa South","139",980,485,495
"1215550","Gampaha","Minuwangoda","Nedagamuwa West","139/2",1704,789,915
"1215555","Gampaha","Minuwangoda","Arachchiwatta","139/3",871,409,462
"1215560","Gampaha","Minuwangoda","Yagodamulla South","119/4",1014,494,520
"1215565","Gampaha","Minuwangoda","Samurdhigama","119/6",1270,641,629
"1215570","Gampaha","Minuwangoda","Opatha","119/5",2109,1189,920
"1215575","Gampaha","Minuwangoda","Kotugoda 2","119/1",1235,640,595
"1215580","Gampaha","Minuwangoda","Kotugoda 1","119",968,460,508
"1215585","Gampaha","Minuwangoda","Maduruvita","138/1",1640,810,830
"1215590","Gampaha","Minuwangoda","Siyambalapitiya","138",1709,829,880
"1215595","Gampaha","Minuwangoda","Madelgamuwa West","137/1",1313,642,671
"1215600","Gampaha","Minuwangoda","Thammita West","136/1",1014,491,523
"1215605","Gampaha","Minuwangoda","Thammita","136",1465,690,775
"1218005","Gampaha","Wattala","Pamunugama","164",2454,1136,1318
"1218010","Gampaha","Wattala","Maha Pamunugama","164A",1774,850,924
"1218015","Gampaha","Wattala","Delathura West","193",2366,1117,1249
"1218020","Gampaha","Wattala","Delathura East","193A",1332,655,677
"1218025","Gampaha","Wattala","Bopitiyathuduwa","165A",2287,1108,1179
"1218030","Gampaha","Wattala","Bopitiya","165",2137,1007,1130
"1218035","Gampaha","Wattala","Pulluhena","165B",2052,943,1109
"1218040","Gampaha","Wattala","Paranambalama","167A",3164,1554,1610
"1218045","Gampaha","Wattala","Nugape","166",1361,635,726
"1218050","Gampaha","Wattala","Kunjawatta","166A",3068,1528,1540
"1218055","Gampaha","Wattala","Mangulpokuna","182A",4224,1962,2262
"1218060","Gampaha","Wattala","Elehiwatta","182B",4245,2013,2232
"1218065","Gampaha","Wattala","Welisara","182",4671,2188,2483
"1218070","Gampaha","Wattala","Pattiyawala","167B",4906,2402,2504
"1218075","Gampaha","Wattala","Uswetakeiyawa","167",4397,2161,2236
"1218080","Gampaha","Wattala","Mahabage","178",4304,2053,2251
"1218085","Gampaha","Wattala","Elapitiwala","179",4261,2027,2234
"1218090","Gampaha","Wattala","Horapethuduwa","180A",1828,874,954
"1218095","Gampaha","Wattala","Horape","180",2114,1019,1095
"1218100","Gampaha","Wattala","Kurukulawa North","250",2501,1179,1322
"1218105","Gampaha","Wattala","Kurukulawa South","250A",2230,1078,1152
"1218110","Gampaha","Wattala","Heenkenda","254",3199,1533,1666
"1218115","Gampaha","Wattala","Thuduwegedara","254A",2281,1135,1146
"1218120","Gampaha","Wattala","Galudupita","177B",4771,2359,2412
"1218125","Gampaha","Wattala","Mattumagala","177",4837,2347,2490
"1218130","Gampaha","Wattala","Kerangapokuna","177A",3226,1536,1690
"1218135","Gampaha","Wattala","Kerawalapitiya","171",11686,5627,6059
"1218140","Gampaha","Wattala","Matagoda","171A",7607,3496,4111
"1218145","Gampaha","Wattala","Balagala","171B",9062,4424,4638
"1218150","Gampaha","Wattala","Dikovita","168B",1623,805,818
"1218155","Gampaha","Wattala","Palliyawatta North","168A",4787,2317,2470
"1218160","Gampaha","Wattala","Elakanda","170A",2788,1366,1422
"1218165","Gampaha","Wattala","Nayakakanda North","172B",2631,1193,1438
"1218170","Gampaha","Wattala","Mabola","176A",3381,1685,1696
"1218175","Gampaha","Wattala","Welikadamulla","176C",8447,4122,4325
"1218180","Gampaha","Wattala","Wattala","176",3234,1532,1702
"1218185","Gampaha","Wattala","Hendala North","172A",4053,2007,2046
"1218190","Gampaha","Wattala","Hendala South","172",4067,1975,2092
"1218195","Gampaha","Wattala","Nayakakanda South","172C",2624,1155,1469
"1218200","Gampaha","Wattala","Thimbirigasyaya","170",4922,2213,2709
"1218205","Gampaha","Wattala","Palliyawatta South","168",3126,1506,1620
"1218210","Gampaha","Wattala","Kurunduhena","169A",3464,1673,1791
"1218215","Gampaha","Wattala","Evariwatta","175 A",4527,2178,2349
"1218220","Gampaha","Wattala","Telangapatha","175",5016,2415,2601
"1218225","Gampaha","Wattala","Galwetiya","176B",3426,1759,1667
"1218230","Gampaha","Wattala","Hekitta","169",5064,2579,2485
"1221005","Gampaha","Ja-Ela","Mahawatta","205B",9394,4505,4889
"1221010","Gampaha","Ja-Ela","Dandugama","194",3236,1587,1649
"1221015","Gampaha","Ja-Ela","Dehiyagatha North","194B",2041,970,1071
"1221020","Gampaha","Ja-Ela","Kudahakapola North","196",1819,863,956
"1221025","Gampaha","Ja-Ela","Gallawatta","205A",5687,2963,2724
"1221030","Gampaha","Ja-Ela","Ekala","206",3822,1987,1835
"1221035","Gampaha","Ja-Ela","Dehiyagatha South","194A",1114,544,570
"1221040","Gampaha","Ja-Ela","Kudahakapola South","195",1612,820,792
"1221045","Gampaha","Ja-Ela","Ekala Kurunduwatta","205",2909,1449,1460
"1221050","Gampaha","Ja-Ela","Vishakawatta","206B",5136,2660,2476
"1221055","Gampaha","Ja-Ela","Thudella North","192B",2425,1156,1269
"1221060","Gampaha","Ja-Ela","Thudella West","192",3150,1500,1650
"1221065","Gampaha","Ja-Ela","Thudella South","192A",1800,872,928
"1221070","Gampaha","Ja-Ela","Kanuwana","191",2919,1387,1532
"1221075","Gampaha","Ja-Ela","Alexendrawatta","206A",5926,3185,2741
"1221080","Gampaha","Ja-Ela","Bandigoda","211B",3352,1647,1705
"1221085","Gampaha","Ja-Ela","Yakkaduwa","207A",3991,1941,2050
"1221090","Gampaha","Ja-Ela","Nivandama North","207",3458,1661,1797
"1221095","Gampaha","Ja-Ela","Nivandama South","207B",2769,1376,1393
"1221100","Gampaha","Ja-Ela","Batagama North","211",3972,1920,2052
"1221105","Gampaha","Ja-Ela","Maeliya","190B",3654,1723,1931
"1221110","Gampaha","Ja-Ela","Ja-ela","191A",2167,1016,1151
"1221115","Gampaha","Ja-Ela","Weligampitiya North","190A",2843,1334,1509
"1221120","Gampaha","Ja-Ela","Indivitiya","190E",2797,1328,1469
"1221125","Gampaha","Ja-Ela","Wewala","189",3618,1690,1928
"1221130","Gampaha","Ja-Ela","Weligampitiya South","190",3989,1997,1992
"1221135","Gampaha","Ja-Ela","Thumpeliya","190D",2608,1231,1377
"1221140","Gampaha","Ja-Ela","Indiminna","211A",2754,1300,1454
"1221145","Gampaha","Ja-Ela","Dolahena","185D",2453,1195,1258
"1221150","Gampaha","Ja-Ela","Hapugoda West","185A",1648,767,881
"1221155","Gampaha","Ja-Ela","Kapuwatta","190C",5646,2658,2988
"1221160","Gampaha","Ja-Ela","Kalaeliya","188",2303,1078,1225
"1221165","Gampaha","Ja-Ela","Nedurupitiya","187",2568,1196,1372
"1221170","Gampaha","Ja-Ela","Rilavulla","186",3096,1405,1691
"1221175","Gampaha","Ja-Ela","Kandana East","184C",1166,588,578
"1221180","Gampaha","Ja-Ela","Kandana West","184",1751,826,925
"1221185","Gampaha","Ja-Ela","Uswatta","184B",3609,1686,1923
"1221190","Gampaha","Ja-Ela","Hapugoda Central","185C",2017,958,1059
"1221195","Gampaha","Ja-Ela","Batagama South","185",3124,1507,1617
"1221200","Gampaha","Ja-Ela","Polpitimookalana","212A",4750,2289,2461
"1221205","Gampaha","Ja-Ela","Batuwatta West","213",3739,1831,1908
"1221210","Gampaha","Ja-Ela","Batuwatta East","213A",3553,1688,1865
"1221215","Gampaha","Ja-Ela","Walpola East","212B",4459,2117,2342
"1221220","Gampaha","Ja-Ela","Jayasrigama","181A",3986,1893,2093
"1221225","Gampaha","Ja-Ela","Hapugoda East","185B",2538,1215,1323
"1221230","Gampaha","Ja-Ela","Nagoda","183",3921,1824,2097
"1221235","Gampaha","Ja-Ela","Jayasamarugama","184A",6748,3167,3581
"1221240","Gampaha","Ja-Ela","Peralanda","181D",5799,2749,3050
"1221245","Gampaha","Ja-Ela","Podiveekumbura","181E",5879,2878,3001
"1221250","Gampaha","Ja-Ela","Walpola West","212",4332,2125,2207
"1221255","Gampaha","Ja-Ela","Narangodapaluwa West","214",3728,1770,1958
"1221260","Gampaha","Ja-Ela","Narangodapaluwa East","214A",4512,2202,2310
"1221265","Gampaha","Ja-Ela","Thewatta","181B",3814,1826,1988
"1221270","Gampaha","Ja-Ela","Ragama","181",3985,1893,2092
"1221275","Gampaha","Ja-Ela","Ketagewatta","181F",3975,2006,1969
"1221280","Gampaha","Ja-Ela","Dambuwa","181G",4191,2032,2159
"1221285","Gampaha","Ja-Ela","Rampitiya","181C",3269,1593,1676
"1224005","Gampaha","Gampaha","Makevita North","218",1862,927,935
"1224010","Gampaha","Gampaha","Makevita South","218A",1559,739,820
"1224015","Gampaha","Gampaha","Mabima","217",1663,824,839
"1224020","Gampaha","Gampaha","Gonagaha II","219A",1542,748,794
"1224025","Gampaha","Gampaha","Welikada","217A",1134,537,597
"1224030","Gampaha","Gampaha","Gonagaha I","219",828,412,416
"1224035","Gampaha","Gampaha","Ambanvita","220A",692,340,352
"1224040","Gampaha","Gampaha","Kirindivita","220",973,473,500
"1224045","Gampaha","Gampaha","Akaravita","222B",1684,798,886
"1224050","Gampaha","Gampaha","Pahalagama","222",1498,725,773
"1224055","Gampaha","Gampaha","Medagama II","223A",2086,998,1088
"1224060","Gampaha","Gampaha","Ihalagama West","224",2004,979,1025
"1224065","Gampaha","Gampaha","Ihalagama East","224A",2049,962,1087
"1224070","Gampaha","Gampaha","Gampaha Aluthgama North","225A",2048,1004,1044
"1224075","Gampaha","Gampaha","Karanekamulla","226A",792,400,392
"1224080","Gampaha","Gampaha","Baduwathugoda","226",1178,562,616
"1224085","Gampaha","Gampaha","Boraliyawatha","228",1062,502,560
"1224090","Gampaha","Gampaha","Thittalapitigoda","228A",1187,572,615
"1224095","Gampaha","Gampaha","Aluthgama Bogamuwa North","229",3919,1872,2047
"1224100","Gampaha","Gampaha","Aluthgama Bogamuwa South","229A",1938,903,1035
"1224105","Gampaha","Gampaha","Mahipalagoda","230",1596,764,832
"1224110","Gampaha","Gampaha","Morenna","230A",1323,665,658
"1224115","Gampaha","Gampaha","Weediyawatta","230B",1401,657,744
"1224120","Gampaha","Gampaha","Keselwathugoda North","227",2903,1402,1501
"1224125","Gampaha","Gampaha","Indigolla","225C",1675,791,884
"1224130","Gampaha","Gampaha","Gampaha Aluthgama West","225",2354,1115,1239
"1224135","Gampaha","Gampaha","Bendiyamulla North","234",1373,611,762
"1224140","Gampaha","Gampaha","Medagama IV","223C",1813,818,995
"1224145","Gampaha","Gampaha","Medagama III","223B",1178,539,639
"1224150","Gampaha","Gampaha","Medagama I","223",311,174,137
"1224155","Gampaha","Gampaha","Oruthota South","235A",1636,768,868
"1224160","Gampaha","Gampaha","Kosovita","222A",1328,640,688
"1224165","Gampaha","Gampaha","Rathmalavita","221A",793,383,410
"1224170","Gampaha","Gampaha","Makilangamuwa","221",1204,602,602
"1224175","Gampaha","Gampaha","Horagolla North","216",2551,1237,1314
"1224180","Gampaha","Gampaha","Thibbotugoda","216B",2515,1186,1329
"1224185","Gampaha","Gampaha","Midellavita","208",591,283,308
"1224190","Gampaha","Gampaha","Kudabollatha","209A",1619,770,849
"1224195","Gampaha","Gampaha","Bollatha North","209",3083,1540,1543
"1224200","Gampaha","Gampaha","Wewel Agara","209D",571,271,300
"1224205","Gampaha","Gampaha","Bollatha West","209C",1243,569,674
"1224210","Gampaha","Gampaha","Bollatha South","209B",2983,1431,1552
"1224215","Gampaha","Gampaha","Bulugahagoda West","210A",1398,671,727
"1224220","Gampaha","Gampaha","Bulugahagoda East","210",1029,488,541
"1224225","Gampaha","Gampaha","Galahitiyawa North","215",3354,1674,1680
"1224230","Gampaha","Gampaha","Horagolla South","216A",1945,965,980
"1224235","Gampaha","Gampaha","Neduna","236C",1356,619,737
"1224240","Gampaha","Gampaha","Pahala Yagoda","236",2549,1249,1300
"1224245","Gampaha","Gampaha","Oruthota North","235",1412,685,727
"1224250","Gampaha","Gampaha","Moragoda 1","233",1150,561,589
"1224255","Gampaha","Gampaha","Bendiyamulla West","234B",2735,1298,1437
"1224260","Gampaha","Gampaha","Kidagammulla","234C",2028,990,1038
"1224265","Gampaha","Gampaha","Bendiyamulla East","234A",1869,883,986
"1224270","Gampaha","Gampaha","Gampaha Aluthgama East","225B",3416,1620,1796
"1224275","Gampaha","Gampaha","Keselwathugoda South","227A",1168,572,596
"1224280","Gampaha","Gampaha","Yakkala North","231",3631,1725,1906
"1224285","Gampaha","Gampaha","Galthotamulla","230C",1334,683,651
"1224290","Gampaha","Gampaha","Yakkala West","231A",2217,1039,1178
"1224295","Gampaha","Gampaha","Pepolgasdeniya","231B",2139,1036,1103
"1224300","Gampaha","Gampaha","Yakkala East","231D",1581,701,880
"1224305","Gampaha","Gampaha","Yakkala South","231C",1892,905,987
"1224310","Gampaha","Gampaha","Henarathgoda","232",2637,1225,1412
"1224315","Gampaha","Gampaha","Mudungoda West","232D",927,457,470
"1224320","Gampaha","Gampaha","Moragoda 2","233A",1394,684,710
"1224325","Gampaha","Gampaha","Ihala Yagoda North","235B",2997,1460,1537
"1224330","Gampaha","Gampaha","Mahena","236A",2988,1443,1545
"1224335","Gampaha","Gampaha","Ganemulla South","236D",5550,2658,2892
"1224340","Gampaha","Gampaha","Ganemulla North","236B",2127,1067,1060
"1224345","Gampaha","Gampaha","Galahitiyawa East","215B",2105,1008,1097
"1224350","Gampaha","Gampaha","Galahitiyawa South","215A",3339,1652,1687
"1224355","Gampaha","Gampaha","Kossinna East","237",2162,1057,1105
"1224360","Gampaha","Gampaha","Amunugoda North","238",3148,1505,1643
"1224365","Gampaha","Gampaha","Ihala Yagoda South","235C",2625,1276,1349
"1224370","Gampaha","Gampaha","Mudungoda South","232C",1923,910,1013
"1224375","Gampaha","Gampaha","Mudungoda North","232B",1458,727,731
"1224380","Gampaha","Gampaha","Godagedara","232A",2056,1017,1039
"1224385","Gampaha","Gampaha","Rathupaswala","239A",3307,1599,1708
"1224390","Gampaha","Gampaha","Galloluwa","239B",1939,969,970
"1224395","Gampaha","Gampaha","Belummahara","239",3173,1550,1623
"1224400","Gampaha","Gampaha","Ihala Imbulgoda North","240",1605,788,817
"1224405","Gampaha","Gampaha","Ihala Imbulgoda South","240A",2160,1011,1149
"1224410","Gampaha","Gampaha","Pahala Imbulgoda South","243B",2597,1315,1282
"1224415","Gampaha","Gampaha","Pahala Imbulgoda West","243A",3064,1492,1572
"1224420","Gampaha","Gampaha","Amunugoda South","238A",1833,897,936
"1224425","Gampaha","Gampaha","Parakandeniya North 1","244A",2103,1028,1075
"1224430","Gampaha","Gampaha","Kossinna West 1","237A",1812,889,923
"1224435","Gampaha","Gampaha","Katuwalamulla North","244C",1808,890,918
"1224440","Gampaha","Gampaha","Kossinna West 2","237B",2302,1094,1208
"1224445","Gampaha","Gampaha","Katuwalamulla South","244D",1735,832,903
"1224450","Gampaha","Gampaha","Parakandeniya North 2","244B",1749,882,867
"1224455","Gampaha","Gampaha","Parakandeniya","244",2238,1089,1149
"1224460","Gampaha","Gampaha","Pahala Imbulgoda East","243",986,492,494
"1224465","Gampaha","Gampaha","Embaraluwa North 2","242A",1610,794,816
"1224470","Gampaha","Gampaha","Embaraluwa North 1","242",2030,1015,1015
"1224475","Gampaha","Gampaha","Weliweriya West","240B",2624,1306,1318
"1224480","Gampaha","Gampaha","Nedungamuwa","241",2237,1085,1152
"1224485","Gampaha","Gampaha","Weliweriya East","241A",2381,1142,1239
"1224490","Gampaha","Gampaha","Weliweriya North","241B",2953,1447,1506
"1224495","Gampaha","Gampaha","Weliweriya South","241C",1883,897,986
"1224500","Gampaha","Gampaha","Embaraluwa South 1","242B",1608,816,792
"1224505","Gampaha","Gampaha","Embaraluwa South 2","242C",2549,1248,1301
"1227005","Gampaha","Attanagalla","Eluwapitiya West","333/A",1372,665,707
"1227010","Gampaha","Attanagalla","Eluwapitiya","333",1646,797,849
"1227015","Gampaha","Attanagalla","Hiripitiya West","329D",1564,766,798
"1227020","Gampaha","Attanagalla","Hiripitiya North","329",1542,745,797
"1227025","Gampaha","Attanagalla","Hiripitiya Central","329C",551,262,289
"1227030","Gampaha","Attanagalla","Hiripitiya East","329B",1368,647,721
"1227035","Gampaha","Attanagalla","Thalgasmote West","328/E",717,337,380
"1227040","Gampaha","Attanagalla","Thalgasmote","328A",757,367,390
"1227045","Gampaha","Attanagalla","Thalgasmote East","328/D",785,374,411
"1227050","Gampaha","Attanagalla","Udammita","347",1138,535,603
"1227055","Gampaha","Attanagalla","Humbutiyawa West","347C",919,427,492
"1227060","Gampaha","Attanagalla","Humbutiyawa","347A",1027,498,529
"1227065","Gampaha","Attanagalla","Parana Veyangoda","346",1051,502,549
"1227070","Gampaha","Attanagalla","Kongasdeniya","346A",829,399,430
"1227075","Gampaha","Attanagalla","Wedagama","343/A",1090,540,550
"1227080","Gampaha","Attanagalla","Kalalpitiya","343",2411,1179,1232
"1227085","Gampaha","Attanagalla","Nawagamuwa","343B",868,423,445
"1227090","Gampaha","Attanagalla","Napagoda","345",1066,532,534
"1227095","Gampaha","Attanagalla","Nittambuwa South","348A",918,496,422
"1227100","Gampaha","Attanagalla","Nittambuwa North","348",825,419,406
"1227105","Gampaha","Attanagalla","Nittambuwa East","348/F",737,342,395
"1227110","Gampaha","Attanagalla","Kolawatta","347B",770,357,413
"1227115","Gampaha","Attanagalla","Pattalagedara East","328/B",1393,658,735
"1227120","Gampaha","Attanagalla","Pattalagedara","328",2333,984,1349
"1227125","Gampaha","Attanagalla","Hiripitiya South","329A",1387,655,732
"1227130","Gampaha","Attanagalla","Wataddara","332",1157,560,597
"1227135","Gampaha","Attanagalla","Wataddara West","332/B",1382,688,694
"1227140","Gampaha","Attanagalla","Magalegoda","331",1357,652,705
"1227145","Gampaha","Attanagalla","Magalegoda South","331/A",1509,696,813
"1227150","Gampaha","Attanagalla","Heendeniya","330A",801,361,440
"1227155","Gampaha","Attanagalla","Pattigoda","330",986,482,504
"1227160","Gampaha","Attanagalla","Wataddara South","332/A",1027,488,539
"1227165","Gampaha","Attanagalla","Hiripitiya Pahala","329/E",611,297,314
"1227170","Gampaha","Attanagalla","Danvilana","328C",653,324,329
"1227175","Gampaha","Attanagalla","Dadagamuwa East","327A",1124,554,570
"1227180","Gampaha","Attanagalla","Pinnagolla","348/I",1499,727,772
"1227185","Gampaha","Attanagalla","Egoda Nittambuwa","348/C",708,341,367
"1227190","Gampaha","Attanagalla","Horagollagama","348H",1268,621,647
"1227195","Gampaha","Attanagalla","Nambadaluwa West","348/B",408,183,225
"1227200","Gampaha","Attanagalla","Nambadaluwa East","348/G",1526,754,772
"1227205","Gampaha","Attanagalla","Ranpokunagama A Zone","349A",1443,676,767
"1227210","Gampaha","Attanagalla","Ellakkala West","355/A",2198,1020,1178
"1227215","Gampaha","Attanagalla","Maimbula","350B",1841,871,970
"1227220","Gampaha","Attanagalla","Ranpokunagama","349F",1051,470,581
"1227225","Gampaha","Attanagalla","Ranpokunagama D Zone","349E",1156,551,605
"1227230","Gampaha","Attanagalla","Ranpokunagama C Zone","349D",388,175,213
"1227235","Gampaha","Attanagalla","Ranpokunagama B Zone","349C",1352,620,732
"1227240","Gampaha","Attanagalla","Maduwegedara","349",2200,1055,1145
"1227245","Gampaha","Attanagalla","Yatiyana","349/B",1608,753,855
"1227250","Gampaha","Attanagalla","Orchardwatta North","348/D",1095,543,552
"1227255","Gampaha","Attanagalla","Malwatta","348/E",2288,1075,1213
"1227260","Gampaha","Attanagalla","Thihariya North","318/C",2177,1068,1109
"1227265","Gampaha","Attanagalla","Katuwasgoda West","321B",813,398,415
"1227270","Gampaha","Attanagalla","Katuwasgoda","321A",1044,502,542
"1227275","Gampaha","Attanagalla","Dadagamuwa","327",1182,579,603
"1227280","Gampaha","Attanagalla","Mudagamuwa","324A",1023,492,531
"1227285","Gampaha","Attanagalla","Bandarabatawala","325A",1027,531,496
"1227290","Gampaha","Attanagalla","Pitiyegedara","325",1122,516,606
"1227295","Gampaha","Attanagalla","Daraluwa","325B",723,346,377
"1227300","Gampaha","Attanagalla","Bemmulla","324",1298,643,655
"1227305","Gampaha","Attanagalla","Kandaoluwawa","326",1535,733,802
"1227310","Gampaha","Attanagalla","Raniswala","323",836,397,439
"1227315","Gampaha","Attanagalla","Sapugasthenna","323A",2199,1090,1109
"1227320","Gampaha","Attanagalla","Thiriwanegama South","322/B",944,478,466
"1227325","Gampaha","Attanagalla","Thiriwanegama North","322/A",846,415,431
"1227330","Gampaha","Attanagalla","Halgampitiya","322",1018,514,504
"1227335","Gampaha","Attanagalla","Kalagedihena","321",1542,766,776
"1227340","Gampaha","Attanagalla","Thihariyagama","318/D",2457,1271,1186
"1227345","Gampaha","Attanagalla","Thihariya East","318",6391,3256,3135
"1227350","Gampaha","Attanagalla","Kalotuwawa","319",1341,672,669
"1227355","Gampaha","Attanagalla","Kattota","317",1700,830,870
"1227360","Gampaha","Attanagalla","Orchardwatta South","348/J",948,472,476
"1227365","Gampaha","Attanagalla","Bogoda","316",924,430,494
"1227370","Gampaha","Attanagalla","Mathalana West","352D",1245,521,724
"1227375","Gampaha","Attanagalla","Wathupitiwala","350/A",2187,968,1219
"1227380","Gampaha","Attanagalla","Walpola","350",2210,1035,1175
"1227385","Gampaha","Attanagalla","Haggalla","354",2178,1018,1160
"1227390","Gampaha","Attanagalla","Ellakkala","355",1380,660,720
"1227395","Gampaha","Attanagalla","Godagama West","361/A",491,233,258
"1227400","Gampaha","Attanagalla","Godagama","361",657,325,332
"1227405","Gampaha","Attanagalla","Welikadamulla","363",1097,530,567
"1227410","Gampaha","Attanagalla","Karasnagala","365",612,296,316
"1227415","Gampaha","Attanagalla","Alawala North","364",1316,626,690
"1227420","Gampaha","Attanagalla","Etha Udakanda","364/B",541,256,285
"1227425","Gampaha","Attanagalla","Alawala South","364/A",889,436,453
"1227430","Gampaha","Attanagalla","Nikahetikanda","365/A",721,341,380
"1227435","Gampaha","Attanagalla","Karasnagala South","365C",467,229,238
"1227440","Gampaha","Attanagalla","Palkumbura","363A",902,446,456
"1227445","Gampaha","Attanagalla","Pelpita","362",852,408,444
"1227450","Gampaha","Attanagalla","Walaliyadda","353/B",884,435,449
"1227455","Gampaha","Attanagalla","Haggalla East","354/A",558,288,270
"1227460","Gampaha","Attanagalla","Diyakade","353A",640,297,343
"1227465","Gampaha","Attanagalla","Welagedara","353",925,455,470
"1227470","Gampaha","Attanagalla","Kamburagalla","352A",2500,1175,1325
"1227475","Gampaha","Attanagalla","Mathalana North","352F",741,376,365
"1227480","Gampaha","Attanagalla","Mathalana","352",1415,610,805
"1227485","Gampaha","Attanagalla","Meewala","315",844,415,429
"1227490","Gampaha","Attanagalla","Kittammahara","316A",276,117,159
"1227495","Gampaha","Attanagalla","Thihariya South","318/E",1749,840,909
"1227500","Gampaha","Attanagalla","Pahala Thihariya","318B",2865,1327,1538
"1227505","Gampaha","Attanagalla","Thihariya West","318/A",1471,711,760
"1227510","Gampaha","Attanagalla","Bogamuwa","320A",516,254,262
"1227515","Gampaha","Attanagalla","Mangalathiriya","320",992,487,505
"1227520","Gampaha","Attanagalla","Pilankada","319A",579,272,307
"1227525","Gampaha","Attanagalla","Bonegala","313",1417,679,738
"1227530","Gampaha","Attanagalla","Meewala West","315A",903,444,459
"1227535","Gampaha","Attanagalla","Udugoda West","351/A",1499,732,767
"1227540","Gampaha","Attanagalla","Mathalana East","352/B",1198,580,618
"1227545","Gampaha","Attanagalla","Udugoda","351",863,422,441
"1227550","Gampaha","Attanagalla","Pannila","352E",575,266,309
"1227555","Gampaha","Attanagalla","Hunupola","352C",1265,634,631
"1227560","Gampaha","Attanagalla","Halpandeniya","362A",790,390,400
"1227565","Gampaha","Attanagalla","Urapola","366",981,452,529
"1227570","Gampaha","Attanagalla","Wanduramulla","366/C",896,438,458
"1227575","Gampaha","Attanagalla","Deenapamunuwa West","366D",706,328,378
"1227580","Gampaha","Attanagalla","Deenapamunuwa","366B",810,369,441
"1227585","Gampaha","Attanagalla","Yatawaka","366/A",704,334,370
"1227590","Gampaha","Attanagalla","Sapugasthenna","365B",1028,506,522
"1227595","Gampaha","Attanagalla","Bopagama","376",1571,753,818
"1227600","Gampaha","Attanagalla","Bopagama East","376A",677,313,364
"1227605","Gampaha","Attanagalla","Meevitigammana","375A",1188,575,613
"1227610","Gampaha","Attanagalla","Bopetta South","367B",1304,636,668
"1227615","Gampaha","Attanagalla","Bopetta","367",840,405,435
"1227620","Gampaha","Attanagalla","Nagoda","367A",891,436,455
"1227625","Gampaha","Attanagalla","Kurawalana","368A",1632,773,859
"1227630","Gampaha","Attanagalla","Kahatovita","369",1431,708,723
"1227635","Gampaha","Attanagalla","Kahatovita West","369/A",1608,779,829
"1227640","Gampaha","Attanagalla","Ogodapola North","314/A",1721,843,878
"1227645","Gampaha","Attanagalla","Ogodapola","314",561,281,280
"1227650","Gampaha","Attanagalla","Kahambilihena","312/A",796,402,394
"1227655","Gampaha","Attanagalla","Udatuttiripitiya","312",1457,707,750
"1227660","Gampaha","Attanagalla","Mattagoda","311",1155,549,606
"1227665","Gampaha","Attanagalla","Weerangula","310",1210,586,624
"1227670","Gampaha","Attanagalla","Weerangula South","310/A",1162,555,607
"1227675","Gampaha","Attanagalla","Koskandawala North","308/A",919,445,474
"1227680","Gampaha","Attanagalla","Kirikittamulla","309",544,274,270
"1227685","Gampaha","Attanagalla","Kirikittamulla South","309A",918,422,496
"1227690","Gampaha","Attanagalla","Koskandawala","308",1361,654,707
"1227695","Gampaha","Attanagalla","Opathella","371",924,449,475
"1227700","Gampaha","Attanagalla","Paranagama","370",1256,618,638
"1227705","Gampaha","Attanagalla","Paranagama East","370C",1283,639,644
"1227710","Gampaha","Attanagalla","Aruppassa","368",1428,673,755
"1227715","Gampaha","Attanagalla","Madakotuwa West","375B",706,333,373
"1227720","Gampaha","Attanagalla","Madakotuwa","375",426,205,221
"1227725","Gampaha","Attanagalla","Rathambale","374",1332,640,692
"1227730","Gampaha","Attanagalla","Walgammulla","373",965,445,520
"1227735","Gampaha","Attanagalla","Ruwanpura","370B",986,517,469
"1227740","Gampaha","Attanagalla","Lavulupitiya","372A",1112,541,571
"1227745","Gampaha","Attanagalla","Galboda","370A",713,355,358
"1227750","Gampaha","Attanagalla","Dematalanda","370D",1004,500,504
"1227755","Gampaha","Attanagalla","Happitiya","372",1359,675,684
"1230005","Gampaha","Dompe","Maryland Colony","389B",1466,731,735
"1230010","Gampaha","Dompe","Indurugalla","389",1394,693,701
"1230015","Gampaha","Dompe","Wathurugama","293",1396,688,708
"1230020","Gampaha","Dompe","Bandaranayakapura West","388C",776,366,410
"1230025","Gampaha","Dompe","Bandaranayakapura East","388A",793,367,426
"1230030","Gampaha","Dompe","Mailawalana","388",1079,516,563
"1230035","Gampaha","Dompe","Mailawalana South","388B",533,242,291
"1230040","Gampaha","Dompe","Thimbirigama","387A",755,372,383
"1230045","Gampaha","Dompe","Mahal Loluwa","387",964,496,468
"1230050","Gampaha","Dompe","Millathe Ihala","386B",1429,702,727
"1230055","Gampaha","Dompe","Pingamuwa","377",1258,597,661
"1230060","Gampaha","Dompe","Pahala Millathe","386A",1186,581,605
"1230065","Gampaha","Dompe","Millathe","386",695,320,375
"1230070","Gampaha","Dompe","Kirindiwela","385",1313,656,657
"1230075","Gampaha","Dompe","Bogahawatta","385A",1451,685,766
"1230080","Gampaha","Dompe","Rambutanwatta","390B",1346,649,697
"1230085","Gampaha","Dompe","Etambagahawatta","389C",797,391,406
"1230090","Gampaha","Dompe","Kannimahara","389A",1230,596,634
"1230095","Gampaha","Dompe","Radawana North","390",630,320,310
"1230100","Gampaha","Dompe","Palupelpita","390E",1913,934,979
"1230105","Gampaha","Dompe","Kithulakanda","390C",1119,542,577
"1230110","Gampaha","Dompe","Radawana South","390A",1351,647,704
"1230115","Gampaha","Dompe","Alliyawatta","390D",1098,535,563
"1230120","Gampaha","Dompe","Diyawala North","391A",846,418,428
"1230125","Gampaha","Dompe","Diyawala","391",1015,472,543
"1230130","Gampaha","Dompe","Meddegama","383",2736,1331,1405
"1230135","Gampaha","Dompe","Udagama","384",1780,871,909
"1230140","Gampaha","Dompe","Vihara Kumbura","384A",1548,784,764
"1230145","Gampaha","Dompe","Kuttivila","377B",1072,523,549
"1230150","Gampaha","Dompe","Thalgaswatta","377C",670,341,329
"1230155","Gampaha","Dompe","Kendagolla","377A",1187,596,591
"1230160","Gampaha","Dompe","Udawela","378B",742,361,381
"1230165","Gampaha","Dompe","Kirimetiyawatta","378A",781,373,408
"1230170","Gampaha","Dompe","Hiswella","378",542,261,281
"1230175","Gampaha","Dompe","Kiriwana","382A",730,349,381
"1230180","Gampaha","Dompe","Meddegama North","383A",753,370,383
"1230185","Gampaha","Dompe","Meddegama South","383B",994,457,537
"1230190","Gampaha","Dompe","Werahera","382",1171,562,609
"1230195","Gampaha","Dompe","Pallegama South","381B",1269,603,666
"1230200","Gampaha","Dompe","Pallegama","381",566,279,287
"1230205","Gampaha","Dompe","Anuragoda","392",1155,586,569
"1230210","Gampaha","Dompe","Weralugampala","392A",647,309,338
"1230215","Gampaha","Dompe","Nedungolla South","392D",525,248,277
"1230220","Gampaha","Dompe","Nedungolla","392B",884,409,475
"1230225","Gampaha","Dompe","Nandarama Pedesa","394A",1458,726,732
"1230230","Gampaha","Dompe","Mandawala North","394",1374,671,703
"1230235","Gampaha","Dompe","Mawatha","394B",1068,523,545
"1230240","Gampaha","Dompe","Parakadamulla","397B",954,448,506
"1230245","Gampaha","Dompe","Nakandapola","397A",754,332,422
"1230250","Gampaha","Dompe","Keragala","397",956,479,477
"1230255","Gampaha","Dompe","Weliketiyawatta","397C",1241,636,605
"1230260","Gampaha","Dompe","Kurunduhena","395B",1533,773,760
"1230265","Gampaha","Dompe","Baduwatta","395C",1177,560,617
"1230270","Gampaha","Dompe","Mandawala South","395",1193,569,624
"1230275","Gampaha","Dompe","Anuragoda South","392C",872,445,427
"1230280","Gampaha","Dompe","Walpola","381A",768,367,401
"1230285","Gampaha","Dompe","Pepiliyawala","380B",1715,845,870
"1230290","Gampaha","Dompe","Ganihigama North","380A",1088,547,541
"1230295","Gampaha","Dompe","Watawala","379B",651,332,319
"1230300","Gampaha","Dompe","Meethirigala","379",691,345,346
"1230305","Gampaha","Dompe","Polhena","379C",837,413,424
"1230310","Gampaha","Dompe","Ganihigama South","380D",625,293,332
"1230315","Gampaha","Dompe","Dangalla North","380C",866,411,455
"1230320","Gampaha","Dompe","Meniklanda","422A",1685,851,834
"1230325","Gampaha","Dompe","Pelpita","393",762,365,397
"1230330","Gampaha","Dompe","Punchi Mandawala","395A",1757,838,919
"1230335","Gampaha","Dompe","Waharaka","410C",1233,599,634
"1230340","Gampaha","Dompe","Putupagala","396",1248,596,652
"1230345","Gampaha","Dompe","Walaramba","398A",624,286,338
"1230350","Gampaha","Dompe","Demalagama","398",843,407,436
"1230355","Gampaha","Dompe","Helummahara","399",927,432,495
"1230360","Gampaha","Dompe","Pananwala","399A",1610,757,853
"1230365","Gampaha","Dompe","Egoda Pelahela","400B",1301,633,668
"1230370","Gampaha","Dompe","Pelahela","400",1037,496,541
"1230375","Gampaha","Dompe","Madurawa","400A",1197,593,604
"1230380","Gampaha","Dompe","Kajugaswatta","400C",575,269,306
"1230385","Gampaha","Dompe","Ihala Lunugama","410",1493,737,756
"1230390","Gampaha","Dompe","Meegahawatta","410B",1644,795,849
"1230395","Gampaha","Dompe","Yakambe","393A",1063,522,541
"1230400","Gampaha","Dompe","Pattiyagama","421",2053,976,1077
"1230405","Gampaha","Dompe","Dangalla","380",539,261,278
"1230410","Gampaha","Dompe","Ranwala","379A",1665,841,824
"1230415","Gampaha","Dompe","Wedagama","379D",625,324,301
"1230420","Gampaha","Dompe","Udugama","423",779,378,401
"1230425","Gampaha","Dompe","Udakanampella South","424B",569,248,321
"1230430","Gampaha","Dompe","Udakanampella","424A",746,352,394
"1230435","Gampaha","Dompe","Senasungoda","424",1063,512,551
"1230440","Gampaha","Dompe","Poogoda","422",1050,547,503
"1230445","Gampaha","Dompe","Bangalawatta","420A",1280,664,616
"1230450","Gampaha","Dompe","Kumarimulla","419",1567,783,784
"1230455","Gampaha","Dompe","Ovitigama","420",1425,692,733
"1230460","Gampaha","Dompe","Parathapakanda","420B",915,435,480
"1230465","Gampaha","Dompe","Dethemulla","406A",1121,532,589
"1230470","Gampaha","Dompe","Pahala Lunugama","410A",776,390,386
"1230475","Gampaha","Dompe","Wanaluwawa North","408",1147,572,575
"1230480","Gampaha","Dompe","Thelkekuna","404B",993,497,496
"1230485","Gampaha","Dompe","Indolamulla","404",1163,582,581
"1230490","Gampaha","Dompe","Parangoda","401A",1309,646,663
"1230495","Gampaha","Dompe","Namaluwa","401C",1584,774,810
"1230500","Gampaha","Dompe","Dekatana","401",988,494,494
"1230505","Gampaha","Dompe","Narampola","401B",3088,1614,1474
"1230510","Gampaha","Dompe","Kalukondayawa West","402A",1772,885,887
"1230515","Gampaha","Dompe","Kalukondayawa East","402",843,382,461
"1230520","Gampaha","Dompe","Galwalagoda","401D",1613,773,840
"1230525","Gampaha","Dompe","Ganegoda","404A",1861,908,953
"1230530","Gampaha","Dompe","Dompe","405",3358,1637,1721
"1230535","Gampaha","Dompe","Iddamaldeniya","405A",939,469,470
"1230540","Gampaha","Dompe","Guruwala","409",689,319,370
"1230545","Gampaha","Dompe","Egoda Guruwala","409A",1006,482,524
"1230550","Gampaha","Dompe","Wanaluwawa South","408A",1051,488,563
"1230555","Gampaha","Dompe","Giridara West","407C",802,389,413
"1230560","Gampaha","Dompe","Galpothugoda","406",1118,541,577
"1230565","Gampaha","Dompe","Nikawala","418",984,484,500
"1230570","Gampaha","Dompe","Kapugoda","418A",849,406,443
"1230575","Gampaha","Dompe","Giridara","407",973,467,506
"1230580","Gampaha","Dompe","Malinda East","407B",1375,648,727
"1230585","Gampaha","Dompe","Malinda","407A",884,445,439
"1230590","Gampaha","Dompe","Palugama","411",1622,794,828
"1230595","Gampaha","Dompe","Degawatta","405B",1016,528,488
"1230600","Gampaha","Dompe","Pahala Dompe","403",1033,505,528
"1230605","Gampaha","Dompe","Malwana","413",1587,783,804
"1230610","Gampaha","Dompe","Pahala Mapitigama","412",1618,807,811
"1230615","Gampaha","Dompe","Morahena","412B",1152,557,595
"1230620","Gampaha","Dompe","Kimbulvilawatta","412A",2421,1188,1233
"1230625","Gampaha","Dompe","Udamapitigama","414",1028,536,492
"1230630","Gampaha","Dompe","Udamapitigama South","414A",1232,623,609
"1230635","Gampaha","Dompe","Palugama West","411A",827,412,415
"1230640","Gampaha","Dompe","Welgama","415",919,455,464
"1230645","Gampaha","Dompe","Lansiyahena","415A",989,488,501
"1230650","Gampaha","Dompe","Samanabedda North","416A",1362,667,695
"1230655","Gampaha","Dompe","Mahawalawatta","417A",1467,701,766
"1230660","Gampaha","Dompe","Thittapattara","417",1135,558,577
"1230665","Gampaha","Dompe","Samanabedda","416",1630,774,856
"1233005","Gampaha","Mahara","Kimbulgoda","304A",1735,836,899
"1233010","Gampaha","Mahara","Pituwalgoda","306A",1430,679,751
"1233015","Gampaha","Mahara","Kinigama","304",1841,857,984
"1233020","Gampaha","Mahara","Maharagama","303A",1513,741,772
"1233025","Gampaha","Mahara","Siwralumulla","303",1465,728,737
"1233030","Gampaha","Mahara","Pilikuttuwa","305",1621,780,841
"1233035","Gampaha","Mahara","Yongammulla","306",686,339,347
"1233040","Gampaha","Mahara","Ambagaspitiya","307A",1165,566,599
"1233045","Gampaha","Mahara","Warapalana","294",1666,803,863
"1233050","Gampaha","Mahara","Kandumulla","307",854,402,452
"1233055","Gampaha","Mahara","Pasgammana","298",1565,774,791
"1233060","Gampaha","Mahara","Maligathenna","297A",1356,667,689
"1233065","Gampaha","Mahara","Batepola North","295A",817,395,422
"1233070","Gampaha","Mahara","Batepola","295",1133,569,564
"1233075","Gampaha","Mahara","Amunukumbura","296",1459,716,743
"1233080","Gampaha","Mahara","Malwathuhiripitiya","297",1011,507,504
"1233085","Gampaha","Mahara","Buthpitiya North","299",399,195,204
"1233090","Gampaha","Mahara","Uruwala East","302A",1948,972,976
"1233095","Gampaha","Mahara","Uruwala West","302",1787,892,895
"1233100","Gampaha","Mahara","Buthpitiya South","300",937,448,489
"1233105","Gampaha","Mahara","Neelamahara North","298A",844,407,437
"1233110","Gampaha","Mahara","Neelamahara South","298B",555,269,286
"1233115","Gampaha","Mahara","Aramangoda North","301B",487,237,250
"1233120","Gampaha","Mahara","Puwakpitiya","292A",1072,506,566
"1233125","Gampaha","Mahara","Amunukumbura South","296B",1231,603,628
"1233130","Gampaha","Mahara","Balivila","296A",982,470,512
"1233135","Gampaha","Mahara","Vilimbula North","292",1799,885,914
"1233140","Gampaha","Mahara","Vilimbula South","292B",3078,1511,1567
"1233145","Gampaha","Mahara","Aramangoda","301",1180,596,584
"1233150","Gampaha","Mahara","Kahatana","301A",1208,583,625
"1233155","Gampaha","Mahara","Henegama","291",2214,1091,1123
"1233160","Gampaha","Mahara","Etikehelgalla East","290",1462,705,757
"1233165","Gampaha","Mahara","Etikehelgalla West","290A",1431,716,715
"1233170","Gampaha","Mahara","Kirikitta North","289B",1341,637,704
"1233175","Gampaha","Mahara","Kirikitta East","289",1526,748,778
"1233180","Gampaha","Mahara","Kirikitta West","289A",1986,986,1000
"1233185","Gampaha","Mahara","Ahugammana","284A",1794,894,900
"1233190","Gampaha","Mahara","Naranwala South","284B",1319,638,681
"1233195","Gampaha","Mahara","Naranwala","284",2779,1359,1420
"1233200","Gampaha","Mahara","Udupila East","285B",2746,1334,1412
"1233205","Gampaha","Mahara","Udupila South","285A",2002,956,1046
"1233210","Gampaha","Mahara","Udupila North","285",4081,2003,2078
"1233215","Gampaha","Mahara","Webada South","288A",1836,877,959
"1233220","Gampaha","Mahara","Webada North","288",1706,852,854
"1233225","Gampaha","Mahara","Webada West","288B",2563,1268,1295
"1233230","Gampaha","Mahara","Kirillawala North","287D",2606,1250,1356
"1233235","Gampaha","Mahara","Kirillawala","287",2181,1089,1092
"1233240","Gampaha","Mahara","Kirillawala West","287C",2251,1151,1100
"1233245","Gampaha","Mahara","Sooriyapaluwa North","245",5130,2477,2653
"1233250","Gampaha","Mahara","Kendaliyeddapaluwa East","246",5258,2492,2766
"1233255","Gampaha","Mahara","Kendaliyeddapaluwa North","246C",3425,1656,1769
"1233260","Gampaha","Mahara","Dangahawela","246B",3794,1815,1979
"1233265","Gampaha","Mahara","Kendaliyeddapaluwa West","246A",7136,4275,2861
"1233270","Gampaha","Mahara","Mahara Nugegoda North","247B",2558,1228,1330
"1233275","Gampaha","Mahara","Mahara Nugegoda West","247A",2232,1077,1155
"1233280","Gampaha","Mahara","Mahara Nugegoda East","247",2290,1045,1245
"1233285","Gampaha","Mahara","Sooriyapaluwa East","245B",4970,2410,2560
"1233290","Gampaha","Mahara","Sooriyapaluwa South","245A",3820,1802,2018
"1233295","Gampaha","Mahara","Rammuthugala","287A",3048,1452,1596
"1233300","Gampaha","Mahara","Kirillawala South","287B",4297,2044,2253
"1233305","Gampaha","Mahara","Webada East","288C",2130,985,1145
"1233310","Gampaha","Mahara","Gonahena East","286",1772,873,899
"1233315","Gampaha","Mahara","Gonahena North","286C",2809,1339,1470
"1233320","Gampaha","Mahara","Gonahena South","286D",1954,955,999
"1233325","Gampaha","Mahara","Gonahena West","286A",3535,1717,1818
"1233330","Gampaha","Mahara","Eldeniya East","286E",3762,1758,2004
"1233335","Gampaha","Mahara","Eldeniya West","286B",2754,1350,1404
"1233340","Gampaha","Mahara","Puwakwetiya","248C",2776,1368,1408
"1233345","Gampaha","Mahara","Ihala Karagahamuna South","248A",2009,994,1015
"1233350","Gampaha","Mahara","Ihala Karagahamuna East","248B",2221,1035,1186
"1233355","Gampaha","Mahara","Ihala Karagahamuna North","248",4351,2089,2262
"1233360","Gampaha","Mahara","Mahara Nugegoda South","247C",2994,1497,1497
"1233365","Gampaha","Mahara","Neligama","249C",2160,998,1162
"1233370","Gampaha","Mahara","Pahala Karagahamuna North","249",1869,919,950
"1233375","Gampaha","Mahara","Pahala Karagahamuna East","249A",2162,1045,1117
"1233380","Gampaha","Mahara","Pahala Karagahamuna West","249B",3559,1783,1776
"1233385","Gampaha","Mahara","Kopiwatta","251A",2112,1012,1100
"1233390","Gampaha","Mahara","Dalupitiya East","252",2162,1036,1126
"1233395","Gampaha","Mahara","Kirimetiyagara","251",2224,1038,1186
"1233400","Gampaha","Mahara","Dalupitiya South","252B",2617,1274,1343
"1233405","Gampaha","Mahara","Dalupitiya West","252A",1498,728,770
"1233410","Gampaha","Mahara","Pinnameda West","255D",2517,1231,1286
"1233415","Gampaha","Mahara","Gongithota","255C",3864,1843,2021
"1233420","Gampaha","Mahara","Appugewatta","255H",1672,810,862
"1233425","Gampaha","Mahara","Gongithota West","255G",3127,1491,1636
"1233430","Gampaha","Mahara","Enderamulla South","255B",2504,1184,1320
"1233435","Gampaha","Mahara","Enderamulla East","255E",2847,1349,1498
"1233440","Gampaha","Mahara","Pinnameda","255",2925,1381,1544
"1233445","Gampaha","Mahara","Nathuduwa","253",2363,1176,1187
"1233450","Gampaha","Mahara","Enderamulla West","255F",2775,1352,1423
"1233455","Gampaha","Mahara","Nathuduwa West","253A",1745,893,852
"1233460","Gampaha","Mahara","Akbar Town","255A",3407,1626,1781
"1236005","Gampaha","Kelaniya","Welegoda","256B",6646,3288,3358
"1236010","Gampaha","Kelaniya","Hunupitiya North","256",2987,1424,1563
"1236015","Gampaha","Kelaniya","Nahena","256C",5761,2823,2938
"1236020","Gampaha","Kelaniya","Eriyawetiya","259A",4664,2301,2363
"1236025","Gampaha","Kelaniya","Kiribathgoda","267A",3302,1549,1753
"1236030","Gampaha","Kelaniya","Thalawathuhenpita North","267",3737,1726,2011
"1236035","Gampaha","Kelaniya","Thalawathuhenpita South","266",1624,841,783
"1236040","Gampaha","Kelaniya","Kendahena","266A",3618,1777,1841
"1236045","Gampaha","Kelaniya","Egoda Eriyawetiya","259C",2629,1279,1350
"1236050","Gampaha","Kelaniya","Hunupitiya East","256D",5774,2850,2924
"1236055","Gampaha","Kelaniya","Hunupitiya South","256A",3507,1687,1820
"1236060","Gampaha","Kelaniya","Wanawasala West","257",3916,1963,1953
"1236065","Gampaha","Kelaniya","Wanawasala East","257B",3415,1768,1647
"1236070","Gampaha","Kelaniya","Dippitigoda","260",3513,1792,1721
"1236075","Gampaha","Kelaniya","Weweldoowa","258",3643,1857,1786
"1236080","Gampaha","Kelaniya","Warakanatta","259",3926,1135,2791
"1236085","Gampaha","Kelaniya","Koholvila","259B",4033,2000,2033
"1236090","Gampaha","Kelaniya","Dalugamgoda","258A",3182,1565,1617
"1236095","Gampaha","Kelaniya","Nungamugoda","258B",2968,1504,1464
"1236100","Gampaha","Kelaniya","Dalugama","260A",1938,949,989
"1236105","Gampaha","Kelaniya","Himbutuwelgoda","257A",3761,1980,1781
"1236110","Gampaha","Kelaniya","Pattiya East","173",3862,2085,1777
"1236115","Gampaha","Kelaniya","Pattiya North","173B",5062,2648,2414
"1236120","Gampaha","Kelaniya","Meegahawatta","174C",5140,2570,2570
"1236125","Gampaha","Kelaniya","Peliyagodawatta","174A",3688,1902,1786
"1236130","Gampaha","Kelaniya","Peliyagoda Gangabada","174",4030,2041,1989
"1236135","Gampaha","Kelaniya","Peliyagoda Gangabada East","174B",2046,1019,1027
"1236140","Gampaha","Kelaniya","Pattiya West","173A",3908,1958,1950
"1236145","Gampaha","Kelaniya","Wedamulla","261",4561,2235,2326
"1236150","Gampaha","Kelaniya","Galborella","261A",3059,1464,1595
"1236155","Gampaha","Kelaniya","Polhena","264A",2704,1310,1394
"1236160","Gampaha","Kelaniya","Kelaniya","264",3230,1588,1642
"1236165","Gampaha","Kelaniya","Sinharamulla North","263B",4151,2059,2092
"1236170","Gampaha","Kelaniya","Pilapitiya","263A",2070,984,1086
"1236175","Gampaha","Kelaniya","Pethiyagoda","262",4094,2043,2051
"1236180","Gampaha","Kelaniya","Mewella","262A",4356,2126,2230
"1236185","Gampaha","Kelaniya","Sinharamulla","263",2834,1371,1463
"1239005","Gampaha","Biyagama","Pahala Biyanvila East","268",2758,1329,1429
"1239010","Gampaha","Biyagama","Ihala Biyanvila North","269",3407,1675,1732
"1239015","Gampaha","Biyagama","Ihala Biyanvila Central","269B",5003,2417,2586
"1239020","Gampaha","Biyagama","Mawaramandiya","269A",5733,2783,2950
"1239025","Gampaha","Biyagama","Meegahawatta West","272A",2787,1323,1464
"1239030","Gampaha","Biyagama","Meegahawatta East","272",2679,1300,1379
"1239035","Gampaha","Biyagama","Kammalwatta","273",2627,1271,1356
"1239040","Gampaha","Biyagama","Delgoda","282/A",2516,1240,1276
"1239045","Gampaha","Biyagama","Athurumulla","283",1755,856,899
"1239050","Gampaha","Biyagama","Kanduboda East","282",2829,1410,1419
"1239055","Gampaha","Biyagama","Kanduboda West","282B",2309,1138,1171
"1239060","Gampaha","Biyagama","Siyambalape Watta","274C",3965,2023,1942
"1239065","Gampaha","Biyagama","Daranagama","272B",2740,1336,1404
"1239070","Gampaha","Biyagama","Siyambalape North","274",5425,2637,2788
"1239075","Gampaha","Biyagama","Heiyanthuduwa North","275",5516,2688,2828
"1239080","Gampaha","Biyagama","Makola South Ihala","271",4856,2369,2487
"1239085","Gampaha","Biyagama","Makola North Ihala","270",3519,1694,1825
"1239090","Gampaha","Biyagama","Makola North Central","270A",6682,3265,3417
"1239095","Gampaha","Biyagama","Pahala Biyanvila West","268A",4708,2228,2480
"1239100","Gampaha","Biyagama","Pahala Biyanvila Central","268B",2375,1121,1254
"1239105","Gampaha","Biyagama","Makola North Pahala","270B",5591,2830,2761
"1239110","Gampaha","Biyagama","Makola South Pahala","271B",3109,1535,1574
"1239115","Gampaha","Biyagama","Pamunuvila","265",5593,2736,2857
"1239120","Gampaha","Biyagama","Gonawala East","277",4081,1946,2135
"1239125","Gampaha","Biyagama","Sapugaskanda","271A",6319,3110,3209
"1239130","Gampaha","Biyagama","Heiyanthuduwa West","275C",2180,1110,1070
"1239135","Gampaha","Biyagama","Heiyanthuduwa East","275B",4649,2282,2367
"1239140","Gampaha","Biyagama","Siyambalape South","274A",6119,3097,3022
"1239145","Gampaha","Biyagama","Yatihena","274B",4554,2351,2203
"1239150","Gampaha","Biyagama","Ulahitiwala","281B",2705,1292,1413
"1239155","Gampaha","Biyagama","Walgama West","281A",5025,2630,2395
"1239160","Gampaha","Biyagama","Biyagama North","280",5277,2664,2613
"1239165","Gampaha","Biyagama","Biyagama West","280/D",2879,1441,1438
"1239170","Gampaha","Biyagama","Heiyanthuduwa South","275A",2342,1137,1205
"1239175","Gampaha","Biyagama","Mabima East","276",3330,1678,1652
"1239180","Gampaha","Biyagama","Mabima West","276A",3270,1665,1605
"1239185","Gampaha","Biyagama","Pattivila North","279",2048,1130,918
"1239190","Gampaha","Biyagama","Gonawala Central","277B",5097,2498,2599
"1239195","Gampaha","Biyagama","Galedanda","265A",2550,1241,1309
"1239200","Gampaha","Biyagama","Gonawala West","277/A",5985,2883,3102
"1239205","Gampaha","Biyagama","Thalwatta","278",3263,1596,1667
"1239210","Gampaha","Biyagama","Bollegala","278A",3920,1898,2022
"1239215","Gampaha","Biyagama","Pattivila South","279A",2694,1382,1312
"1239220","Gampaha","Biyagama","Biyagama South","280/C",3312,1675,1637
"1239225","Gampaha","Biyagama","Biyagama East","280B",3016,1517,1499
"1239230","Gampaha","Biyagama","Yabaraluwa North","280A",1860,938,922
"1239235","Gampaha","Biyagama","Yabaraluwa South","280E",2076,1077,999
"1239240","Gampaha","Biyagama","Malwana Town","281C",5361,2669,2692
"1239245","Gampaha","Biyagama","Walgama East","281",4191,2004,2187
"1303005","Kalutara","Panadura","Horethuduwa North","670B",1574,754,820
"1303010","Kalutara","Panadura","Horethuduwa","670",2013,973,1040
"1303015","Kalutara","Panadura","Horethuduwa Central","670C",1312,637,675
"1303020","Kalutara","Panadura","Horethuduwa South","670A",2138,1059,1079
"1303025","Kalutara","Panadura","Gorakana","671",2614,1260,1354
"1303030","Kalutara","Panadura","Gorakana South","671A",3902,1895,2007
"1303035","Kalutara","Panadura","Paratta West","672D",2397,1129,1268
"1303040","Kalutara","Panadura","Paratta","672A",2926,1471,1455
"1303045","Kalutara","Panadura","Diggala","672B",4301,2090,2211
"1303050","Kalutara","Panadura","Keselwatta","672",6270,3085,3185
"1303055","Kalutara","Panadura","Sarikkamulla","673",3218,1568,1650
"1303060","Kalutara","Panadura","Henamulla","673A",3024,1469,1555
"1303065","Kalutara","Panadura","Wattalpola","674A",4273,2028,2245
"1303070","Kalutara","Panadura","Miriyawatta","672C",2497,1197,1300
"1303075","Kalutara","Panadura","Thotawatta","675",4809,2334,2475
"1303080","Kalutara","Panadura","Werawatta","674B",2494,1225,1269
"1303085","Kalutara","Panadura","Pallimulla","673B",2012,1021,991
"1303090","Kalutara","Panadura","Gorakapola","674",1998,961,1037
"1303095","Kalutara","Panadura","Walana North","679A",2954,1409,1545
"1303100","Kalutara","Panadura","Ambalanduwa","675A",3574,1699,1875
"1303105","Kalutara","Panadura","Galthude North","677A",1736,832,904
"1303110","Kalutara","Panadura","Galthude","677",1647,787,860
"1303115","Kalutara","Panadura","Hirana West","676A",4094,1957,2137
"1303120","Kalutara","Panadura","Hirana","676",2496,1195,1301
"1303125","Kalutara","Panadura","Thanthirimulla East","681A",1907,894,1013
"1303130","Kalutara","Panadura","Thanthirimulla","681",1357,636,721
"1303135","Kalutara","Panadura","Bekkegama","680",2947,1424,1523
"1303140","Kalutara","Panadura","Walana South","679B",2533,1063,1470
"1303145","Kalutara","Panadura","Walana","679",3488,1674,1814
"1303150","Kalutara","Panadura","Udahamulla","682",1731,831,900
"1303155","Kalutara","Panadura","Punchideniya","682C",1795,845,950
"1303160","Kalutara","Panadura","Malamulla West","684A",4772,2275,2497
"1303165","Kalutara","Panadura","Kiriberiya","684B",3720,1816,1904
"1303170","Kalutara","Panadura","Malamulla","684",3731,1777,1954
"1303175","Kalutara","Panadura","Kuruppumulla","682A",1638,765,873
"1303180","Kalutara","Panadura","Etambagoda","682B",2263,1015,1248
"1303185","Kalutara","Panadura","Pattiya North","685",1059,524,535
"1303190","Kalutara","Panadura","Bazaar North","685A",939,436,503
"1303195","Kalutara","Panadura","Sagara Place","685D",547,271,276
"1303200","Kalutara","Panadura","Bazaar West","685C",811,395,416
"1303205","Kalutara","Panadura","Bazaar","685B",602,294,308
"1303210","Kalutara","Panadura","Walapala Pattiya","683A",1771,874,897
"1303215","Kalutara","Panadura","Walapala","683",2596,1216,1380
"1303220","Kalutara","Panadura","Eluvila","687B",3495,1672,1823
"1303225","Kalutara","Panadura","Wekada East","687A",3071,1491,1580
"1303230","Kalutara","Panadura","Wekada North","687C",2753,1302,1451
"1303235","Kalutara","Panadura","Wekada West","687",2999,1430,1569
"1303240","Kalutara","Panadura","Pattiya","686B",1395,666,729
"1303245","Kalutara","Panadura","Uyankele","686A",1777,820,957
"1303250","Kalutara","Panadura","Pattiya South","686",1393,657,736
"1303255","Kalutara","Panadura","Kaludewala","689",2267,1065,1202
"1303260","Kalutara","Panadura","Kaludewala East","689B",3230,1496,1734
"1303265","Kalutara","Panadura","Moravinna","689A",3884,1829,2055
"1303270","Kalutara","Panadura","Nallooruwa North","692A",1978,915,1063
"1303275","Kalutara","Panadura","Nallooruwa","692",3014,1392,1622
"1303280","Kalutara","Panadura","Dibbedda","693",1506,717,789
"1303285","Kalutara","Panadura","Dibbedda North","693A",2938,1411,1527
"1303290","Kalutara","Panadura","Narampitiya","696A",2554,1189,1365
"1303295","Kalutara","Panadura","Pinwatta","696",3409,1614,1795
"1303300","Kalutara","Panadura","Pinwatta West","696B",2212,1011,1201
"1303305","Kalutara","Panadura","Thalpitiya North","697",2479,1189,1290
"1303310","Kalutara","Panadura","Thalpitiya South","697A",3362,1639,1723
"1303315","Kalutara","Panadura","Pallimankada","697B",2843,1320,1523
"1303320","Kalutara","Panadura","Wadduwa West","699",1392,662,730
"1303325","Kalutara","Panadura","Wadduwa East","698",2544,1215,1329
"1303330","Kalutara","Panadura","Maha Wadduwa","698A",3967,1948,2019
"1303335","Kalutara","Panadura","Pattieliya","702A",1080,508,572
"1303340","Kalutara","Panadura","Kuda Wadduwa","702",2122,968,1154
"1303345","Kalutara","Panadura","Wadduwa South","699A",1420,678,742
"1303350","Kalutara","Panadura","Molligoda","704",2040,987,1053
"1303355","Kalutara","Panadura","Molligoda North","704A",2464,1161,1303
"1303360","Kalutara","Panadura","Molligoda South","704B",2217,1098,1119
"1306005","Kalutara","Bandaragama","Kidelpitiya West","669",2161,1062,1099
"1306010","Kalutara","Bandaragama","Kidelpitiya East","669A",1805,829,976
"1306015","Kalutara","Bandaragama","Senapura","669C",2617,1308,1309
"1306020","Kalutara","Bandaragama","Newdawa","678B",3916,1886,2030
"1306025","Kalutara","Bandaragama","Aluthgama","668",2018,978,1040
"1306030","Kalutara","Bandaragama","Alothiyawa","668B",2446,1186,1260
"1306035","Kalutara","Bandaragama","Walgama North","667B",1669,817,852
"1306040","Kalutara","Bandaragama","Rerukana","667A",940,453,487
"1306045","Kalutara","Bandaragama","Samaranayakapura","667C",1060,526,534
"1306050","Kalutara","Bandaragama","Kothalawala","661A",2879,1431,1448
"1306055","Kalutara","Bandaragama","Veedagama East","664",1779,869,910
"1306060","Kalutara","Bandaragama","Walgama South","667D",1557,755,802
"1306065","Kalutara","Bandaragama","Gammanpila","667",2084,988,1096
"1306070","Kalutara","Bandaragama","Medagama","668A",1716,795,921
"1306075","Kalutara","Bandaragama","Alubomulla East","691",2813,1326,1487
"1306080","Kalutara","Bandaragama","Kuda Aruggoda East","678A",3235,1586,1649
"1306085","Kalutara","Bandaragama","Maha Aruggoda","678",3478,1657,1821
"1306090","Kalutara","Bandaragama","Kuda Aruggoda West","678C",2168,1058,1110
"1306095","Kalutara","Bandaragama","Batadombathuduwa","691B",3648,1724,1924
"1306100","Kalutara","Bandaragama","Miriswatta","690B",1322,636,686
"1306105","Kalutara","Bandaragama","Wanduramulla West","688B",1299,649,650
"1306110","Kalutara","Bandaragama","Pinwala East","688",1470,717,753
"1306115","Kalutara","Bandaragama","Pinwala West","688A",1654,795,859
"1306120","Kalutara","Bandaragama","Wanduramulla East","688C",2051,965,1086
"1306125","Kalutara","Bandaragama","Mahavila","690",2606,1223,1383
"1306130","Kalutara","Bandaragama","Pamunugama","694",1934,888,1046
"1306135","Kalutara","Bandaragama","Alubomulla West","691A",3158,1513,1645
"1306140","Kalutara","Bandaragama","Rambukkana North","665",1152,571,581
"1306145","Kalutara","Bandaragama","Kamburugoda West","666A",1232,585,647
"1306150","Kalutara","Bandaragama","Kamburugoda East","666",773,382,391
"1306155","Kalutara","Bandaragama","Veedagama West","664A",1881,895,986
"1306160","Kalutara","Bandaragama","Gelanigama","661",837,428,409
"1306165","Kalutara","Bandaragama","Raigama South","656",1122,570,552
"1306170","Kalutara","Bandaragama","Raigama West","656C",1350,638,712
"1306175","Kalutara","Bandaragama","Raigama East","656B",1779,826,953
"1306180","Kalutara","Bandaragama","Raigama North","656A",1789,837,952
"1306185","Kalutara","Bandaragama","Kolamediriya North","657A",1133,526,607
"1306190","Kalutara","Bandaragama","Bandaragama East","663A",1609,770,839
"1306195","Kalutara","Bandaragama","Bandaragama","663",894,440,454
"1306200","Kalutara","Bandaragama","Rambukkana South","665A",1093,527,566
"1306205","Kalutara","Bandaragama","Bolgoda","665B",1194,588,606
"1306210","Kalutara","Bandaragama","Mahabellana","695",1994,948,1046
"1306215","Kalutara","Bandaragama","Imbulliha","694A",2217,1077,1140
"1306220","Kalutara","Bandaragama","Diganathuduwa","694B",2479,1182,1297
"1306225","Kalutara","Bandaragama","Madupitiya","690A",2992,1452,1540
"1306230","Kalutara","Bandaragama","Mahawatta","695A",1701,819,882
"1306235","Kalutara","Bandaragama","Bandaragama West","663B",1895,923,972
"1306240","Kalutara","Bandaragama","Yatiyana","662A",1906,919,987
"1306245","Kalutara","Bandaragama","Wevita","662",1760,844,916
"1306250","Kalutara","Bandaragama","Atulugama East","659",2156,1104,1052
"1306255","Kalutara","Bandaragama","Panape","657",834,398,436
"1306260","Kalutara","Bandaragama","Galgemandiya","659D",1806,928,878
"1306265","Kalutara","Bandaragama","Atulugama West","659A",1913,980,933
"1306270","Kalutara","Bandaragama","Bamunumulla (Muslim)","659C",1165,586,579
"1306275","Kalutara","Bandaragama","Bamunumulla","660",625,307,318
"1306280","Kalutara","Bandaragama","Epitamulla","660A",1000,476,524
"1306285","Kalutara","Bandaragama","Korawala","659B",2325,1228,1097
"1306290","Kalutara","Bandaragama","Bogahawatta","659E",2198,1098,1100
"1306295","Kalutara","Bandaragama","Kimmanthudawa","658",949,487,462
"1309005","Kalutara","Horana","Kotigamgoda","628B",2108,1014,1094
"1309010","Kalutara","Horana","Pahala Millewa North","628C",1847,911,936
"1309015","Kalutara","Horana","Pahala Millewa South","628",1497,729,768
"1309020","Kalutara","Horana","Ihala Millewa North","628A",1406,713,693
"1309025","Kalutara","Horana","Ihala Millewa South","628D",2885,1368,1517
"1309030","Kalutara","Horana","Thalagala East","613C",2535,1241,1294
"1309035","Kalutara","Horana","Thalagala North","613",3981,1943,2038
"1309040","Kalutara","Horana","Thalagala West","613B",2931,1421,1510
"1309045","Kalutara","Horana","Olaboduwa North","605B",1702,841,861
"1309050","Kalutara","Horana","Koralaima","604A",3479,1705,1774
"1309055","Kalutara","Horana","Godigamuwa East","606B",2578,1306,1272
"1309060","Kalutara","Horana","Halapitiya","606C",2650,1286,1364
"1309065","Kalutara","Horana","Welmilla","606A",1889,923,966
"1309070","Kalutara","Horana","Godigamuwa West","606",1739,836,903
"1309075","Kalutara","Horana","Palannoruwa","604",3009,1406,1603
"1309080","Kalutara","Horana","Olaboduwa South","605",1779,862,917
"1309085","Kalutara","Horana","Olaboduwa East","605A",1491,722,769
"1309090","Kalutara","Horana","Thalagala South","613A",2861,1382,1479
"1309095","Kalutara","Horana","Pannila","612B",1667,808,859
"1309100","Kalutara","Horana","Kahatapitiya","612",2331,1122,1209
"1309105","Kalutara","Horana","Uduwa North","614",1836,894,942
"1309110","Kalutara","Horana","Kidelpitiya","629",2137,1061,1076
"1309115","Kalutara","Horana","Gorokgoda","630A",527,248,279
"1309120","Kalutara","Horana","Dambara","630",1734,875,859
"1309125","Kalutara","Horana","Handupelpola","631",1557,753,804
"1309130","Kalutara","Horana","Kuda Uduwa","614C",1670,829,841
"1309135","Kalutara","Horana","Maha Uduwa","614B",1884,951,933
"1309140","Kalutara","Horana","Kananvila North","612A",1575,778,797
"1309145","Kalutara","Horana","Batuvita North","611",976,457,519
"1309150","Kalutara","Horana","Kumbuka East","607",1692,814,878
"1309155","Kalutara","Horana","Kumbuka South","607B",1140,581,559
"1309160","Kalutara","Horana","Kumbuka North","607C",1978,932,1046
"1309165","Kalutara","Horana","Kumbuka West","607A",2105,1036,1069
"1309170","Kalutara","Horana","Pokunuvita","608",2144,1027,1117
"1309175","Kalutara","Horana","Batuvita South","611B",1478,736,742
"1309180","Kalutara","Horana","Meemana","611A",2157,1028,1129
"1309185","Kalutara","Horana","Kananvila South","612C",722,349,373
"1309190","Kalutara","Horana","Uduwa South","614A",1828,870,958
"1309195","Kalutara","Horana","Kirigalahena","617C",1213,590,623
"1309200","Kalutara","Horana","Meewanapalana West","617B",1571,731,840
"1309205","Kalutara","Horana","Meewanapalana East","617",958,432,526
"1309210","Kalutara","Horana","Gurugoda","617A",1760,816,944
"1309215","Kalutara","Horana","Munagama East","616D",1472,681,791
"1309220","Kalutara","Horana","Midellamulahena","616E",2859,1425,1434
"1309225","Kalutara","Horana","Ovitiyagala","616A",1359,655,704
"1309230","Kalutara","Horana","Aramanagolla","610A",2582,1235,1347
"1309235","Kalutara","Horana","Werullahena","610B",836,413,423
"1309240","Kalutara","Horana","Kulupana","610",987,470,517
"1309245","Kalutara","Horana","Kanewala","609",1750,823,927
"1309250","Kalutara","Horana","Henegama","609A",2188,1043,1145
"1309255","Kalutara","Horana","Gal Edandugoda","615C",1153,550,603
"1309260","Kalutara","Horana","Horana North","615",2149,1066,1083
"1309265","Kalutara","Horana","Munagama West","616",1129,527,602
"1309270","Kalutara","Horana","Dikhenagama","616B",1590,776,814
"1309275","Kalutara","Horana","Narthanagala","616C",2903,1362,1541
"1309280","Kalutara","Horana","Horana South","615A",1334,669,665
"1309285","Kalutara","Horana","Wewala West","615F",1290,598,692
"1309290","Kalutara","Horana","Halthotiyawatta","615D",1233,603,630
"1309295","Kalutara","Horana","Mahena","615B",1910,924,986
"1309300","Kalutara","Horana","Wewala East","615G",2012,993,1019
"1309305","Kalutara","Horana","Horana East","615E",1621,659,962
"1310005","Kalutara","Ingiriya","Menerigama","625A",1364,677,687
"1310010","Kalutara","Ingiriya","Arakavila","625",2176,1048,1128
"1310015","Kalutara","Ingiriya","Kandanapitiya","626",1679,828,851
"1310020","Kalutara","Ingiriya","Kottiyawatta","626A",1106,566,540
"1310025","Kalutara","Ingiriya","Kurana North","627B",886,435,451
"1310030","Kalutara","Ingiriya","Kurana South","627",1485,763,722
"1310035","Kalutara","Ingiriya","Kotigala","627A",838,394,444
"1310040","Kalutara","Ingiriya","Handapangoda East","623A",1122,527,595
"1310045","Kalutara","Ingiriya","Handapangoda West","623B",1243,600,643
"1310050","Kalutara","Ingiriya","Kekuladola","624A",461,217,244
"1310055","Kalutara","Ingiriya","Handapangoda South","623",1313,616,697
"1310060","Kalutara","Ingiriya","Batugampala","624",1431,699,732
"1310065","Kalutara","Ingiriya","Raigam Watta","620B",2336,1136,1200
"1310070","Kalutara","Ingiriya","Maha Ingiriya","620G",3321,1662,1659
"1310075","Kalutara","Ingiriya","Nambapana","619A",1205,590,615
"1310080","Kalutara","Ingiriya","Urugala East","619",1833,899,934
"1310085","Kalutara","Ingiriya","Ingiriya East","620",1395,695,700
"1310090","Kalutara","Ingiriya","Ingiriya North","620C",2658,1310,1348
"1310095","Kalutara","Ingiriya","Nimalagama","620D",3433,1698,1735
"1310100","Kalutara","Ingiriya","Eduragala","620E",1308,631,677
"1310105","Kalutara","Ingiriya","Maputugala","621",2106,1008,1098
"1310110","Kalutara","Ingiriya","Pelpitigoda","622",2044,1001,1043
"1310115","Kalutara","Ingiriya","Rathmalgoda East","621A",1213,585,628
"1310120","Kalutara","Ingiriya","Rathmalgoda West","621B",1805,869,936
"1310125","Kalutara","Ingiriya","Poruwadanda West","618C",3094,1481,1613
"1310130","Kalutara","Ingiriya","Poruwadanda East","618A",3147,1614,1533
"1310135","Kalutara","Ingiriya","Wagawatta","618",1883,921,962
"1310140","Kalutara","Ingiriya","Kekulaliya","618B",806,424,382
"1310145","Kalutara","Ingiriya","Dombagaskanda","620F",1737,861,876
"1310150","Kalutara","Ingiriya","Ingiriya West","620A",1900,907,993
"1310155","Kalutara","Ingiriya","Urugala West","619B",1568,761,807
"1312005","Kalutara","Bulathsinhala","Ihala Naragala","813A",1293,596,697
"1312010","Kalutara","Bulathsinhala","Kobawaka North","813",1492,719,773
"1312015","Kalutara","Bulathsinhala","Diwalakada","822B",985,482,503
"1312020","Kalutara","Bulathsinhala","Meegahakumbura","822E",660,322,338
"1312025","Kalutara","Bulathsinhala","Yahalawatta","822D",691,330,361
"1312030","Kalutara","Bulathsinhala","Bothale Gamgoda","822C",648,315,333
"1312035","Kalutara","Bulathsinhala","Kongasthenna","822F",2842,1345,1497
"1312040","Kalutara","Bulathsinhala","Halwathura","822A",1061,517,544
"1312045","Kalutara","Bulathsinhala","Amaragedara North","821E",755,367,388
"1312050","Kalutara","Bulathsinhala","Bothale","822",596,299,297
"1312055","Kalutara","Bulathsinhala","Bulathsinhala North","821",1111,532,579
"1312060","Kalutara","Bulathsinhala","Egaloya","821D",2141,1061,1080
"1312065","Kalutara","Bulathsinhala","Kobawaka South","813B",1622,788,834
"1312070","Kalutara","Bulathsinhala","Ihala Naragala South","813C",1111,556,555
"1312075","Kalutara","Bulathsinhala","Govinna North","814",881,424,457
"1312080","Kalutara","Bulathsinhala","Pahala Naragala","812A",1317,630,687
"1312085","Kalutara","Bulathsinhala","Dewamulla","812",1591,768,823
"1312090","Kalutara","Bulathsinhala","Govinna South","814B",1837,901,936
"1312095","Kalutara","Bulathsinhala","Retiyala","814A",1759,897,862
"1312100","Kalutara","Bulathsinhala","Galahena","824H",2161,1029,1132
"1312105","Kalutara","Bulathsinhala","Bulathsinhala South","821B",1108,545,563
"1312110","Kalutara","Bulathsinhala","Bulathsinhala","824B",2147,1071,1076
"1312115","Kalutara","Bulathsinhala","Bulathsinhala Central","821F",893,431,462
"1312120","Kalutara","Bulathsinhala","Amaragedara South","821C",1339,670,669
"1312125","Kalutara","Bulathsinhala","Delmella","821A",1596,778,818
"1312130","Kalutara","Bulathsinhala","Udugalakanda","821G",1123,553,570
"1312135","Kalutara","Bulathsinhala","Niggaha","823A",1051,544,507
"1312140","Kalutara","Bulathsinhala","Yatagampitiya","823",1202,583,619
"1312145","Kalutara","Bulathsinhala","Karaldekma","824F",1427,719,708
"1312150","Kalutara","Bulathsinhala","Bulathsinhala East","824E",1281,601,680
"1312155","Kalutara","Bulathsinhala","Damparadugoda","824C",584,284,300
"1312160","Kalutara","Bulathsinhala","Pahala Welgama","824",834,437,397
"1312165","Kalutara","Bulathsinhala","Bulathsinhala West","824G",1488,701,787
"1312170","Kalutara","Bulathsinhala","Diyakaduwa  East","820",849,410,439
"1312175","Kalutara","Bulathsinhala","Diyakaduwa  West","820A",840,408,432
"1312180","Kalutara","Bulathsinhala","Bogahawatta","819D",757,349,408
"1312185","Kalutara","Bulathsinhala","Mahagama North","819",850,409,441
"1312190","Kalutara","Bulathsinhala","Demodarawatta","819E",1516,715,801
"1312195","Kalutara","Bulathsinhala","Thennahena","824D",789,398,391
"1312200","Kalutara","Bulathsinhala","Ihala Welgama","824A",1299,621,678
"1312205","Kalutara","Bulathsinhala","Paragoda West","825C",1057,527,530
"1312210","Kalutara","Bulathsinhala","Paragoda East","825A",953,458,495
"1312215","Kalutara","Bulathsinhala","Molkawa","825",823,394,429
"1312220","Kalutara","Bulathsinhala","Galahitiya","825B",691,355,336
"1312225","Kalutara","Bulathsinhala","Mahagama East","819B",916,419,497
"1312230","Kalutara","Bulathsinhala","Polegoda West","819F",1131,521,610
"1312235","Kalutara","Bulathsinhala","Mahagama West","819C",1163,545,618
"1312240","Kalutara","Bulathsinhala","Pahala Kudaligama","817A",1306,613,693
"1312245","Kalutara","Bulathsinhala","Ihala Kudaligama","817",1513,743,770
"1312250","Kalutara","Bulathsinhala","Weyangalla West","818A",1515,691,824
"1312255","Kalutara","Bulathsinhala","Weyangalla East","818",1028,462,566
"1312260","Kalutara","Bulathsinhala","Mahagama South","819A",877,446,431
"1312265","Kalutara","Bulathsinhala","Muduna","819G",1288,619,669
"1312270","Kalutara","Bulathsinhala","Gamagewatta","819H",812,378,434
"1315005","Kalutara","Madurawala","Ilimba","632A",1609,766,843
"1315010","Kalutara","Madurawala","Kandana North","632",618,294,324
"1315015","Kalutara","Madurawala","Kandana South","632B",890,402,488
"1315020","Kalutara","Madurawala","Elawella","650E",2117,1023,1094
"1315025","Kalutara","Madurawala","Bellapitiya West","650B",952,455,497
"1315030","Kalutara","Madurawala","Mahena South","650F",1639,764,875
"1315035","Kalutara","Madurawala","Bellapitiya East","650A",1798,884,914
"1315040","Kalutara","Madurawala","Walpita","633B",1624,790,834
"1315045","Kalutara","Madurawala","Werawatta","633",630,304,326
"1315050","Kalutara","Madurawala","Peramunagama","650C",1153,569,584
"1315055","Kalutara","Madurawala","Weliketella","650D",1021,493,528
"1315060","Kalutara","Madurawala","Remuna","650",1066,495,571
"1315065","Kalutara","Madurawala","Mahayala East","634",591,278,313
"1315070","Kalutara","Madurawala","Kananvila","633A",733,353,380
"1315075","Kalutara","Madurawala","Mahayala West","634A",863,418,445
"1315080","Kalutara","Madurawala","Hallankanda","648B",452,222,230
"1315085","Kalutara","Madurawala","Koodella","648A",1093,564,529
"1315090","Kalutara","Madurawala","Madurawala East","635",727,357,370
"1315095","Kalutara","Madurawala","Kudayala","636",1151,583,568
"1315100","Kalutara","Madurawala","Pahala Karannagoda","811A",775,369,406
"1315105","Kalutara","Madurawala","Anguruwathota","637",1391,706,685
"1315110","Kalutara","Madurawala","Madurawala West","635A",741,333,408
"1315115","Kalutara","Madurawala","Keselhenawa","648",1220,587,633
"1315120","Kalutara","Madurawala","Karannagoda","811",1036,517,519
"1315125","Kalutara","Madurawala","Ihala Karannagoda","811B",715,343,372
"1315130","Kalutara","Madurawala","Katuhena","815A",684,324,360
"1315135","Kalutara","Madurawala","Warakagoda North","816B",1246,614,632
"1315140","Kalutara","Madurawala","Warakagoda West","816A",1099,550,549
"1315145","Kalutara","Madurawala","Warakagoda South","816C",1505,743,762
"1315150","Kalutara","Madurawala","Warakagoda East","816",1186,564,622
"1315155","Kalutara","Madurawala","Nahalla","815",710,321,389
"1315160","Kalutara","Madurawala","Pahalagoda","815B",583,284,299
"1315165","Kalutara","Madurawala","Ihalagoda","815C",763,360,403
"1318005","Kalutara","Millaniya","Gungamuwa","655",1825,882,943
"1318010","Kalutara","Millaniya","Bellanthudawa","655A",2346,1145,1201
"1318015","Kalutara","Millaniya","Kelesgamuwa","647B",1233,606,627
"1318020","Kalutara","Millaniya","Welikala","654",2811,1401,1410
"1318025","Kalutara","Millaniya","Thibbotugoda","654A",1000,489,511
"1318030","Kalutara","Millaniya","Lenawara","647A",2296,1126,1170
"1318035","Kalutara","Millaniya","Halthota","647",837,413,424
"1318040","Kalutara","Millaniya","Langana","646",928,450,478
"1318045","Kalutara","Millaniya","Deldorawatta","645B",925,459,466
"1318050","Kalutara","Millaniya","Millaniya","645",1503,707,796
"1318055","Kalutara","Millaniya","Raddegoda","644C",1091,511,580
"1318060","Kalutara","Millaniya","Delkada","644A",1164,589,575
"1318065","Kalutara","Millaniya","Paragasthota","644",1619,791,828
"1318070","Kalutara","Millaniya","Dikhena","644B",1938,952,986
"1318075","Kalutara","Millaniya","Arakagoda","645A",1038,486,552
"1318080","Kalutara","Millaniya","Kennanthudawa","652",948,452,496
"1318085","Kalutara","Millaniya","Mawathgama","646A",746,362,384
"1318090","Kalutara","Millaniya","Yalagala","651",1196,563,633
"1318095","Kalutara","Millaniya","Labugama","653",1106,518,588
"1318100","Kalutara","Millaniya","Pethigamuwa North","653B",742,381,361
"1318105","Kalutara","Millaniya","Pethigamuwa South","653A",1072,535,537
"1318110","Kalutara","Millaniya","Weniwelpitiya","651A",1308,628,680
"1318115","Kalutara","Millaniya","Millagaspola","651B",512,248,264
"1318120","Kalutara","Millaniya","Boralessa","652A",1569,761,808
"1318125","Kalutara","Millaniya","Pelpola","643",1353,641,712
"1318130","Kalutara","Millaniya","Imbulahena","643B",1698,844,854
"1318135","Kalutara","Millaniya","Punsiripura","643A",1841,909,932
"1318140","Kalutara","Millaniya","Galpatha West","642A",972,436,536
"1318145","Kalutara","Millaniya","Galpatha East","642",966,474,492
"1318150","Kalutara","Millaniya","Batagoda","649",1133,567,566
"1318155","Kalutara","Millaniya","Mulkadakanda","649B",1037,501,536
"1318160","Kalutara","Millaniya","Adhikarigoda","649C",1087,533,554
"1318165","Kalutara","Millaniya","Dombagoda","649A",1189,573,616
"1318170","Kalutara","Millaniya","Uduwara North","638B",2169,1041,1128
"1318175","Kalutara","Millaniya","Uduwara West","638",573,279,294
"1318180","Kalutara","Millaniya","Uduwara East","638A",1271,601,670
"1318185","Kalutara","Millaniya","Uduwara South","638C",647,321,326
"1318190","Kalutara","Millaniya","Pathakada","639",1281,595,686
"1318195","Kalutara","Millaniya","Panagoda","641",803,391,412
"1318200","Kalutara","Millaniya","Yatawara South","640A",297,141,156
"1318205","Kalutara","Millaniya","Mahadurupitiya","639B",715,362,353
"1318210","Kalutara","Millaniya","Delgoda","639A",426,216,210
"1318215","Kalutara","Millaniya","Yatawara North","640",467,222,245
"1318220","Kalutara","Millaniya","Begamuwa Thalahitiya","640B",498,243,255
"1321005","Kalutara","Kalutara","Mestiya","700",924,444,480
"1321010","Kalutara","Kalutara","Maha Gonadoowa","701",2200,1078,1122
"1321015","Kalutara","Kalutara","Kuda Gonadoowa","701A",1386,674,712
"1321020","Kalutara","Kalutara","Moronthuduwa North","706",992,478,514
"1321025","Kalutara","Kalutara","Mawala","705B",1710,822,888
"1321030","Kalutara","Kalutara","Melegama North","703",1084,528,556
"1321035","Kalutara","Kalutara","Melegama South","703B",1841,853,988
"1321040","Kalutara","Kalutara","Habaralagahalanda","703A",3118,1499,1619
"1321045","Kalutara","Kalutara","Pohoddaramulla West","707A",1013,491,522
"1321050","Kalutara","Kalutara","Pohoddaramulla East","707",2568,1248,1320
"1321055","Kalutara","Kalutara","Pothupitiya East","708B",2005,990,1015
"1321060","Kalutara","Kalutara","Mawala South","705A",1191,567,624
"1321065","Kalutara","Kalutara","Maharekma","705",1525,758,767
"1321070","Kalutara","Kalutara","Nandoowa","706A",914,441,473
"1321075","Kalutara","Kalutara","Moronthuduwa South","706B",2685,1312,1373
"1321080","Kalutara","Kalutara","Kalapugama","709",1485,713,772
"1321085","Kalutara","Kalutara","Kalapugama West","709C",1714,802,912
"1321090","Kalutara","Kalutara","Ariyagama","709D",2123,1038,1085
"1321095","Kalutara","Kalutara","Deldoowa","709A",2258,1101,1157
"1321100","Kalutara","Kalutara","Nugagoda","709B",2356,1160,1196
"1321105","Kalutara","Kalutara","Pothupitiya South","708A",1554,760,794
"1321110","Kalutara","Kalutara","Pothupitiya North","708",1296,648,648
"1321115","Kalutara","Kalutara","Pothupitiya West","708C",1474,725,749
"1321120","Kalutara","Kalutara","Meda Pothupitiya","708D",1232,583,649
"1321125","Kalutara","Kalutara","Kuda Waskaduwa West","710B",2022,1041,981
"1321130","Kalutara","Kalutara","Kuda Waskaduwa North","710",2380,1123,1257
"1321135","Kalutara","Kalutara","Kuda Waskaduwa East","710C",1597,788,809
"1321140","Kalutara","Kalutara","Kapuhena","715A",677,320,357
"1321145","Kalutara","Kalutara","Usgodella","711C",1638,762,876
"1321150","Kalutara","Kalutara","Panapitiya North","711B",1217,571,646
"1321155","Kalutara","Kalutara","Paraduwa","712",902,409,493
"1321160","Kalutara","Kalutara","Dodammulla","713A",774,386,388
"1321165","Kalutara","Kalutara","Diyagama","713",991,501,490
"1321170","Kalutara","Kalutara","Panapitiya South","711",1185,579,606
"1321175","Kalutara","Kalutara","Rannungala","711A",1300,645,655
"1321180","Kalutara","Kalutara","Uggalbada West","716A",1990,958,1032
"1321185","Kalutara","Kalutara","Dediyawala","715",2636,1276,1360
"1321190","Kalutara","Kalutara","Kuda Waskaduwa South","710A",2376,1133,1243
"1321195","Kalutara","Kalutara","Mahawaskaduwa South","714",2739,1313,1426
"1321200","Kalutara","Kalutara","Mahawaskaduwa North","714A",1525,715,810
"1321205","Kalutara","Kalutara","Vilegoda North","718C",2574,961,1613
"1321210","Kalutara","Kalutara","Malwatta","718D",910,449,461
"1321215","Kalutara","Kalutara","Wijerathnawatta","716B",2843,1765,1078
"1321220","Kalutara","Kalutara","Uggalbada East","716",1444,670,774
"1321225","Kalutara","Kalutara","Thekkawatta","723F",3828,1866,1962
"1321230","Kalutara","Kalutara","Jawatta","718A",1532,743,789
"1321235","Kalutara","Kalutara","Botnikwatta","718B",1558,733,825
"1321240","Kalutara","Kalutara","Kalutara North","717",2580,1261,1319
"1321245","Kalutara","Kalutara","Deshasthra Kalutara","717A",2138,976,1162
"1321250","Kalutara","Kalutara","Deshasthra Kalutara West","717D",1957,950,1007
"1321255","Kalutara","Kalutara","Vidyasara","717C",2226,1045,1181
"1321260","Kalutara","Kalutara","Thotupala","717B",1441,677,764
"1321265","Kalutara","Kalutara","Ethanamadala","718",2617,1242,1375
"1321270","Kalutara","Kalutara","Palathota","723E",1477,677,800
"1321275","Kalutara","Kalutara","Welapura","725B",1628,744,884
"1321280","Kalutara","Kalutara","Kalutara South","725",1721,833,888
"1321285","Kalutara","Kalutara","Kuda Heenatiyangala","727B",2495,1263,1232
"1321290","Kalutara","Kalutara","Ilukwatta","723B",2049,965,1084
"1321295","Kalutara","Kalutara","Vilegoda South","723D",906,448,458
"1321300","Kalutara","Kalutara","Godaparagahahena","723C",978,461,517
"1321305","Kalutara","Kalutara","Kithulawa","723",3314,1668,1646
"1321310","Kalutara","Kalutara","Alwiswatta","723A",976,467,509
"1321315","Kalutara","Kalutara","Etavila","727A",2261,1082,1179
"1321320","Kalutara","Kalutara","Akkaragoda","727E",1657,828,829
"1321325","Kalutara","Kalutara","Mahawatta","727",2131,1015,1116
"1321330","Kalutara","Kalutara","Kalutara South A","725A",1522,720,802
"1321335","Kalutara","Kalutara","Kalapuwa","730A",1632,794,838
"1321340","Kalutara","Kalutara","Wettumakada","730",2051,1022,1029
"1321345","Kalutara","Kalutara","Kurunduwatta","727C",2436,1155,1281
"1321350","Kalutara","Kalutara","Maha Heenatiyangala","727D",3295,1574,1721
"1321355","Kalutara","Kalutara","Wattamulla","727F",2116,1017,1099
"1321360","Kalutara","Kalutara","Alubogahalanda","729A",2390,1153,1237
"1321365","Kalutara","Kalutara","Rajawatta Aluth Kotasa","729G",514,266,248
"1321370","Kalutara","Kalutara","Rajawatta Parana Kotasa","729H",1018,507,511
"1321375","Kalutara","Kalutara","Pulartan","729C",3741,2027,1714
"1321380","Kalutara","Kalutara","Uswatta","729F",1813,812,1001
"1321385","Kalutara","Kalutara","Katukurunda","730B",1361,644,717
"1321390","Kalutara","Kalutara","Kalamulla North","731",1993,946,1047
"1321395","Kalutara","Kalutara","Nagoda West","729B",3441,1619,1822
"1321400","Kalutara","Kalutara","Kajudoowawatta","729E",1894,914,980
"1321405","Kalutara","Kalutara","Nagoda South","729",3179,1536,1643
"1321410","Kalutara","Kalutara","Weniwelketiya","729I",2438,1205,1233
"1321415","Kalutara","Kalutara","Gallassa","729D",1414,698,716
"1321420","Kalutara","Kalutara","Kalamulla East","731B",1209,529,680
"1321425","Kalutara","Kalutara","Kalamulla South","731A",1543,723,820
"1321430","Kalutara","Kalutara","Ethagama West","732A",966,466,500
"1321435","Kalutara","Kalutara","Ethagama East","732",1893,918,975
"1324005","Kalutara","Beruwala","Kuda Payagala North","734",1884,869,1015
"1324010","Kalutara","Beruwala","Mehimulla","733B",1334,650,684
"1324015","Kalutara","Beruwala","Pambe","733A",1437,723,714
"1324020","Kalutara","Beruwala","Hirigalgodella","737A",2083,1034,1049
"1324025","Kalutara","Beruwala","Malegoda","733",2847,1391,1456
"1324030","Kalutara","Beruwala","Kuda Payagala South","734A",1217,599,618
"1324035","Kalutara","Beruwala","Payagala North","735A",2206,1079,1127
"1324040","Kalutara","Beruwala","Pinidiyamulla","736",2029,982,1047
"1324045","Kalutara","Beruwala","Viharakanda","737",1125,553,572
"1324050","Kalutara","Beruwala","Palayangoda","738",1879,887,992
"1324055","Kalutara","Beruwala","Weragala","738A",2504,1249,1255
"1324060","Kalutara","Beruwala","Katukurundugahalanda East","738B",2017,1009,1008
"1324065","Kalutara","Beruwala","Katukurundugahalanda West","740B",991,470,521
"1324070","Kalutara","Beruwala","Pothuvila East","740",1717,829,888
"1324075","Kalutara","Beruwala","Mahagammedda","739",1940,890,1050
"1324080","Kalutara","Beruwala","Maha Payagala","735",1116,518,598
"1324085","Kalutara","Beruwala","Pothuvila West","740A",1186,574,612
"1324090","Kalutara","Beruwala","Munasinghagoda","741A",1354,672,682
"1324095","Kalutara","Beruwala","Diyalagoda","741",2424,1135,1289
"1324100","Kalutara","Beruwala","Kapugoda","741B",1679,903,776
"1324105","Kalutara","Beruwala","Halkandavila","744",1647,808,839
"1324110","Kalutara","Beruwala","Yovungama","744B",1023,503,520
"1324115","Kalutara","Beruwala","Doowegoda","744A",2030,1002,1028
"1324120","Kalutara","Beruwala","Kendagahavila","744C",1827,918,909
"1324125","Kalutara","Beruwala","Munhena","745",2603,1288,1315
"1324130","Kalutara","Beruwala","Maggona East","743",3045,1475,1570
"1324135","Kalutara","Beruwala","Akkaramale","743A",2641,1302,1339
"1324140","Kalutara","Beruwala","Maggona West","742",1188,573,615
"1324145","Kalutara","Beruwala","Idiriligoda","746",1411,666,745
"1324150","Kalutara","Beruwala","Kuda Magalkanda","746A",681,329,352
"1324155","Kalutara","Beruwala","Magalkanda North","746C",1045,520,525
"1324160","Kalutara","Beruwala","Magalkanda South","746B",2015,999,1016
"1324165","Kalutara","Beruwala","Akkara Asoowa","745B",1421,725,696
"1324170","Kalutara","Beruwala","Bubulalanda","747B",1439,723,716
"1324175","Kalutara","Beruwala","Kadurugasmulla","745A",1965,997,968
"1324180","Kalutara","Beruwala","Bandanagoda","750A",1364,662,702
"1324185","Kalutara","Beruwala","Kalavilakanda","750B",1176,575,601
"1324190","Kalutara","Beruwala","Walathara","750",3267,1631,1636
"1324195","Kalutara","Beruwala","Pannila","752A",1413,701,712
"1324200","Kalutara","Beruwala","Cheenakotuwa","751A",3602,1797,1805
"1324205","Kalutara","Beruwala","Akkaragoda","751",3259,1695,1564
"1324210","Kalutara","Beruwala","Karandagoda","747",1234,577,657
"1324215","Kalutara","Beruwala","Marakkalahawatta","747A",3937,1959,1978
"1324220","Kalutara","Beruwala","Polkotuwa","748",3383,1661,1722
"1324225","Kalutara","Beruwala","Paranakade","753",1329,682,647
"1324230","Kalutara","Beruwala","Maradana","754",7297,3461,3836
"1324235","Kalutara","Beruwala","Hettiyakanda","753A",2753,1337,1416
"1324240","Kalutara","Beruwala","Massalgoda","757",1939,930,1009
"1324245","Kalutara","Beruwala","Kankanamgoda","749",5833,2864,2969
"1324250","Kalutara","Beruwala","Ambepitiya","752",4235,2210,2025
"1324255","Kalutara","Beruwala","Pinhena","759",1495,739,756
"1324260","Kalutara","Beruwala","Pinhena Colony","759B",1031,511,520
"1324265","Kalutara","Beruwala","Kalavila","767",2129,1048,1081
"1324270","Kalutara","Beruwala","Malewangoda","768B",1433,713,720
"1324275","Kalutara","Beruwala","Padagoda","768",1461,720,741
"1324280","Kalutara","Beruwala","Hettimulla","758",1885,915,970
"1324285","Kalutara","Beruwala","Mahagoda","755",5910,2973,2937
"1324290","Kalutara","Beruwala","Maligahena","756",2488,1199,1289
"1324295","Kalutara","Beruwala","Moragalla","760",2916,1484,1432
"1324300","Kalutara","Beruwala","Mullapitiya","761",1319,636,683
"1324305","Kalutara","Beruwala","Gammedda","762B",1235,623,612
"1324310","Kalutara","Beruwala","Kaluwamodara North","762A",1201,616,585
"1324315","Kalutara","Beruwala","Galhena","759A",1279,611,668
"1324320","Kalutara","Beruwala","Alakadupitiya","766B",1951,911,1040
"1324325","Kalutara","Beruwala","Welipitiya","768A",2598,1274,1324
"1324330","Kalutara","Beruwala","Pathirajagoda","766C",775,371,404
"1324335","Kalutara","Beruwala","Kadiyawatta","766D",1224,426,798
"1324340","Kalutara","Beruwala","Malewana","766F",2442,1155,1287
"1324345","Kalutara","Beruwala","Adikarigoda","766G",1213,576,637
"1324350","Kalutara","Beruwala","Nakandalagoda","770A",1494,734,760
"1324355","Kalutara","Beruwala","Danwattagoda","770B",473,229,244
"1324360","Kalutara","Beruwala","Kotapitiya","770",692,327,365
"1324365","Kalutara","Beruwala","Warapitiya","769",3080,1483,1597
"1324370","Kalutara","Beruwala","Dharga Town East","766A",2264,1163,1101
"1324375","Kalutara","Beruwala","Ganga Addara","766E",2176,1023,1153
"1324380","Kalutara","Beruwala","Dharga Town","766",2758,1279,1479
"1324385","Kalutara","Beruwala","Kaluwamodara East","762C",1362,641,721
"1324390","Kalutara","Beruwala","Kaluwamodara West","762",1837,856,981
"1324395","Kalutara","Beruwala","Ganegama","763",1374,672,702
"1324400","Kalutara","Beruwala","Seenawatta","765A",2144,979,1165
"1324405","Kalutara","Beruwala","Aluthgama East","765",1401,661,740
"1324410","Kalutara","Beruwala","Aluthgama West","764",958,465,493
"1327005","Kalutara","Dodangoda","Koholana North","719B",739,347,392
"1327010","Kalutara","Dodangoda","Ukwatta","720",628,285,343
"1327015","Kalutara","Dodangoda","Bolossagama","721",903,436,467
"1327020","Kalutara","Dodangoda","Remunagoda North","726A",801,400,401
"1327025","Kalutara","Dodangoda","Pelapitiyagoda","810",1128,527,601
"1327030","Kalutara","Dodangoda","Pelapitiyagoda North","810A",1170,591,579
"1327035","Kalutara","Dodangoda","Pahala Nebada","807B",1490,717,773
"1327040","Kalutara","Dodangoda","Nebada","807",1217,593,624
"1327045","Kalutara","Dodangoda","Nebada West","807C",483,252,231
"1327050","Kalutara","Dodangoda","Thebuwana East","809",2162,1069,1093
"1327055","Kalutara","Dodangoda","Thebuwana West","809A",1255,612,643
"1327060","Kalutara","Dodangoda","Remunagoda South","726",702,332,370
"1327065","Kalutara","Dodangoda","Gamagoda East","724",1468,698,770
"1327070","Kalutara","Dodangoda","Serupita East","722A",1483,722,761
"1327075","Kalutara","Dodangoda","Serupita West","722",799,391,408
"1327080","Kalutara","Dodangoda","Koholana South","719",676,331,345
"1327085","Kalutara","Dodangoda","Adhikarigoda","719A",1333,672,661
"1327090","Kalutara","Dodangoda","Gamagoda West","724A",1492,717,775
"1327095","Kalutara","Dodangoda","Bombuwala North - West","728C",2354,1123,1231
"1327100","Kalutara","Dodangoda","Bombuwala North - Central","728B",1735,830,905
"1327105","Kalutara","Dodangoda","Bombuwala North - East","728A",1027,478,549
"1327110","Kalutara","Dodangoda","Bombuwala South - West","728D",1447,688,759
"1327115","Kalutara","Dodangoda","Bombuwala South - Central","728",2432,1183,1249
"1327120","Kalutara","Dodangoda","Bombuwala South - East","728E",1765,855,910
"1327125","Kalutara","Dodangoda","Thudugala East","808A",1179,594,585
"1327130","Kalutara","Dodangoda","Wellatha","807D",1302,623,679
"1327135","Kalutara","Dodangoda","Ihala Nebada","807A",894,422,472
"1327140","Kalutara","Dodangoda","Wattahena","807E",874,419,455
"1327145","Kalutara","Dodangoda","Nehinna","801",1244,605,639
"1327150","Kalutara","Dodangoda","Wadugama","801A",1906,905,1001
"1327155","Kalutara","Dodangoda","Thudugala West","808",1182,552,630
"1327160","Kalutara","Dodangoda","Dodangoda East - North","800H",1582,762,820
"1327165","Kalutara","Dodangoda","Dodangoda West - North","800D",2520,1252,1268
"1327170","Kalutara","Dodangoda","Dodangoda West - North West","800F",2855,1363,1492
"1327175","Kalutara","Dodangoda","Dodangoda West","800",3211,1539,1672
"1327180","Kalutara","Dodangoda","Dodangoda West - Central","800E",892,438,454
"1327185","Kalutara","Dodangoda","Dodangoda West - South","800C",2095,1018,1077
"1327190","Kalutara","Dodangoda","Dodangoda East - South","800G",2028,941,1087
"1327195","Kalutara","Dodangoda","Sapugahawatta","800B",1476,706,770
"1327200","Kalutara","Dodangoda","Puhambugoda East","799",1673,810,863
"1327205","Kalutara","Dodangoda","Dodangoda East","800A",1126,527,599
"1327210","Kalutara","Dodangoda","Dodangoda East - Central","800I",1992,937,1055
"1327215","Kalutara","Dodangoda","Puhambugoda West","799C",1044,474,570
"1327220","Kalutara","Dodangoda","Eladoowa","799A",1551,771,780
"1327225","Kalutara","Dodangoda","Galpottavila","799B",645,337,308
"1330005","Kalutara","Mathugama","Iddagoda West","806A",864,429,435
"1330010","Kalutara","Mathugama","Iddagoda East","806",1514,726,788
"1330015","Kalutara","Mathugama","Hiriketiya","806B",666,319,347
"1330020","Kalutara","Mathugama","Panthiya","804",1826,910,916
"1330025","Kalutara","Mathugama","Welimanana","804A",2044,1002,1042
"1330030","Kalutara","Mathugama","Bopitiya East","802",1289,648,641
"1330035","Kalutara","Mathugama","Yattovita","805E",1767,828,939
"1330040","Kalutara","Mathugama","Mathugama West","805A",2278,1130,1148
"1330045","Kalutara","Mathugama","Mathugama North","805B",2217,1084,1133
"1330050","Kalutara","Mathugama","Gurudola","806C",485,231,254
"1330055","Kalutara","Mathugama","Wettewa","805D",2180,1086,1094
"1330060","Kalutara","Mathugama","Mathugama East","805",2144,1047,1097
"1330065","Kalutara","Mathugama","Mathugama South","805C",2281,1085,1196
"1330070","Kalutara","Mathugama","Naravila","803",2022,1003,1019
"1330075","Kalutara","Mathugama","Bopitiya West","802A",1515,720,795
"1330080","Kalutara","Mathugama","Diyagala","802C",1005,482,523
"1330085","Kalutara","Mathugama","Thambaretiya","802E",1167,544,623
"1330090","Kalutara","Mathugama","Yatadolawatta East","802D",2787,1342,1445
"1330095","Kalutara","Mathugama","Yatadolawatta West","802B",2502,1196,1306
"1330100","Kalutara","Mathugama","Aluthgamgoda","796A",1608,783,825
"1330105","Kalutara","Mathugama","Navuttuduwa","796",1704,820,884
"1330110","Kalutara","Mathugama","Keeranthidiya","797",1886,917,969
"1330115","Kalutara","Mathugama","Pussalamulla","797A",1643,785,858
"1330120","Kalutara","Mathugama","Kolehekada","798A",1786,866,920
"1330125","Kalutara","Mathugama","Kotagedara","798",1505,723,782
"1330130","Kalutara","Mathugama","Henegama","803A",1525,727,798
"1330135","Kalutara","Mathugama","Badugama","795A",2504,1210,1294
"1330140","Kalutara","Mathugama","Ovitigala","795",2214,1034,1180
"1330145","Kalutara","Mathugama","Sandasirigama","795B",1616,778,838
"1330150","Kalutara","Mathugama","Badugama New Colony","795C",1323,656,667
"1330155","Kalutara","Mathugama","Horawala East","794B",823,390,433
"1330160","Kalutara","Mathugama","Horawala North","794A",945,457,488
"1330165","Kalutara","Mathugama","Horawala","794",1008,476,532
"1330170","Kalutara","Mathugama","Horawala West","794C",1678,800,878
"1330175","Kalutara","Mathugama","Welipenna East - South","793A",918,441,477
"1330180","Kalutara","Mathugama","Welipenna West","793",2791,1342,1449
"1330185","Kalutara","Mathugama","Welipenna East - North","793B",2018,913,1105
"1330190","Kalutara","Mathugama","Dippita","793C",1052,522,530
"1330195","Kalutara","Mathugama","Lewwanduwa North","792B",633,291,342
"1330200","Kalutara","Mathugama","Henpita","774B",823,390,433
"1330205","Kalutara","Mathugama","Galmatta","774A",934,444,490
"1330210","Kalutara","Mathugama","Walagedara North","774",1145,562,583
"1330215","Kalutara","Mathugama","Warakatholla","772A",1269,635,634
"1330220","Kalutara","Mathugama","Nugagahalanda","772B",828,388,440
"1330225","Kalutara","Mathugama","Keppetiyagahalanda","771A",840,400,440
"1330230","Kalutara","Mathugama","Bondupitiya","771",899,446,453
"1330235","Kalutara","Mathugama","Andawala","776",1046,521,525
"1330240","Kalutara","Mathugama","Thalgasgoda","771B",2080,1018,1062
"1330245","Kalutara","Mathugama","Indigasthuduwa","772",550,259,291
"1330250","Kalutara","Mathugama","Ladduwa","776A",600,297,303
"1330255","Kalutara","Mathugama","Meegama","775",939,449,490
"1330260","Kalutara","Mathugama","Dewagoda","775A",1052,529,523
"1330265","Kalutara","Mathugama","Walagedara South","773A",1278,616,662
"1330270","Kalutara","Mathugama","Kurudippita","773",648,303,345
"1330275","Kalutara","Mathugama","Lewwanduwa West","792A",1152,556,596
"1330280","Kalutara","Mathugama","Lewwanduwa East","792",695,325,370
"1330285","Kalutara","Mathugama","Madawala","793D",775,376,399
"1333005","Kalutara","Agalawatta","Girikola","827A",1364,630,734
"1333010","Kalutara","Agalawatta","Pimbura","827",1712,812,900
"1333015","Kalutara","Agalawatta","Omatta","826",935,441,494
"1333020","Kalutara","Agalawatta","Omatta East","826B",528,248,280
"1333025","Kalutara","Agalawatta","Evariwatta","826A",1017,507,510
"1333030","Kalutara","Agalawatta","Kekulandala South","829B",1617,785,832
"1333035","Kalutara","Agalawatta","Halovita","827B",868,408,460
"1333040","Kalutara","Agalawatta","Udawela","828",1167,571,596
"1333045","Kalutara","Agalawatta","Helamba","828A",1558,741,817
"1333050","Kalutara","Agalawatta","Yatiyana West","830B",1924,932,992
"1333055","Kalutara","Agalawatta","Gorokgoda","828B",1609,763,846
"1333060","Kalutara","Agalawatta","Beragama","829C",773,366,407
"1333065","Kalutara","Agalawatta","Agalawatta","829",937,471,466
"1333070","Kalutara","Agalawatta","Kekulandala North","829A",1422,689,733
"1333075","Kalutara","Agalawatta","Dapiligoda","831",1378,662,716
"1333080","Kalutara","Agalawatta","Wandurabba","830",1561,741,820
"1333085","Kalutara","Agalawatta","Yatiyana East","830A",1493,682,811
"1333090","Kalutara","Agalawatta","Pinnagoda","832",1182,555,627
"1333095","Kalutara","Agalawatta","Bodhiyakanda","830C",349,161,188
"1333100","Kalutara","Agalawatta","Mulatiyana","832A",558,241,317
"1333105","Kalutara","Agalawatta","Ridirekhagama","832B",952,461,491
"1333110","Kalutara","Agalawatta","Kithulgoda","833",1619,782,837
"1333115","Kalutara","Agalawatta","Kithulgoda South","833A",790,361,429
"1333120","Kalutara","Agalawatta","Kuda Kalupahana","847A",687,340,347
"1333125","Kalutara","Agalawatta","Kalupahana","847",1007,489,518
"1333130","Kalutara","Agalawatta","Kevitiyagala North","846B",737,354,383
"1333135","Kalutara","Agalawatta","Diyapattugama","846A",1075,510,565
"1333140","Kalutara","Agalawatta","Kurupita","845",672,314,358
"1333145","Kalutara","Agalawatta","Harankahapatha","845A",699,334,365
"1333150","Kalutara","Agalawatta","Kevitiyagala","846",917,433,484
"1333155","Kalutara","Agalawatta","Polgampala","844D",873,407,466
"1333160","Kalutara","Agalawatta","Polgampala East","844C",751,354,397
"1333165","Kalutara","Agalawatta","Rathmale East","844B",1155,575,580
"1333170","Kalutara","Agalawatta","Rathmale","844",783,378,405
"1336005","Kalutara","Palindanuwara","Kosgulana","836L",561,278,283
"1336010","Kalutara","Palindanuwara","Kelinkanda","836B",832,432,400
"1336015","Kalutara","Palindanuwara","Kelinkanda Colony","836I",837,426,411
"1336020","Kalutara","Palindanuwara","Walakada","836K",778,388,390
"1336025","Kalutara","Palindanuwara","Kapugedara","836C",1036,501,535
"1336030","Kalutara","Palindanuwara","Galahitiya","836F",1642,794,848
"1336035","Kalutara","Palindanuwara","Ilukpatha","835A",1409,688,721
"1336040","Kalutara","Palindanuwara","Pelenda West","836E",1971,954,1017
"1336045","Kalutara","Palindanuwara","Pelenda","836",2009,972,1037
"1336050","Kalutara","Palindanuwara","Bampara","836J",563,264,299
"1336055","Kalutara","Palindanuwara","Ambegoda","836M",1004,492,512
"1336060","Kalutara","Palindanuwara","Morapitiya North","836H",1349,671,678
"1336065","Kalutara","Palindanuwara","Morapitiya","836A",1240,594,646
"1336070","Kalutara","Palindanuwara","Midalana West","837A",782,387,395
"1336075","Kalutara","Palindanuwara","Maragahadeniya","835C",2315,1168,1147
"1336080","Kalutara","Palindanuwara","Lathpandura East","835B",1745,881,864
"1336085","Kalutara","Palindanuwara","Bellana East","834A",1414,678,736
"1336090","Kalutara","Palindanuwara","Viharagama","834C",1072,545,527
"1336095","Kalutara","Palindanuwara","Kapugama","834B",432,189,243
"1336100","Kalutara","Palindanuwara","Bellana","834",1340,651,689
"1336105","Kalutara","Palindanuwara","Yakupitiya","834D",934,471,463
"1336110","Kalutara","Palindanuwara","Lathpandura","835",1496,692,804
"1336115","Kalutara","Palindanuwara","Kamburawala","839B",1883,906,977
"1336120","Kalutara","Palindanuwara","Baduraliya","839",2083,1031,1052
"1336125","Kalutara","Palindanuwara","Diggoda","839C",1257,604,653
"1336130","Kalutara","Palindanuwara","Midalana","837",1371,656,715
"1336135","Kalutara","Palindanuwara","Morapitiya South","836G",641,302,339
"1336140","Kalutara","Palindanuwara","Athwelthota","836D",1184,588,596
"1336145","Kalutara","Palindanuwara","Diganna","836N",927,446,481
"1336150","Kalutara","Palindanuwara","Batahena","838A",1092,547,545
"1336155","Kalutara","Palindanuwara","Hedigalla","838",1826,914,912
"1336160","Kalutara","Palindanuwara","Magura East","839D",777,378,399
"1336165","Kalutara","Palindanuwara","Magura West","839A",1022,498,524
"1336170","Kalutara","Palindanuwara","Addaragoda","840B",706,342,364
"1336175","Kalutara","Palindanuwara","Penigala","840A",563,265,298
"1336180","Kalutara","Palindanuwara","Kalugala","840",1249,628,621
"1336185","Kalutara","Palindanuwara","Athale","841",637,312,325
"1336190","Kalutara","Palindanuwara","Ingurudaluwa","841A",1124,534,590
"1336195","Kalutara","Palindanuwara","Bollunna","841C",908,469,439
"1336200","Kalutara","Palindanuwara","Kalukandawa","842B",103,57,46
"1336205","Kalutara","Palindanuwara","Batagodavila","841B",1236,627,609
"1336210","Kalutara","Palindanuwara","Boralugoda","842",395,200,195
"1336215","Kalutara","Palindanuwara","Thiniyawala","842A",3056,1557,1499
"1339005","Kalutara","Walallavita","Pannila South","791A",867,412,455
"1339010","Kalutara","Walallavita","Pannila East","791B",1102,527,575
"1339015","Kalutara","Walallavita","Uragoda West","790B",517,240,277
"1339020","Kalutara","Walallavita","Uragoda East","790",406,192,214
"1339025","Kalutara","Walallavita","Lihiniyawa West","848B",920,448,472
"1339030","Kalutara","Walallavita","Lihiniyawa East","848A",1123,547,576
"1339035","Kalutara","Walallavita","Moragala","848",1265,603,662
"1339040","Kalutara","Walallavita","Meegahathenna","849",1615,761,854
"1339045","Kalutara","Walallavita","Mallawachchigoda Gangabada","849C",1136,550,586
"1339050","Kalutara","Walallavita","Bothalawa","844A",802,380,422
"1339055","Kalutara","Walallavita","Kumbadoowa","849E",1354,620,734
"1339060","Kalutara","Walallavita","Maddegama","849A",1039,480,559
"1339065","Kalutara","Walallavita","Bogodakanda","849D",977,456,521
"1339070","Kalutara","Walallavita","Halwalakele Malwathukanda","848C",607,302,305
"1339075","Kalutara","Walallavita","Uthumgama","790A",789,387,402
"1339080","Kalutara","Walallavita","Kuda Mathugama","781",724,356,368
"1339085","Kalutara","Walallavita","Pareigama North","782",856,414,442
"1339090","Kalutara","Walallavita","Halwala","779",964,470,494
"1339095","Kalutara","Walallavita","Pannila","791",922,435,487
"1339100","Kalutara","Walallavita","Miriswatta","778A",1150,566,584
"1339105","Kalutara","Walallavita","Ittapana North","778",875,402,473
"1339110","Kalutara","Walallavita","Malambehena","777C",1039,486,553
"1339115","Kalutara","Walallavita","Ittapana West","777A",634,298,336
"1339120","Kalutara","Walallavita","Ittapana South","777",648,293,355
"1339125","Kalutara","Walallavita","Ittapana East","777B",752,348,404
"1339130","Kalutara","Walallavita","Loolbadduwa","780",1294,597,697
"1339135","Kalutara","Walallavita","Pareigama South","782A",856,400,456
"1339140","Kalutara","Walallavita","Gulavita North","789",603,297,306
"1339145","Kalutara","Walallavita","Wedawatta","849B",929,440,489
"1339150","Kalutara","Walallavita","Katukele Welmeegoda","844E",1183,570,613
"1339155","Kalutara","Walallavita","Ranepuragoda","843I",821,413,408
"1339160","Kalutara","Walallavita","Mandagala","843C",927,435,492
"1339165","Kalutara","Walallavita","Yattapatha","843B",1280,649,631
"1339170","Kalutara","Walallavita","Pahala Hewessa North","843A",1174,566,608
"1339175","Kalutara","Walallavita","Pahala Hewessa South","843G",757,384,373
"1339180","Kalutara","Walallavita","Pelawatta East","850B",738,374,364
"1339185","Kalutara","Walallavita","Pelawatta","850",954,484,470
"1339190","Kalutara","Walallavita","Pelawatta West North","850D",1265,604,661
"1339195","Kalutara","Walallavita","Makalandawa","788",771,385,386
"1339200","Kalutara","Walallavita","Makalandawa South","788A",645,296,349
"1339205","Kalutara","Walallavita","Gulavita South","789A",765,371,394
"1339210","Kalutara","Walallavita","Udugama","786",631,289,342
"1339215","Kalutara","Walallavita","Karapagala","784",951,458,493
"1339220","Kalutara","Walallavita","Gammana East","783",462,223,239
"1339225","Kalutara","Walallavita","Gammana West","783A",926,462,464
"1339230","Kalutara","Walallavita","Gorakadoowa","784A",938,438,500
"1339235","Kalutara","Walallavita","Yagirala","785",957,438,519
"1339240","Kalutara","Walallavita","Katudora","787A",833,401,432
"1339245","Kalutara","Walallavita","Magurumasvila","788B",671,310,361
"1339250","Kalutara","Walallavita","Walallavita East","787",736,363,373
"1339255","Kalutara","Walallavita","Pelawatta West South","850E",1273,619,654
"1339260","Kalutara","Walallavita","Gorakadoowa","850C",1624,783,841
"1339265","Kalutara","Walallavita","Miriswatta","850A",779,382,397
"1339270","Kalutara","Walallavita","Thundola","843E",1174,606,568
"1339275","Kalutara","Walallavita","Weerakanda","843F",468,228,240
"1339280","Kalutara","Walallavita","Gulanawatta","843H",1154,586,568
"1339285","Kalutara","Walallavita","Kankotawatta","843D",909,439,470
"1339290","Kalutara","Walallavita","Ihala Hewessa","843",741,367,374
"1339295","Kalutara","Walallavita","Walallavita South","787B",538,272,266
"1339300","Kalutara","Walallavita","Thotaha","787C",818,399,419
"2118030","Kandy","Udadumbara","Gerandigala","879",385,188,197
"5110020","Batticaloa","Koralai Pattu South (Kiran)","Uthuchchenai","210A/2",406,206,200
"5112115","Batticaloa","Eravur Pattu","Meerakerny","193E",3829,1867,1962
"5112120","Batticaloa","Eravur Pattu","Mich Nagar","193B",5313,2499,2814
"5112170","Batticaloa","Eravur Pattu","Marappalam","185C",1292,609,683
"5112175","Batticaloa","Eravur Pattu","Kithulwewa","185B",1177,584,593
"5112185","Batticaloa","Eravur Pattu","Koppavely","146A",634,320,314
"5115040","Batticaloa","Eravur Town","Eravur 02A","191A",1615,720,895
"5124050","Batticaloa","Kattankudy","Kattankudy Division 4  West","164C",1424,704,720
"5133025","Batticaloa","Porativu Pattu","Ganthipuram","107B",715,328,387
"5133170","Batticaloa","Porativu Pattu","Ganeshapuram","98C",1113,501,612
"5136030","Batticaloa","Manmunai South & Eruvil Pattu","Thottathivu North","122",1169,589,580
"5136035","Batticaloa","Manmunai South & Eruvil Pattu","Thottathivu  South","122A",666,330,336
"5136040","Batticaloa","Manmunai South & Eruvil Pattu","Thottathivu  South 2","122C",1019,480,539
"5136045","Batticaloa","Manmunai South & Eruvil Pattu","Thottathivu  South 1","122B",956,463,493
"5233005","Ampara","Addalachchenai","Deeghawapiya 01","AD/35A",1229,617,612
"5233160","Ampara","Addalachchenai","Deeghawapiya 02","AD/35D",840,411,429
"5312010","Trincomalee","Morawewa","Mahadivulwewa Stage I","230A",1846,937,909
"5312050","Trincomalee","Morawewa","Pankulama","231F",241,162,79
"5318040","Trincomalee","Thambalagamuwa","Thambalagamuwa","228A",1447,707,740
"5321090","Trincomalee","Kanthale","Kantale Town South","227K",2809,1483,1326
"5321095","Trincomalee","Kanthale","Kantale Town","227",3124,1524,1600
"7124105","Anuradhapura","Horowpothana","Medawachchiya Handiya","130",750,385,365
"7130105","Anuradhapura","Mihinthale","Kattabuwagama","570",654,324,330
"7133025","Anuradhapura","Nuwaragam Palatha East","Nelum Kanniya","278",1360,653,707
"4109130","Jaffna","Valikamam South-West (Sandilipay)","Mareesankoodal","J/154",1252,588,664
"4130155","Jaffna","Thenmaradchi (Chavakachcheri)","Meesalai East","J/318",1839,883,956
"4133065","Jaffna","Nallur","Neeraviyady","J/101",1501,723,778
"4309085","Vavuniya","Vavuniya","Katharsinnakulam","215B",3568,1742,1826
"4309095","Vavuniya","Vavuniya","Pattanichchi puliyankulam","214B",6367,3119,3248
"4309140","Vavuniya","Vavuniya","Pampaimadu","218A",2014,1005,1009
"4309145","Vavuniya","Vavuniya","Rajendrankulam","217",2525,1204,1321
"4409040","Mullaitivu","Puthukudiyiruppu","Puthukkudiyiruppu East","MU/36",0,0,0
"4409045","Mullaitivu","Puthukudiyiruppu","Puthukkudiyiruppu West","MU/41",615,297,318
"4412020","Mullaitivu","Oddusuddan","Kanagarathinapuram","MU/56",340,160,180
"4412055","Mullaitivu","Oddusuddan","Muththuiyankaddukulam","MU/55",1076,515,561
"4415020","Mullaitivu","Maritimepattu","Chemmalai","MU/84",928,441,487
"4415025","Mullaitivu","Maritimepattu","Chemmalai East","MU/83",247,147,100
"6151155","Kurunegala","Maspotha","Kavudawatta","809",1050,494,556
"6172120","Kurunegala","Kuliyapitiya West","Essedduma","1158",1161,568,593
"6227030","Puttalam","Pallama","Kammandaluwa","662A",1514,707,807
"9218155","Kegalle","Warakapola","IIipangamuwa","83E",949,442,507
"3242080","Matara","Matara Four Gravets","Hittetiya East","420A",2225,1056,1169
"3242085","Matara","Matara Four Gravets","Hittetiya Meda","414B",3719,1694,2025
"3242110","Matara","Matara Four Gravets","Hittetiya West","414A",1321,617,704
"8124160","Badulla","Hali-Ela","Kottagoda","82D",1980,882,1098
